PokerStars Hand #226484810600: Tournament #3187437334, $13.79+$1.21 USD Hold'em No Limit - Level IV (40/80) - 2021/05/05 19:56:10 MSK [2021/05/05 12:56:10 ET]
Table '3187437334 1' 6-max Seat #5 is the button
Seat 2: dimetruk (6974 in chips)
Seat 5: Vandbro (2026 in chips)
dimetruk: posts the ante 10
Vandbro: posts the ante 10
Vandbro: posts small blind 40
dimetruk: posts big blind 80
*** HOLE CARDS ***
Dealt to dimetruk [Jh Td]
Vandbro: calls 40
dimetruk: raises 80 to 160
Vandbro: calls 80
*** FLOP *** [8h 8c 7c]
dimetruk: bets 153
Vandbro: raises 258 to 411
dimetruk: raises 6393 to 6804 and is all-in
Vandbro: calls 1445 and is all-in
Uncalled bet (4948) returned to dimetruk
*** TURN *** [8h 8c 7c] [3h]
*** RIVER *** [8h 8c 7c 3h] [6d]
*** SHOW DOWN ***
dimetruk: shows [Jh Td] (a pair of Eights)
Vandbro: shows [8d Kd] (three of a kind, Eights)
Vandbro collected 4052 from pot
*** SUMMARY ***
Total pot 4052 | Rake 0
Board [8h 8c 7c 3h 6d]
Seat 2: dimetruk (big blind) showed [Jh Td] and lost with a pair of Eights
Seat 5: Vandbro (button) (small blind) showed [8d Kd] and won (4052) with three of a kind, Eights


PokerStars Hand #226484828418: Tournament #3187437334, $13.79+$1.21 USD Hold'em No Limit - Level V (60/120) - 2021/05/05 19:56:57 MSK [2021/05/05 12:56:57 ET]
Table '3187437334 1' 6-max Seat #5 is the button
Seat 2: dimetruk (4693 in chips)
Seat 5: Vandbro (4307 in chips)
dimetruk: posts the ante 15
Vandbro: posts the ante 15
Vandbro: posts small blind 60
dimetruk: posts big blind 120
*** HOLE CARDS ***
Dealt to dimetruk [Ts 3s]
Vandbro: raises 120 to 240
dimetruk: calls 120
*** FLOP *** [2s 6s As]
dimetruk: checks
Vandbro: bets 120
dimetruk: calls 120
*** TURN *** [2s 6s As] [Jc]
dimetruk: checks
Vandbro: checks
*** RIVER *** [2s 6s As Jc] [Th]
dimetruk: bets 563
Vandbro: calls 563
*** SHOW DOWN ***
dimetruk: shows [Ts 3s] (a flush, Ace high)
Vandbro: mucks hand
dimetruk collected 1876 from pot
*** SUMMARY ***
Total pot 1876 | Rake 0
Board [2s 6s As Jc Th]
Seat 2: dimetruk (big blind) showed [Ts 3s] and won (1876) with a flush, Ace high
Seat 5: Vandbro (button) (small blind) mucked [9h Kc]


PokerStars Hand #226484843891: Tournament #3187437334, $13.79+$1.21 USD Hold'em No Limit - Level V (60/120) - 2021/05/05 19:57:39 MSK [2021/05/05 12:57:39 ET]
Table '3187437334 1' 6-max Seat #2 is the button
Seat 2: dimetruk (5631 in chips)
Seat 5: Vandbro (3369 in chips)
dimetruk: posts the ante 15
Vandbro: posts the ante 15
dimetruk: posts small blind 60
Vandbro: posts big blind 120
*** HOLE CARDS ***
Dealt to dimetruk [4s 5c]
dimetruk: raises 120 to 240
Vandbro: calls 120
*** FLOP *** [Ks Qh 7h]
Vandbro: checks
dimetruk: checks
*** TURN *** [Ks Qh 7h] [Tc]
Vandbro: checks
dimetruk: checks
*** RIVER *** [Ks Qh 7h Tc] [4c]
Vandbro: checks
dimetruk: checks
*** SHOW DOWN ***
Vandbro: shows [Jd 7d] (a pair of Sevens)
dimetruk: mucks hand
Vandbro collected 510 from pot
*** SUMMARY ***
Total pot 510 | Rake 0
Board [Ks Qh 7h Tc 4c]
Seat 2: dimetruk (button) (small blind) mucked [4s 5c]
Seat 5: Vandbro (big blind) showed [Jd 7d] and won (510) with a pair of Sevens


PokerStars Hand #226484859594: Tournament #3187437334, $13.79+$1.21 USD Hold'em No Limit - Level V (60/120) - 2021/05/05 19:58:21 MSK [2021/05/05 12:58:21 ET]
Table '3187437334 1' 6-max Seat #5 is the button
Seat 2: dimetruk (5436 in chips)
Seat 5: Vandbro (3564 in chips)
dimetruk: posts the ante 15
Vandbro: posts the ante 15
Vandbro: posts small blind 60
dimetruk: posts big blind 120
*** HOLE CARDS ***
Dealt to dimetruk [9c Th]
Vandbro: calls 60
dimetruk: checks
*** FLOP *** [7s 4d Qd]
dimetruk: checks
Vandbro: bets 120
dimetruk: folds
Uncalled bet (120) returned to Vandbro
Vandbro collected 270 from pot
Vandbro: doesn't show hand
*** SUMMARY ***
Total pot 270 | Rake 0
Board [7s 4d Qd]
Seat 2: dimetruk (big blind) folded on the Flop
Seat 5: Vandbro (button) (small blind) collected (270)


PokerStars Hand #226484865470: Tournament #3187437334, $13.79+$1.21 USD Hold'em No Limit - Level V (60/120) - 2021/05/05 19:58:37 MSK [2021/05/05 12:58:37 ET]
Table '3187437334 1' 6-max Seat #2 is the button
Seat 2: dimetruk (5301 in chips)
Seat 5: Vandbro (3699 in chips)
dimetruk: posts the ante 15
Vandbro: posts the ante 15
dimetruk: posts small blind 60
Vandbro: posts big blind 120
*** HOLE CARDS ***
Dealt to dimetruk [7h 9d]
dimetruk: raises 120 to 240
Vandbro: calls 120
*** FLOP *** [2h Qd 5d]
Vandbro: checks
dimetruk: checks
*** TURN *** [2h Qd 5d] [Ts]
Vandbro: checks
dimetruk: checks
*** RIVER *** [2h Qd 5d Ts] [3s]
Vandbro: bets 336
dimetruk: folds
Uncalled bet (336) returned to Vandbro
Vandbro collected 510 from pot
Vandbro: doesn't show hand
*** SUMMARY ***
Total pot 510 | Rake 0
Board [2h Qd 5d Ts 3s]
Seat 2: dimetruk (button) (small blind) folded on the River
Seat 5: Vandbro (big blind) collected (510)


PokerStars Hand #226484873842: Tournament #3187437334, $13.79+$1.21 USD Hold'em No Limit - Level V (60/120) - 2021/05/05 19:59:00 MSK [2021/05/05 12:59:00 ET]
Table '3187437334 1' 6-max Seat #5 is the button
Seat 2: dimetruk (5046 in chips)
Seat 5: Vandbro (3954 in chips)
dimetruk: posts the ante 15
Vandbro: posts the ante 15
Vandbro: posts small blind 60
dimetruk: posts big blind 120
*** HOLE CARDS ***
Dealt to dimetruk [7d 3d]
Vandbro: calls 60
dimetruk: checks
*** FLOP *** [Kh 6c Ac]
dimetruk: checks
Vandbro: bets 120
dimetruk: folds
Uncalled bet (120) returned to Vandbro
Vandbro collected 270 from pot
Vandbro: doesn't show hand
*** SUMMARY ***
Total pot 270 | Rake 0
Board [Kh 6c Ac]
Seat 2: dimetruk (big blind) folded on the Flop
Seat 5: Vandbro (button) (small blind) collected (270)


PokerStars Hand #226484880852: Tournament #3187437334, $13.79+$1.21 USD Hold'em No Limit - Level V (60/120) - 2021/05/05 19:59:19 MSK [2021/05/05 12:59:19 ET]
Table '3187437334 1' 6-max Seat #5 is the button
Seat 2: dimetruk (4836 in chips)
Seat 5: Vandbro (4164 in chips)
dimetruk: posts the ante 15
Vandbro: posts the ante 15
Vandbro: posts small blind 60
dimetruk: posts big blind 120
*** HOLE CARDS ***
Dealt to dimetruk [5c 9h]
Vandbro: calls 60
dimetruk: checks
*** FLOP *** [Qs 2d 9c]
dimetruk: checks
Vandbro: checks
*** TURN *** [Qs 2d 9c] [4c]
dimetruk: bets 120
Vandbro: calls 120
*** RIVER *** [Qs 2d 9c 4c] [7s]
dimetruk: checks
Vandbro: checks
*** SHOW DOWN ***
dimetruk: shows [5c 9h] (a pair of Nines)
Vandbro: mucks hand
dimetruk collected 510 from pot
*** SUMMARY ***
Total pot 510 | Rake 0
Board [Qs 2d 9c 4c 7s]
Seat 2: dimetruk (big blind) showed [5c 9h] and won (510) with a pair of Nines
Seat 5: Vandbro (button) (small blind) mucked [6d Ad]


PokerStars Hand #226484890655: Tournament #3187437334, $13.79+$1.21 USD Hold'em No Limit - Level V (60/120) - 2021/05/05 19:59:45 MSK [2021/05/05 12:59:45 ET]
Table '3187437334 1' 6-max Seat #2 is the button
Seat 2: dimetruk (5091 in chips)
Seat 5: Vandbro (3909 in chips)
dimetruk: posts the ante 15
Vandbro: posts the ante 15
dimetruk: posts small blind 60
Vandbro: posts big blind 120
*** HOLE CARDS ***
Dealt to dimetruk [Jd 8s]
dimetruk: raises 120 to 240
Vandbro: calls 120
*** FLOP *** [4h 2c Jc]
Vandbro: checks
dimetruk: bets 230
Vandbro: folds
Uncalled bet (230) returned to dimetruk
dimetruk collected 510 from pot
dimetruk: doesn't show hand
*** SUMMARY ***
Total pot 510 | Rake 0
Board [4h 2c Jc]
Seat 2: dimetruk (button) (small blind) collected (510)
Seat 5: Vandbro (big blind) folded on the Flop


PokerStars Hand #226484895329: Tournament #3187437334, $13.79+$1.21 USD Hold'em No Limit - Level V (60/120) - 2021/05/05 19:59:58 MSK [2021/05/05 12:59:58 ET]
Table '3187437334 1' 6-max Seat #5 is the button
Seat 2: dimetruk (5346 in chips)
Seat 5: Vandbro (3654 in chips)
dimetruk: posts the ante 15
Vandbro: posts the ante 15
Vandbro: posts small blind 60
dimetruk: posts big blind 120
*** HOLE CARDS ***
Dealt to dimetruk [8d Jh]
Vandbro: calls 60
dimetruk: checks
*** FLOP *** [Kc 7h Js]
dimetruk: checks
Vandbro: bets 120
dimetruk: calls 120
*** TURN *** [Kc 7h Js] [Td]
dimetruk: checks
Vandbro: bets 336
dimetruk: calls 336
*** RIVER *** [Kc 7h Js Td] [Jc]
dimetruk: checks
Vandbro: checks
*** SHOW DOWN ***
dimetruk: shows [8d Jh] (three of a kind, Jacks)
Vandbro: mucks hand
dimetruk collected 1182 from pot
*** SUMMARY ***
Total pot 1182 | Rake 0
Board [Kc 7h Js Td Jc]
Seat 2: dimetruk (big blind) showed [8d Jh] and won (1182) with three of a kind, Jacks
Seat 5: Vandbro (button) (small blind) mucked [6c Kh]


PokerStars Hand #226484909241: Tournament #3187437334, $13.79+$1.21 USD Hold'em No Limit - Level V (60/120) - 2021/05/05 20:00:34 MSK [2021/05/05 13:00:34 ET]
Table '3187437334 1' 6-max Seat #5 is the button
Seat 2: dimetruk (5862 in chips)
Seat 5: Vandbro (3138 in chips)
dimetruk: posts the ante 15
Vandbro: posts the ante 15
Vandbro: posts small blind 60
dimetruk: posts big blind 120
*** HOLE CARDS ***
Dealt to dimetruk [5s 9d]
Vandbro: calls 60
dimetruk: checks
*** FLOP *** [7s Jd Td]
dimetruk: checks
Vandbro: checks
*** TURN *** [7s Jd Td] [Js]
dimetruk: checks
Vandbro: checks
*** RIVER *** [7s Jd Td Js] [4c]
dimetruk: checks
Vandbro: checks
*** SHOW DOWN ***
dimetruk: shows [5s 9d] (a pair of Jacks)
Vandbro: shows [5h Kc] (a pair of Jacks - King kicker)
Vandbro collected 270 from pot
*** SUMMARY ***
Total pot 270 | Rake 0
Board [7s Jd Td Js 4c]
Seat 2: dimetruk (big blind) showed [5s 9d] and lost with a pair of Jacks
Seat 5: Vandbro (button) (small blind) showed [5h Kc] and won (270) with a pair of Jacks


PokerStars Hand #226484934392: Tournament #3187437334, $13.79+$1.21 USD Hold'em No Limit - Level V (60/120) - 2021/05/05 20:01:14 MSK [2021/05/05 13:01:14 ET]
Table '3187437334 1' 6-max Seat #5 is the button
Seat 2: dimetruk (5652 in chips)
Seat 5: Vandbro (3348 in chips)
dimetruk: posts the ante 15
Vandbro: posts the ante 15
Vandbro: posts small blind 60
dimetruk: posts big blind 120
*** HOLE CARDS ***
Dealt to dimetruk [5h Ad]
Vandbro: calls 60
dimetruk: checks
*** FLOP *** [3c Ts Js]
dimetruk: checks
Vandbro: bets 120
dimetruk: folds
Uncalled bet (120) returned to Vandbro
Vandbro collected 270 from pot
Vandbro: doesn't show hand
*** SUMMARY ***
Total pot 270 | Rake 0
Board [3c Ts Js]
Seat 2: dimetruk (big blind) folded on the Flop
Seat 5: Vandbro (button) (small blind) collected (270)


PokerStars Hand #226484940242: Tournament #3187437334, $13.79+$1.21 USD Hold'em No Limit - Level V (60/120) - 2021/05/05 20:01:27 MSK [2021/05/05 13:01:27 ET]
Table '3187437334 1' 6-max Seat #2 is the button
Seat 2: dimetruk (5517 in chips)
Seat 5: Vandbro (3483 in chips)
dimetruk: posts the ante 15
Vandbro: posts the ante 15
dimetruk: posts small blind 60
Vandbro: posts big blind 120
*** HOLE CARDS ***
Dealt to dimetruk [Jc Th]
dimetruk: raises 120 to 240
Vandbro: calls 120
*** FLOP *** [Ah Js 9c]
Vandbro: checks
dimetruk: checks
*** TURN *** [Ah Js 9c] [8h]
Vandbro: checks
dimetruk: bets 230
Vandbro: folds
Uncalled bet (230) returned to dimetruk
dimetruk collected 510 from pot
dimetruk: doesn't show hand
*** SUMMARY ***
Total pot 510 | Rake 0
Board [Ah Js 9c 8h]
Seat 2: dimetruk (button) (small blind) collected (510)
Seat 5: Vandbro (big blind) folded on the Turn


PokerStars Hand #226484948309: Tournament #3187437334, $13.79+$1.21 USD Hold'em No Limit - Level V (60/120) - 2021/05/05 20:01:44 MSK [2021/05/05 13:01:44 ET]
Table '3187437334 1' 6-max Seat #5 is the button
Seat 2: dimetruk (5772 in chips)
Seat 5: Vandbro (3228 in chips)
dimetruk: posts the ante 15
Vandbro: posts the ante 15
Vandbro: posts small blind 60
dimetruk: posts big blind 120
*** HOLE CARDS ***
Dealt to dimetruk [7s Qc]
Vandbro: calls 60
dimetruk: checks
*** FLOP *** [5s Js 8d]
dimetruk: checks
Vandbro: checks
*** TURN *** [5s Js 8d] [Td]
dimetruk: bets 120
Vandbro: raises 286 to 406
dimetruk: folds
Uncalled bet (286) returned to Vandbro
Vandbro collected 510 from pot
Vandbro: doesn't show hand
*** SUMMARY ***
Total pot 510 | Rake 0
Board [5s Js 8d Td]
Seat 2: dimetruk (big blind) folded on the Turn
Seat 5: Vandbro (button) (small blind) collected (510)


PokerStars Hand #226484965683: Tournament #3187437334, $13.79+$1.21 USD Hold'em No Limit - Level V (60/120) - 2021/05/05 20:02:22 MSK [2021/05/05 13:02:22 ET]
Table '3187437334 1' 6-max Seat #5 is the button
Seat 2: dimetruk (5442 in chips)
Seat 5: Vandbro (3558 in chips)
dimetruk: posts the ante 15
Vandbro: posts the ante 15
Vandbro: posts small blind 60
dimetruk: posts big blind 120
*** HOLE CARDS ***
Dealt to dimetruk [Ac 3h]
Vandbro: raises 120 to 240
dimetruk: calls 120
*** FLOP *** [As Ks 4s]
dimetruk: checks
Vandbro: bets 120
dimetruk: calls 120
*** TURN *** [As Ks 4s] [4d]
dimetruk: checks
Vandbro: checks
*** RIVER *** [As Ks 4s 4d] [9s]
dimetruk: checks
Vandbro: checks
*** SHOW DOWN ***
dimetruk: shows [Ac 3h] (two pair, Aces and Fours)
Vandbro: mucks hand
dimetruk collected 750 from pot
*** SUMMARY ***
Total pot 750 | Rake 0
Board [As Ks 4s 4d 9s]
Seat 2: dimetruk (big blind) showed [Ac 3h] and won (750) with two pair, Aces and Fours
Seat 5: Vandbro (button) (small blind) mucked [8h Kd]


PokerStars Hand #226484984579: Tournament #3187437334, $13.79+$1.21 USD Hold'em No Limit - Level V (60/120) - 2021/05/05 20:03:01 MSK [2021/05/05 13:03:01 ET]
Table '3187437334 1' 6-max Seat #2 is the button
Seat 2: dimetruk (5817 in chips)
Seat 5: Vandbro (3183 in chips)
dimetruk: posts the ante 15
Vandbro: posts the ante 15
dimetruk: posts small blind 60
Vandbro: posts big blind 120
*** HOLE CARDS ***
Dealt to dimetruk [4s Ts]
dimetruk: raises 120 to 240
Vandbro: calls 120
*** FLOP *** [4c Qc 3h]
Vandbro: checks
dimetruk: bets 230
Vandbro: calls 230
*** TURN *** [4c Qc 3h] [3c]
Vandbro: bets 388
dimetruk: calls 388
*** RIVER *** [4c Qc 3h 3c] [9s]
Vandbro: checks
dimetruk: checks
*** SHOW DOWN ***
Vandbro: shows [7d 4d] (two pair, Fours and Threes)
dimetruk: shows [4s Ts] (two pair, Fours and Threes)
Vandbro collected 873 from pot
dimetruk collected 873 from pot
*** SUMMARY ***
Total pot 1746 | Rake 0
Board [4c Qc 3h 3c 9s]
Seat 2: dimetruk (button) (small blind) showed [4s Ts] and won (873) with two pair, Fours and Threes
Seat 5: Vandbro (big blind) showed [7d 4d] and won (873) with two pair, Fours and Threes


PokerStars Hand #226485011750: Tournament #3187437334, $13.79+$1.21 USD Hold'em No Limit - Level V (60/120) - 2021/05/05 20:03:57 MSK [2021/05/05 13:03:57 ET]
Table '3187437334 1' 6-max Seat #5 is the button
Seat 2: dimetruk (5817 in chips)
Seat 5: Vandbro (3183 in chips)
dimetruk: posts the ante 15
Vandbro: posts the ante 15
Vandbro: posts small blind 60
dimetruk: posts big blind 120
*** HOLE CARDS ***
Dealt to dimetruk [Tc 4c]
Vandbro: calls 60
dimetruk: checks
*** FLOP *** [6d 5c 6s]
dimetruk: checks
Vandbro: checks
*** TURN *** [6d 5c 6s] [Qs]
dimetruk: checks
Vandbro: checks
*** RIVER *** [6d 5c 6s Qs] [Ks]
dimetruk: checks
Vandbro: bets 120
dimetruk: folds
Uncalled bet (120) returned to Vandbro
Vandbro collected 270 from pot
Vandbro: doesn't show hand
*** SUMMARY ***
Total pot 270 | Rake 0
Board [6d 5c 6s Qs Ks]
Seat 2: dimetruk (big blind) folded on the River
Seat 5: Vandbro (button) (small blind) collected (270)


PokerStars Hand #226485031628: Tournament #3187437334, $13.79+$1.21 USD Hold'em No Limit - Level V (60/120) - 2021/05/05 20:04:38 MSK [2021/05/05 13:04:38 ET]
Table '3187437334 1' 6-max Seat #5 is the button
Seat 2: dimetruk (5427 in chips)
Seat 5: Vandbro (3573 in chips)
dimetruk: posts the ante 15
Vandbro: posts the ante 15
Vandbro: posts small blind 60
dimetruk: posts big blind 120
*** HOLE CARDS ***
Dealt to dimetruk [Kh 7c]
Vandbro: calls 60
dimetruk: raises 270 to 390
Vandbro: calls 270
*** FLOP *** [9d 5d Ad]
dimetruk: bets 267
Vandbro: calls 267
*** TURN *** [9d 5d Ad] [Qd]
dimetruk: checks
Vandbro: checks
*** RIVER *** [9d 5d Ad Qd] [7d]
dimetruk: checks
Vandbro: checks
*** SHOW DOWN ***
dimetruk: shows [Kh 7c] (a flush, Ace high)
Vandbro: shows [9c 8h] (a flush, Ace high)
dimetruk collected 672 from pot
Vandbro collected 672 from pot
*** SUMMARY ***
Total pot 1344 | Rake 0
Board [9d 5d Ad Qd 7d]
Seat 2: dimetruk (big blind) showed [Kh 7c] and won (672) with a flush, Ace high
Seat 5: Vandbro (button) (small blind) showed [9c 8h] and won (672) with a flush, Ace high


PokerStars Hand #226485043143: Tournament #3187437334, $13.79+$1.21 USD Hold'em No Limit - Level V (60/120) - 2021/05/05 20:05:00 MSK [2021/05/05 13:05:00 ET]
Table '3187437334 1' 6-max Seat #2 is the button
Seat 2: dimetruk (5427 in chips)
Seat 5: Vandbro (3573 in chips)
dimetruk: posts the ante 15
Vandbro: posts the ante 15
dimetruk: posts small blind 60
Vandbro: posts big blind 120
*** HOLE CARDS ***
Dealt to dimetruk [7c Jh]
dimetruk: raises 120 to 240
Vandbro: calls 120
*** FLOP *** [Td 3c Qd]
Vandbro: checks
dimetruk: checks
*** TURN *** [Td 3c Qd] [Th]
Vandbro: checks
dimetruk: checks
*** RIVER *** [Td 3c Qd Th] [8c]
Vandbro: bets 336
dimetruk: folds
Uncalled bet (336) returned to Vandbro
Vandbro collected 510 from pot
Vandbro: doesn't show hand
*** SUMMARY ***
Total pot 510 | Rake 0
Board [Td 3c Qd Th 8c]
Seat 2: dimetruk (button) (small blind) folded on the River
Seat 5: Vandbro (big blind) collected (510)


PokerStars Hand #226485063141: Tournament #3187437334, $13.79+$1.21 USD Hold'em No Limit - Level V (60/120) - 2021/05/05 20:05:41 MSK [2021/05/05 13:05:41 ET]
Table '3187437334 1' 6-max Seat #2 is the button
Seat 2: dimetruk (5307 in chips)
Seat 5: Vandbro (3693 in chips)
dimetruk: posts the ante 15
Vandbro: posts the ante 15
dimetruk: posts small blind 60
Vandbro: posts big blind 120
*** HOLE CARDS ***
Dealt to dimetruk [9d Qc]
dimetruk: raises 120 to 240
Vandbro: calls 120
*** FLOP *** [7h Tc Ac]
Vandbro: checks
dimetruk: bets 168
Vandbro: calls 168
*** TURN *** [7h Tc Ac] [Kc]
Vandbro: checks
dimetruk: bets 465
Vandbro: calls 465
*** RIVER *** [7h Tc Ac Kc] [Ts]
Vandbro: checks
dimetruk: checks
*** SHOW DOWN ***
Vandbro: shows [7s Jc] (two pair, Tens and Sevens)
dimetruk: mucks hand
Vandbro collected 1776 from pot
*** SUMMARY ***
Total pot 1776 | Rake 0
Board [7h Tc Ac Kc Ts]
Seat 2: dimetruk (button) (small blind) mucked [9d Qc]
Seat 5: Vandbro (big blind) showed [7s Jc] and won (1776) with two pair, Tens and Sevens


PokerStars Hand #226485087550: Tournament #3187437334, $13.79+$1.21 USD Hold'em No Limit - Level VI (80/160) - 2021/05/05 20:06:30 MSK [2021/05/05 13:06:30 ET]
Table '3187437334 1' 6-max Seat #5 is the button
Seat 2: dimetruk (4419 in chips)
Seat 5: Vandbro (4581 in chips)
dimetruk: posts the ante 20
Vandbro: posts the ante 20
Vandbro: posts small blind 80
dimetruk: posts big blind 160
*** HOLE CARDS ***
Dealt to dimetruk [8d 7s]
Vandbro: raises 160 to 320
dimetruk: calls 160
*** FLOP *** [4s 8s 5h]
dimetruk: checks
Vandbro: checks
*** TURN *** [4s 8s 5h] [Td]
dimetruk: bets 306
Vandbro: calls 306
*** RIVER *** [4s 8s 5h Td] [Ks]
dimetruk: checks
Vandbro: checks
*** SHOW DOWN ***
dimetruk: shows [8d 7s] (a pair of Eights)
Vandbro: mucks hand
dimetruk collected 1292 from pot
*** SUMMARY ***
Total pot 1292 | Rake 0
Board [4s 8s 5h Td Ks]
Seat 2: dimetruk (big blind) showed [8d 7s] and won (1292) with a pair of Eights
Seat 5: Vandbro (button) (small blind) mucked [Qd 9s]


PokerStars Hand #226485112393: Tournament #3187437334, $13.79+$1.21 USD Hold'em No Limit - Level VI (80/160) - 2021/05/05 20:07:20 MSK [2021/05/05 13:07:20 ET]
Table '3187437334 1' 6-max Seat #5 is the button
Seat 2: dimetruk (4725 in chips)
Seat 5: Vandbro (4275 in chips)
dimetruk: posts the ante 20
Vandbro: posts the ante 20
Vandbro: posts small blind 80
dimetruk: posts big blind 160
*** HOLE CARDS ***
Dealt to dimetruk [8d Jd]
Vandbro: raises 160 to 320
dimetruk: raises 320 to 640
Vandbro: calls 320
*** FLOP *** [8s Kh 3d]
dimetruk: bets 436
Vandbro: calls 436
*** TURN *** [8s Kh 3d] [2h]
dimetruk: bets 723
Vandbro: calls 723
*** RIVER *** [8s Kh 3d 2h] [3h]
dimetruk: checks
Vandbro: checks
*** SHOW DOWN ***
dimetruk: shows [8d Jd] (two pair, Eights and Threes)
Vandbro: shows [5s 8h] (two pair, Eights and Threes)
dimetruk collected 1819 from pot
Vandbro collected 1819 from pot
*** SUMMARY ***
Total pot 3638 | Rake 0
Board [8s Kh 3d 2h 3h]
Seat 2: dimetruk (big blind) showed [8d Jd] and won (1819) with two pair, Eights and Threes
Seat 5: Vandbro (button) (small blind) showed [5s 8h] and won (1819) with two pair, Eights and Threes


PokerStars Hand #226485142396: Tournament #3187437334, $13.79+$1.21 USD Hold'em No Limit - Level VI (80/160) - 2021/05/05 20:08:20 MSK [2021/05/05 13:08:20 ET]
Table '3187437334 1' 6-max Seat #5 is the button
Seat 2: dimetruk (4625 in chips)
Seat 5: Vandbro (4375 in chips)
dimetruk: posts the ante 20
Vandbro: posts the ante 20
Vandbro: posts small blind 80
dimetruk: posts big blind 160
*** HOLE CARDS ***
Dealt to dimetruk [Td 7s]
Vandbro: raises 160 to 320
dimetruk: calls 160
*** FLOP *** [Qs 3s Ad]
dimetruk: checks
Vandbro: bets 160
dimetruk: raises 320 to 480
Vandbro: calls 320
*** TURN *** [Qs 3s Ad] [4h]
dimetruk: checks
Vandbro: checks
*** RIVER *** [Qs 3s Ad 4h] [Qc]
dimetruk: checks
Vandbro: checks
*** SHOW DOWN ***
dimetruk: shows [Td 7s] (a pair of Queens)
Vandbro: shows [9c 3d] (two pair, Queens and Threes)
Vandbro collected 1640 from pot
*** SUMMARY ***
Total pot 1640 | Rake 0
Board [Qs 3s Ad 4h Qc]
Seat 2: dimetruk (big blind) showed [Td 7s] and lost with a pair of Queens
Seat 5: Vandbro (button) (small blind) showed [9c 3d] and won (1640) with two pair, Queens and Threes


PokerStars Hand #226485154533: Tournament #3187437334, $13.79+$1.21 USD Hold'em No Limit - Level VI (80/160) - 2021/05/05 20:08:44 MSK [2021/05/05 13:08:44 ET]
Table '3187437334 1' 6-max Seat #2 is the button
Seat 2: dimetruk (3805 in chips)
Seat 5: Vandbro (5195 in chips)
dimetruk: posts the ante 20
Vandbro: posts the ante 20
dimetruk: posts small blind 80
Vandbro: posts big blind 160
*** HOLE CARDS ***
Dealt to dimetruk [Kh 5s]
dimetruk: raises 160 to 320
Vandbro: calls 160
*** FLOP *** [Qc Td Ks]
Vandbro: checks
dimetruk: bets 306
Vandbro: calls 306
*** TURN *** [Qc Td Ks] [Ts]
Vandbro: checks
dimetruk: bets 581
Vandbro: calls 581
*** RIVER *** [Qc Td Ks Ts] [2s]
Vandbro: checks
dimetruk: checks
*** SHOW DOWN ***
Vandbro: shows [2d Kd] (two pair, Kings and Tens)
dimetruk: shows [Kh 5s] (two pair, Kings and Tens)
Vandbro collected 1227 from pot
dimetruk collected 1227 from pot
*** SUMMARY ***
Total pot 2454 | Rake 0
Board [Qc Td Ks Ts 2s]
Seat 2: dimetruk (button) (small blind) showed [Kh 5s] and won (1227) with two pair, Kings and Tens
Seat 5: Vandbro (big blind) showed [2d Kd] and won (1227) with two pair, Kings and Tens


PokerStars Hand #226485169243: Tournament #3187437334, $13.79+$1.21 USD Hold'em No Limit - Level VI (80/160) - 2021/05/05 20:09:18 MSK [2021/05/05 13:09:18 ET]
Table '3187437334 1' 6-max Seat #5 is the button
Seat 2: dimetruk (3805 in chips)
Seat 5: Vandbro (5195 in chips)
dimetruk: posts the ante 20
Vandbro: posts the ante 20
Vandbro: posts small blind 80
dimetruk: posts big blind 160
*** HOLE CARDS ***
Dealt to dimetruk [Ac 9h]
Vandbro: raises 160 to 320
dimetruk: raises 3465 to 3785 and is all-in
Vandbro: calls 3465
*** FLOP *** [5s 4c 9s]
*** TURN *** [5s 4c 9s] [6s]
*** RIVER *** [5s 4c 9s 6s] [2s]
*** SHOW DOWN ***
dimetruk: shows [Ac 9h] (a pair of Nines)
Vandbro: shows [Th Kc] (high card King)
dimetruk collected 7610 from pot
*** SUMMARY ***
Total pot 7610 | Rake 0
Board [5s 4c 9s 6s 2s]
Seat 2: dimetruk (big blind) showed [Ac 9h] and won (7610) with a pair of Nines
Seat 5: Vandbro (button) (small blind) showed [Th Kc] and lost with high card King


PokerStars Hand #226485177669: Tournament #3187437334, $13.79+$1.21 USD Hold'em No Limit - Level VI (80/160) - 2021/05/05 20:09:36 MSK [2021/05/05 13:09:36 ET]
Table '3187437334 1' 6-max Seat #2 is the button
Seat 2: dimetruk (7610 in chips)
Seat 5: Vandbro (1390 in chips)
dimetruk: posts the ante 20
Vandbro: posts the ante 20
dimetruk: posts small blind 80
Vandbro: posts big blind 160
*** HOLE CARDS ***
Dealt to dimetruk [6c Kc]
dimetruk: raises 7430 to 7590 and is all-in
Vandbro: calls 1210 and is all-in
Uncalled bet (6220) returned to dimetruk
*** FLOP *** [5h 4s 6h]
*** TURN *** [5h 4s 6h] [Ts]
*** RIVER *** [5h 4s 6h Ts] [Qd]
*** SHOW DOWN ***
Vandbro: shows [Kh 5s] (a pair of Fives)
dimetruk: shows [6c Kc] (a pair of Sixes)
dimetruk collected 2780 from pot
Vandbro finished the tournament in 2nd place and received $28.95.
dimetruk wins the tournament and receives $53.79 - congratulations!
*** SUMMARY ***
Total pot 2780 | Rake 0
Board [5h 4s 6h Ts Qd]
Seat 2: dimetruk (button) (small blind) showed [6c Kc] and won (2780) with a pair of Sixes
Seat 5: Vandbro (big blind) showed [Kh 5s] and lost with a pair of Fives


PokerStars Hand #226484828227: Tournament #3187445431, $13.70+$1.30 USD Hold'em No Limit - Level V (60/120) - 2021/05/05 19:56:57 MSK [2021/05/05 12:56:57 ET]
Table '3187445431 1' 9-max Seat #7 is the button
Seat 1: Eva Redonda (5568 in chips)
Seat 4: dimetruk (4949 in chips)
Seat 7: RaulG777 (2983 in chips)
Eva Redonda: posts the ante 15
dimetruk: posts the ante 15
RaulG777: posts the ante 15
Eva Redonda: posts small blind 60
dimetruk: posts big blind 120
*** HOLE CARDS ***
Dealt to dimetruk [5h Jh]
RaulG777: raises 120 to 240
Eva Redonda: folds
dimetruk: calls 120
*** FLOP *** [Ad 9h Js]
dimetruk: checks
RaulG777: checks
*** TURN *** [Ad 9h Js] [Qh]
dimetruk: bets 263
RaulG777: folds
Uncalled bet (263) returned to dimetruk
dimetruk collected 585 from pot
dimetruk: doesn't show hand
*** SUMMARY ***
Total pot 585 | Rake 0
Board [Ad 9h Js Qh]
Seat 1: Eva Redonda (small blind) folded before Flop
Seat 4: dimetruk (big blind) collected (585)
Seat 7: RaulG777 (button) folded on the Turn


PokerStars Hand #226484879666: Tournament #3187445431, $13.70+$1.30 USD Hold'em No Limit - Level V (60/120) - 2021/05/05 19:59:15 MSK [2021/05/05 12:59:15 ET]
Table '3187445431 1' 9-max Seat #7 is the button
Seat 1: Eva Redonda (6453 in chips)
Seat 4: dimetruk (5414 in chips)
Seat 7: RaulG777 (1633 in chips)
Eva Redonda: posts the ante 15
dimetruk: posts the ante 15
RaulG777: posts the ante 15
Eva Redonda: posts small blind 60
dimetruk: posts big blind 120
*** HOLE CARDS ***
Dealt to dimetruk [As Jh]
RaulG777: folds
Eva Redonda: raises 240 to 360
dimetruk: calls 240
*** FLOP *** [Ah 8d 6c]
Eva Redonda: bets 480
dimetruk: calls 480
*** TURN *** [Ah 8d 6c] [Jd]
Eva Redonda: checks
dimetruk: bets 949
Eva Redonda: folds
Uncalled bet (949) returned to dimetruk
dimetruk collected 1725 from pot
dimetruk: doesn't show hand
*** SUMMARY ***
Total pot 1725 | Rake 0
Board [Ah 8d 6c Jd]
Seat 1: Eva Redonda (small blind) folded on the Turn
Seat 4: dimetruk (big blind) collected (1725)
Seat 7: RaulG777 (button) folded before Flop (didn't bet)


PokerStars Hand #226484952246: Tournament #3187445431, $13.70+$1.30 USD Hold'em No Limit - Level VI (80/160) - 2021/05/05 20:01:52 MSK [2021/05/05 13:01:52 ET]
Table '3187445431 1' 9-max Seat #4 is the button
Seat 1: Eva Redonda (7256 in chips)
Seat 4: dimetruk (6244 in chips)
Eva Redonda: posts the ante 20
dimetruk: posts the ante 20
dimetruk: posts small blind 80
Eva Redonda: posts big blind 160
*** HOLE CARDS ***
Dealt to dimetruk [Ad 2d]
dimetruk: raises 160 to 320
Eva Redonda: calls 160
*** FLOP *** [9h 5d Qh]
Eva Redonda: checks
dimetruk: checks
*** TURN *** [9h 5d Qh] [Jd]
Eva Redonda: bets 480
dimetruk: calls 480
*** RIVER *** [9h 5d Qh Jd] [Qd]
Eva Redonda: bets 960
dimetruk: raises 4464 to 5424 and is all-in
Eva Redonda: calls 4464
*** SHOW DOWN ***
dimetruk: shows [Ad 2d] (a flush, Ace high)
Eva Redonda: shows [Qs 9s] (a full house, Queens full of Nines)
Eva Redonda collected 12488 from pot
dimetruk finished the tournament in 2nd place and received $36.99.
Eva Redonda wins the tournament and receives $61.65 - congratulations!
*** SUMMARY ***
Total pot 12488 | Rake 0
Board [9h 5d Qh Jd Qd]
Seat 1: Eva Redonda (big blind) showed [Qs 9s] and won (12488) with a full house, Queens full of Nines
Seat 4: dimetruk (button) (small blind) showed [Ad 2d] and lost with a flush, Ace high


PokerStars Hand #226513978208: Tournament #3187736508, $13.70+$1.30 USD Hold'em No Limit - Level I (10/20) - 2021/05/06 20:13:37 MSK [2021/05/06 13:13:37 ET]
Table '3187736508 2' 9-max Seat #5 is the button
Seat 2: WestwoodMuff (3401 in chips)
Seat 3: TUSUR FET (1118 in chips)
Seat 4: Jeremsdax (937 in chips)
Seat 5: dclucasPS (1458 in chips)
Seat 6: nararocha (2182 in chips) is sitting out
Seat 7: dimetruk (1488 in chips)
Seat 8: hansbolle (1488 in chips)
Seat 9: tottodahle (1428 in chips)
WestwoodMuff: posts the ante 3
TUSUR FET: posts the ante 3
Jeremsdax: posts the ante 3
dclucasPS: posts the ante 3
nararocha: posts the ante 3
dimetruk: posts the ante 3
hansbolle: posts the ante 3
tottodahle: posts the ante 3
nararocha: posts small blind 10
dimetruk: posts big blind 20
*** HOLE CARDS ***
Dealt to dimetruk [Jc 6d]
hansbolle: folds
tottodahle: raises 30 to 50
WestwoodMuff: folds
TUSUR FET: folds
Jeremsdax: folds
dclucasPS: folds
nararocha: folds
dimetruk: calls 30
*** FLOP *** [Js Ks 4d]
dimetruk: checks
tottodahle: bets 76
dimetruk: calls 76
*** TURN *** [Js Ks 4d] [Ah]
dimetruk: checks
tottodahle: bets 163
dimetruk: folds
Uncalled bet (163) returned to tottodahle
tottodahle collected 286 from pot
*** SUMMARY ***
Total pot 286 | Rake 0
Board [Js Ks 4d Ah]
Seat 2: WestwoodMuff folded before Flop (didn't bet)
Seat 3: TUSUR FET folded before Flop (didn't bet)
Seat 4: Jeremsdax folded before Flop (didn't bet)
Seat 5: dclucasPS (button) folded before Flop (didn't bet)
Seat 6: nararocha (small blind) folded before Flop
Seat 7: dimetruk (big blind) folded on the Turn
Seat 8: hansbolle folded before Flop (didn't bet)
Seat 9: tottodahle collected (286)


PokerStars Hand #226514229033: Tournament #3187736508, $13.70+$1.30 USD Hold'em No Limit - Level II (15/30) - 2021/05/06 20:22:02 MSK [2021/05/06 13:22:02 ET]
Table '3187736508 2' 9-max Seat #3 is the button
Seat 2: WestwoodMuff (3263 in chips)
Seat 3: TUSUR FET (784 in chips)
Seat 4: Jeremsdax (1395 in chips)
Seat 5: dclucasPS (1647 in chips)
Seat 6: nararocha (2369 in chips)
Seat 7: dimetruk (1332 in chips)
Seat 8: hansbolle (1438 in chips)
Seat 9: tottodahle (1272 in chips)
WestwoodMuff: posts the ante 4
TUSUR FET: posts the ante 4
Jeremsdax: posts the ante 4
dclucasPS: posts the ante 4
nararocha: posts the ante 4
dimetruk: posts the ante 4
hansbolle: posts the ante 4
tottodahle: posts the ante 4
Jeremsdax: posts small blind 15
dclucasPS: posts big blind 30
*** HOLE CARDS ***
Dealt to dimetruk [Qd Ah]
nararocha: calls 30
dimetruk: raises 60 to 90
hansbolle: folds
tottodahle: folds
WestwoodMuff: folds
TUSUR FET: folds
Jeremsdax: calls 75
dclucasPS: folds
nararocha: calls 60
*** FLOP *** [Ts Kh Jc]
Jeremsdax: checks
nararocha: bets 180
dimetruk: calls 180
Jeremsdax: raises 1121 to 1301 and is all-in
nararocha: folds
dimetruk: calls 1058 and is all-in
Uncalled bet (63) returned to Jeremsdax
*** TURN *** [Ts Kh Jc] [8c]
*** RIVER *** [Ts Kh Jc 8c] [7d]
*** SHOW DOWN ***
Jeremsdax: shows [Th Js] (two pair, Jacks and Tens)
dimetruk: shows [Qd Ah] (a straight, Ten to Ace)
dimetruk collected 2988 from pot
*** SUMMARY ***
Total pot 2988 | Rake 0
Board [Ts Kh Jc 8c 7d]
Seat 2: WestwoodMuff folded before Flop (didn't bet)
Seat 3: TUSUR FET (button) folded before Flop (didn't bet)
Seat 4: Jeremsdax (small blind) showed [Th Js] and lost with two pair, Jacks and Tens
Seat 5: dclucasPS (big blind) folded before Flop
Seat 6: nararocha folded on the Flop
Seat 7: dimetruk showed [Qd Ah] and won (2988) with a straight, Ten to Ace
Seat 8: hansbolle folded before Flop (didn't bet)
Seat 9: tottodahle folded before Flop (didn't bet)


PokerStars Hand #226514380835: Tournament #3187736508, $13.70+$1.30 USD Hold'em No Limit - Level III (25/50) - 2021/05/06 20:27:07 MSK [2021/05/06 13:27:07 ET]
Table '3187736508 2' 9-max Seat #9 is the button
Seat 2: WestwoodMuff (3814 in chips)
Seat 3: TUSUR FET (670 in chips)
Seat 5: dclucasPS (1578 in chips)
Seat 6: nararocha (2000 in chips)
Seat 7: dimetruk (2923 in chips)
Seat 8: hansbolle (1312 in chips)
Seat 9: tottodahle (1203 in chips)
WestwoodMuff: posts the ante 6
TUSUR FET: posts the ante 6
dclucasPS: posts the ante 6
nararocha: posts the ante 6
dimetruk: posts the ante 6
hansbolle: posts the ante 6
tottodahle: posts the ante 6
WestwoodMuff: posts small blind 25
TUSUR FET: posts big blind 50
*** HOLE CARDS ***
Dealt to dimetruk [Kd Jc]
dclucasPS: folds
nararocha: calls 50
dimetruk: raises 100 to 150
hansbolle: folds
tottodahle: folds
WestwoodMuff: calls 125
TUSUR FET: folds
nararocha: folds
*** FLOP *** [8s 6d 5d]
WestwoodMuff: bets 200
dimetruk: folds
Uncalled bet (200) returned to WestwoodMuff
WestwoodMuff collected 442 from pot
*** SUMMARY ***
Total pot 442 | Rake 0
Board [8s 6d 5d]
Seat 2: WestwoodMuff (small blind) collected (442)
Seat 3: TUSUR FET (big blind) folded before Flop
Seat 5: dclucasPS folded before Flop (didn't bet)
Seat 6: nararocha folded before Flop
Seat 7: dimetruk folded on the Flop
Seat 8: hansbolle folded before Flop (didn't bet)
Seat 9: tottodahle (button) folded before Flop (didn't bet)


PokerStars Hand #226514480233: Tournament #3187736508, $13.70+$1.30 USD Hold'em No Limit - Level III (25/50) - 2021/05/06 20:30:22 MSK [2021/05/06 13:30:22 ET]
Table '3187736508 2' 9-max Seat #4 is the button
Seat 2: WestwoodMuff (4038 in chips) is sitting out
Seat 3: TUSUR FET (577 in chips)
Seat 4: crovetto (3393 in chips)
Seat 5: dclucasPS (1510 in chips)
Seat 6: nararocha (1407 in chips)
Seat 7: dimetruk (2755 in chips)
Seat 9: tottodahle (1135 in chips)
WestwoodMuff: posts the ante 6
TUSUR FET: posts the ante 6
crovetto: posts the ante 6
dclucasPS: posts the ante 6
nararocha: posts the ante 6
dimetruk: posts the ante 6
tottodahle: posts the ante 6
dclucasPS: posts small blind 25
nararocha: posts big blind 50
*** HOLE CARDS ***
Dealt to dimetruk [Ah As]
dimetruk: raises 50 to 100
tottodahle: folds
WestwoodMuff: folds
TUSUR FET: folds
crovetto: folds
dclucasPS: calls 75
nararocha: calls 50
*** FLOP *** [Th Jc 2d]
dclucasPS: checks
nararocha: bets 200
dimetruk: raises 2449 to 2649 and is all-in
dclucasPS: folds
nararocha: folds
Uncalled bet (2449) returned to dimetruk
dimetruk collected 742 from pot
dimetruk: doesn't show hand
*** SUMMARY ***
Total pot 742 | Rake 0
Board [Th Jc 2d]
Seat 2: WestwoodMuff folded before Flop (didn't bet)
Seat 3: TUSUR FET folded before Flop (didn't bet)
Seat 4: crovetto (button) folded before Flop (didn't bet)
Seat 5: dclucasPS (small blind) folded on the Flop
Seat 6: nararocha (big blind) folded on the Flop
Seat 7: dimetruk collected (742)
Seat 9: tottodahle folded before Flop (didn't bet)


PokerStars Hand #226514505604: Tournament #3187736508, $13.70+$1.30 USD Hold'em No Limit - Level III (25/50) - 2021/05/06 20:31:11 MSK [2021/05/06 13:31:11 ET]
Table '3187736508 2' 9-max Seat #5 is the button
Seat 2: WestwoodMuff (4032 in chips) is sitting out
Seat 3: TUSUR FET (571 in chips)
Seat 4: crovetto (3387 in chips)
Seat 5: dclucasPS (1404 in chips)
Seat 6: nararocha (1101 in chips)
Seat 7: dimetruk (3191 in chips)
Seat 9: tottodahle (1129 in chips)
WestwoodMuff: posts the ante 6
TUSUR FET: posts the ante 6
crovetto: posts the ante 6
dclucasPS: posts the ante 6
nararocha: posts the ante 6
dimetruk: posts the ante 6
tottodahle: posts the ante 6
nararocha: posts small blind 25
dimetruk: posts big blind 50
*** HOLE CARDS ***
Dealt to dimetruk [Qd 7c]
tottodahle: folds
WestwoodMuff: folds
TUSUR FET: folds
crovetto: folds
dclucasPS: raises 50 to 100
nararocha has timed out
nararocha: folds
nararocha is sitting out
dimetruk: calls 50
*** FLOP *** [Kd Ad 8h]
nararocha has returned
dimetruk: checks
dclucasPS: checks
*** TURN *** [Kd Ad 8h] [Th]
dimetruk: bets 88
dclucasPS: calls 88
*** RIVER *** [Kd Ad 8h Th] [8c]
dimetruk: checks
dclucasPS: checks
*** SHOW DOWN ***
dimetruk: shows [Qd 7c] (a pair of Eights)
dclucasPS: shows [Jd Kc] (two pair, Kings and Eights)
dclucasPS collected 443 from pot
WestwoodMuff has returned
*** SUMMARY ***
Total pot 443 | Rake 0
Board [Kd Ad 8h Th 8c]
Seat 2: WestwoodMuff folded before Flop (didn't bet)
Seat 3: TUSUR FET folded before Flop (didn't bet)
Seat 4: crovetto folded before Flop (didn't bet)
Seat 5: dclucasPS (button) showed [Jd Kc] and won (443) with two pair, Kings and Eights
Seat 6: nararocha (small blind) folded before Flop
Seat 7: dimetruk (big blind) showed [Qd 7c] and lost with a pair of Eights
Seat 9: tottodahle folded before Flop (didn't bet)


PokerStars Hand #226514673186: Tournament #3187736508, $13.70+$1.30 USD Hold'em No Limit - Level III (25/50) - 2021/05/06 20:36:23 MSK [2021/05/06 13:36:23 ET]
Table '3187736508 2' 9-max Seat #4 is the button
Seat 2: WestwoodMuff (3921 in chips) is sitting out
Seat 3: TUSUR FET (1111 in chips)
Seat 4: crovetto (3905 in chips)
Seat 5: dclucasPS (1765 in chips)
Seat 7: dimetruk (2842 in chips)
Seat 9: tottodahle (1271 in chips)
WestwoodMuff: posts the ante 6
TUSUR FET: posts the ante 6
crovetto: posts the ante 6
dclucasPS: posts the ante 6
dimetruk: posts the ante 6
tottodahle: posts the ante 6
dclucasPS: posts small blind 25
dimetruk: posts big blind 50
*** HOLE CARDS ***
Dealt to dimetruk [7h 5d]
tottodahle: raises 50 to 100
WestwoodMuff: folds
TUSUR FET: calls 100
crovetto: folds
dclucasPS: folds
dimetruk: calls 50
*** FLOP *** [6d 8s Kc]
dimetruk: checks
tottodahle: bets 206
TUSUR FET: folds
dimetruk: calls 206
*** TURN *** [6d 8s Kc] [Ks]
dimetruk: checks
tottodahle: checks
*** RIVER *** [6d 8s Kc Ks] [8h]
dimetruk: checks
tottodahle: checks
*** SHOW DOWN ***
dimetruk: shows [7h 5d] (two pair, Kings and Eights)
tottodahle: shows [Ah 3d] (two pair, Kings and Eights - Ace kicker)
tottodahle collected 773 from pot
*** SUMMARY ***
Total pot 773 | Rake 0
Board [6d 8s Kc Ks 8h]
Seat 2: WestwoodMuff folded before Flop (didn't bet)
Seat 3: TUSUR FET folded on the Flop
Seat 4: crovetto (button) folded before Flop (didn't bet)
Seat 5: dclucasPS (small blind) folded before Flop
Seat 7: dimetruk (big blind) showed [7h 5d] and lost with two pair, Kings and Eights
Seat 9: tottodahle showed [Ah 3d] and won (773) with two pair, Kings and Eights


PokerStars Hand #226514799411: Tournament #3187736508, $13.70+$1.30 USD Hold'em No Limit - Level IV (40/80) - 2021/05/06 20:40:02 MSK [2021/05/06 13:40:02 ET]
Table '3187736508 2' 9-max Seat #2 is the button
Seat 2: WestwoodMuff (3825 in chips)
Seat 3: TUSUR FET (2170 in chips)
Seat 4: crovetto (3869 in chips)
Seat 5: dclucasPS (1544 in chips)
Seat 7: dimetruk (2800 in chips)
Seat 9: tottodahle (607 in chips)
WestwoodMuff: posts the ante 10
TUSUR FET: posts the ante 10
crovetto: posts the ante 10
dclucasPS: posts the ante 10
dimetruk: posts the ante 10
tottodahle: posts the ante 10
TUSUR FET: posts small blind 40
crovetto: posts big blind 80
*** HOLE CARDS ***
Dealt to dimetruk [5s 6s]
dclucasPS: folds
dimetruk: raises 80 to 160
tottodahle: folds
WestwoodMuff: folds
TUSUR FET: folds
crovetto: calls 80
*** FLOP *** [Ac 7s 6d]
crovetto: checks
dimetruk: bets 139
crovetto: calls 139
*** TURN *** [Ac 7s 6d] [Ad]
crovetto: checks
dimetruk: bets 384
crovetto: calls 384
*** RIVER *** [Ac 7s 6d Ad] [4s]
crovetto: bets 733
dimetruk: folds
Uncalled bet (733) returned to crovetto
crovetto collected 1466 from pot
crovetto: doesn't show hand
*** SUMMARY ***
Total pot 1466 | Rake 0
Board [Ac 7s 6d Ad 4s]
Seat 2: WestwoodMuff (button) folded before Flop (didn't bet)
Seat 3: TUSUR FET (small blind) folded before Flop
Seat 4: crovetto (big blind) collected (1466)
Seat 5: dclucasPS folded before Flop (didn't bet)
Seat 7: dimetruk folded on the River
Seat 9: tottodahle folded before Flop (didn't bet)


PokerStars Hand #226514837520: Tournament #3187736508, $13.70+$1.30 USD Hold'em No Limit - Level IV (40/80) - 2021/05/06 20:41:13 MSK [2021/05/06 13:41:13 ET]
Table '3187736508 2' 9-max Seat #3 is the button
Seat 2: WestwoodMuff (3815 in chips)
Seat 3: TUSUR FET (2120 in chips)
Seat 4: crovetto (4642 in chips)
Seat 5: dclucasPS (1534 in chips)
Seat 7: dimetruk (2107 in chips)
Seat 9: tottodahle (597 in chips)
WestwoodMuff: posts the ante 10
TUSUR FET: posts the ante 10
crovetto: posts the ante 10
dclucasPS: posts the ante 10
dimetruk: posts the ante 10
tottodahle: posts the ante 10
crovetto: posts small blind 40
dclucasPS: posts big blind 80
*** HOLE CARDS ***
Dealt to dimetruk [5s As]
dimetruk: raises 80 to 160
tottodahle: folds
WestwoodMuff: folds
TUSUR FET: folds
crovetto: calls 120
dclucasPS: folds
*** FLOP *** [2h Ad 9d]
crovetto: checks
dimetruk: bets 207
crovetto: folds
Uncalled bet (207) returned to dimetruk
dimetruk collected 460 from pot
dimetruk: doesn't show hand
*** SUMMARY ***
Total pot 460 | Rake 0
Board [2h Ad 9d]
Seat 2: WestwoodMuff folded before Flop (didn't bet)
Seat 3: TUSUR FET (button) folded before Flop (didn't bet)
Seat 4: crovetto (small blind) folded on the Flop
Seat 5: dclucasPS (big blind) folded before Flop
Seat 7: dimetruk collected (460)
Seat 9: tottodahle folded before Flop (didn't bet)


PokerStars Hand #226514946658: Tournament #3187736508, $13.70+$1.30 USD Hold'em No Limit - Level IV (40/80) - 2021/05/06 20:44:38 MSK [2021/05/06 13:44:38 ET]
Table '3187736508 2' 9-max Seat #3 is the button
Seat 2: WestwoodMuff (3815 in chips)
Seat 3: TUSUR FET (2007 in chips)
Seat 4: crovetto (5242 in chips)
Seat 5: dclucasPS (1354 in chips)
Seat 7: dimetruk (2397 in chips)
WestwoodMuff: posts the ante 10
TUSUR FET: posts the ante 10
crovetto: posts the ante 10
dclucasPS: posts the ante 10
dimetruk: posts the ante 10
crovetto: posts small blind 40
dclucasPS: posts big blind 80
*** HOLE CARDS ***
Dealt to dimetruk [Jc Ad]
dimetruk: raises 80 to 160
WestwoodMuff: folds
TUSUR FET: folds
crovetto: folds
dclucasPS: calls 80
*** FLOP *** [Kh Jh 9d]
dclucasPS: checks
dimetruk: bets 135
dclucasPS: folds
Uncalled bet (135) returned to dimetruk
dimetruk collected 410 from pot
dimetruk: doesn't show hand
*** SUMMARY ***
Total pot 410 | Rake 0
Board [Kh Jh 9d]
Seat 2: WestwoodMuff folded before Flop (didn't bet)
Seat 3: TUSUR FET (button) folded before Flop (didn't bet)
Seat 4: crovetto (small blind) folded before Flop
Seat 5: dclucasPS (big blind) folded on the Flop
Seat 7: dimetruk collected (410)


PokerStars Hand #226514973757: Tournament #3187736508, $13.70+$1.30 USD Hold'em No Limit - Level IV (40/80) - 2021/05/06 20:45:11 MSK [2021/05/06 13:45:11 ET]
Table '3187736508 2' 9-max Seat #4 is the button
Seat 2: WestwoodMuff (3805 in chips)
Seat 3: TUSUR FET (1997 in chips)
Seat 4: crovetto (5192 in chips)
Seat 5: dclucasPS (1184 in chips)
Seat 7: dimetruk (2637 in chips)
WestwoodMuff: posts the ante 10
TUSUR FET: posts the ante 10
crovetto: posts the ante 10
dclucasPS: posts the ante 10
dimetruk: posts the ante 10
dclucasPS: posts small blind 40
dimetruk: posts big blind 80
*** HOLE CARDS ***
Dealt to dimetruk [3s Qh]
WestwoodMuff: folds
TUSUR FET: raises 80 to 160
crovetto: folds
dclucasPS: folds
dimetruk: calls 80
*** FLOP *** [4c 9d 7c]
dimetruk: checks
TUSUR FET: bets 193
dimetruk: folds
Uncalled bet (193) returned to TUSUR FET
TUSUR FET collected 410 from pot
TUSUR FET: doesn't show hand
*** SUMMARY ***
Total pot 410 | Rake 0
Board [4c 9d 7c]
Seat 2: WestwoodMuff folded before Flop (didn't bet)
Seat 3: TUSUR FET collected (410)
Seat 4: crovetto (button) folded before Flop (didn't bet)
Seat 5: dclucasPS (small blind) folded before Flop
Seat 7: dimetruk (big blind) folded on the Flop


PokerStars Hand #226515138978: Tournament #3187736508, $13.70+$1.30 USD Hold'em No Limit - Level V (60/120) - 2021/05/06 20:50:19 MSK [2021/05/06 13:50:19 ET]
Table '3187736508 1' 9-max Seat #9 is the button
Seat 1: sakinaw (345 in chips)
Seat 2: TUSUR FET (3136 in chips)
Seat 3: WestwoodMuff (3685 in chips)
Seat 4: dimetruk (2362 in chips)
Seat 5: crovetto (5047 in chips)
Seat 6: bigbluesfan1977 (2279 in chips)
Seat 7: RaulG777 (1764 in chips)
Seat 8: coradog0215 (5725 in chips)
Seat 9: ScousePro (2657 in chips)
sakinaw: posts the ante 15
TUSUR FET: posts the ante 15
WestwoodMuff: posts the ante 15
dimetruk: posts the ante 15
crovetto: posts the ante 15
bigbluesfan1977: posts the ante 15
RaulG777: posts the ante 15
coradog0215: posts the ante 15
ScousePro: posts the ante 15
sakinaw: posts small blind 60
TUSUR FET: posts big blind 120
*** HOLE CARDS ***
Dealt to dimetruk [Kc Jc]
WestwoodMuff: folds
dimetruk: raises 120 to 240
crovetto: folds
bigbluesfan1977: folds
RaulG777: folds
coradog0215: folds
ScousePro: folds
sakinaw: folds
TUSUR FET: calls 120
*** FLOP *** [9h 7d 7h]
TUSUR FET: checks
dimetruk: bets 371
TUSUR FET: folds
Uncalled bet (371) returned to dimetruk
dimetruk collected 675 from pot
dimetruk: doesn't show hand
*** SUMMARY ***
Total pot 675 | Rake 0
Board [9h 7d 7h]
Seat 1: sakinaw (small blind) folded before Flop
Seat 2: TUSUR FET (big blind) folded on the Flop
Seat 3: WestwoodMuff folded before Flop (didn't bet)
Seat 4: dimetruk collected (675)
Seat 5: crovetto folded before Flop (didn't bet)
Seat 6: bigbluesfan1977 folded before Flop (didn't bet)
Seat 7: RaulG777 folded before Flop (didn't bet)
Seat 8: coradog0215 folded before Flop (didn't bet)
Seat 9: ScousePro (button) folded before Flop (didn't bet)


PokerStars Hand #226515517629: Tournament #3187736508, $13.70+$1.30 USD Hold'em No Limit - Level VI (80/160) - 2021/05/06 21:04:06 MSK [2021/05/06 14:04:06 ET]
Table '3187736508 1' 9-max Seat #2 is the button
Seat 2: TUSUR FET (3861 in chips)
Seat 3: WestwoodMuff (3320 in chips)
Seat 4: dimetruk (2462 in chips)
Seat 5: crovetto (5312 in chips)
Seat 6: bigbluesfan1977 (3444 in chips)
Seat 7: RaulG777 (1639 in chips)
Seat 8: coradog0215 (4640 in chips)
Seat 9: ScousePro (2322 in chips)
TUSUR FET: posts the ante 20
WestwoodMuff: posts the ante 20
dimetruk: posts the ante 20
crovetto: posts the ante 20
bigbluesfan1977: posts the ante 20
RaulG777: posts the ante 20
coradog0215: posts the ante 20
ScousePro: posts the ante 20
WestwoodMuff: posts small blind 80
dimetruk: posts big blind 160
*** HOLE CARDS ***
Dealt to dimetruk [Kc 9h]
crovetto: folds
bigbluesfan1977: folds
RaulG777: folds
coradog0215: calls 160
ScousePro: folds
TUSUR FET: folds
WestwoodMuff: calls 80
dimetruk: checks
*** FLOP *** [8s Jh 8d]
WestwoodMuff: bets 320
dimetruk: folds
coradog0215: folds
Uncalled bet (320) returned to WestwoodMuff
WestwoodMuff collected 640 from pot
*** SUMMARY ***
Total pot 640 | Rake 0
Board [8s Jh 8d]
Seat 2: TUSUR FET (button) folded before Flop (didn't bet)
Seat 3: WestwoodMuff (small blind) collected (640)
Seat 4: dimetruk (big blind) folded on the Flop
Seat 5: crovetto folded before Flop (didn't bet)
Seat 6: bigbluesfan1977 folded before Flop (didn't bet)
Seat 7: RaulG777 folded before Flop (didn't bet)
Seat 8: coradog0215 folded on the Flop
Seat 9: ScousePro folded before Flop (didn't bet)


PokerStars Hand #226515638971: Tournament #3187736508, $13.70+$1.30 USD Hold'em No Limit - Level VI (80/160) - 2021/05/06 21:07:53 MSK [2021/05/06 14:07:53 ET]
Table '3187736508 1' 9-max Seat #2 is the button
Seat 2: TUSUR FET (3461 in chips)
Seat 3: WestwoodMuff (3064 in chips)
Seat 4: dimetruk (2462 in chips)
Seat 5: crovetto (4912 in chips)
Seat 6: bigbluesfan1977 (3844 in chips)
Seat 7: RaulG777 (2455 in chips)
Seat 8: coradog0215 (4480 in chips)
Seat 9: ScousePro (2322 in chips)
TUSUR FET: posts the ante 20
WestwoodMuff: posts the ante 20
dimetruk: posts the ante 20
crovetto: posts the ante 20
bigbluesfan1977: posts the ante 20
RaulG777: posts the ante 20
coradog0215: posts the ante 20
ScousePro: posts the ante 20
WestwoodMuff: posts small blind 80
dimetruk: posts big blind 160
*** HOLE CARDS ***
Dealt to dimetruk [4c 3s]
crovetto: folds
bigbluesfan1977: calls 160
RaulG777: folds
coradog0215: folds
ScousePro: folds
TUSUR FET: folds
WestwoodMuff: calls 80
dimetruk: checks
*** FLOP *** [9h Td 3c]
WestwoodMuff: checks
dimetruk: checks
bigbluesfan1977: bets 399
WestwoodMuff: folds
dimetruk: folds
Uncalled bet (399) returned to bigbluesfan1977
bigbluesfan1977 collected 640 from pot
*** SUMMARY ***
Total pot 640 | Rake 0
Board [9h Td 3c]
Seat 2: TUSUR FET (button) folded before Flop (didn't bet)
Seat 3: WestwoodMuff (small blind) folded on the Flop
Seat 4: dimetruk (big blind) folded on the Flop
Seat 5: crovetto folded before Flop (didn't bet)
Seat 6: bigbluesfan1977 collected (640)
Seat 7: RaulG777 folded before Flop (didn't bet)
Seat 8: coradog0215 folded before Flop (didn't bet)
Seat 9: ScousePro folded before Flop (didn't bet)


PokerStars Hand #226515662939: Tournament #3187736508, $13.70+$1.30 USD Hold'em No Limit - Level VI (80/160) - 2021/05/06 21:08:38 MSK [2021/05/06 14:08:38 ET]
Table '3187736508 1' 9-max Seat #3 is the button
Seat 2: TUSUR FET (3441 in chips)
Seat 3: WestwoodMuff (2884 in chips)
Seat 4: dimetruk (2282 in chips)
Seat 5: crovetto (4892 in chips)
Seat 6: bigbluesfan1977 (4304 in chips)
Seat 7: RaulG777 (2435 in chips)
Seat 8: coradog0215 (4460 in chips)
Seat 9: ScousePro (2302 in chips)
TUSUR FET: posts the ante 20
WestwoodMuff: posts the ante 20
dimetruk: posts the ante 20
crovetto: posts the ante 20
bigbluesfan1977: posts the ante 20
RaulG777: posts the ante 20
coradog0215: posts the ante 20
ScousePro: posts the ante 20
dimetruk: posts small blind 80
crovetto: posts big blind 160
*** HOLE CARDS ***
Dealt to dimetruk [7s Kd]
bigbluesfan1977: folds
RaulG777: folds
coradog0215: folds
ScousePro: folds
TUSUR FET: folds
WestwoodMuff: folds
dimetruk: raises 2102 to 2262 and is all-in
crovetto: calls 2102
*** FLOP *** [6d 6h 8h]
*** TURN *** [6d 6h 8h] [8s]
*** RIVER *** [6d 6h 8h 8s] [7h]
*** SHOW DOWN ***
dimetruk: shows [7s Kd] (two pair, Eights and Sevens)
crovetto: shows [Tc Ah] (two pair, Eights and Sixes)
dimetruk collected 4684 from pot
*** SUMMARY ***
Total pot 4684 | Rake 0
Board [6d 6h 8h 8s 7h]
Seat 2: TUSUR FET folded before Flop (didn't bet)
Seat 3: WestwoodMuff (button) folded before Flop (didn't bet)
Seat 4: dimetruk (small blind) showed [7s Kd] and won (4684) with two pair, Eights and Sevens
Seat 5: crovetto (big blind) showed [Tc Ah] and lost with two pair, Eights and Sixes
Seat 6: bigbluesfan1977 folded before Flop (didn't bet)
Seat 7: RaulG777 folded before Flop (didn't bet)
Seat 8: coradog0215 folded before Flop (didn't bet)
Seat 9: ScousePro folded before Flop (didn't bet)


PokerStars Hand #226515863203: Tournament #3187736508, $13.70+$1.30 USD Hold'em No Limit - Level VII (100/200) - 2021/05/06 21:14:51 MSK [2021/05/06 14:14:51 ET]
Table '3187736508 1' 9-max Seat #4 is the button
Seat 2: TUSUR FET (4579 in chips)
Seat 3: WestwoodMuff (1909 in chips)
Seat 4: dimetruk (3909 in chips)
Seat 6: bigbluesfan1977 (4419 in chips)
Seat 8: coradog0215 (2786 in chips)
Seat 9: ScousePro (9398 in chips)
TUSUR FET: posts the ante 25
WestwoodMuff: posts the ante 25
dimetruk: posts the ante 25
bigbluesfan1977: posts the ante 25
coradog0215: posts the ante 25
ScousePro: posts the ante 25
bigbluesfan1977: posts small blind 100
coradog0215: posts big blind 200
*** HOLE CARDS ***
Dealt to dimetruk [Ah Kd]
ScousePro: folds
TUSUR FET: folds
WestwoodMuff: raises 400 to 600
dimetruk: raises 3284 to 3884 and is all-in
bigbluesfan1977: folds
coradog0215: folds
WestwoodMuff: calls 1284 and is all-in
Uncalled bet (2000) returned to dimetruk
*** FLOP *** [5d Tc 9s]
*** TURN *** [5d Tc 9s] [8d]
*** RIVER *** [5d Tc 9s 8d] [Jh]
*** SHOW DOWN ***
WestwoodMuff: shows [Kh Kc] (a pair of Kings)
dimetruk: shows [Ah Kd] (high card Ace)
WestwoodMuff collected 4218 from pot
*** SUMMARY ***
Total pot 4218 | Rake 0
Board [5d Tc 9s 8d Jh]
Seat 2: TUSUR FET folded before Flop (didn't bet)
Seat 3: WestwoodMuff showed [Kh Kc] and won (4218) with a pair of Kings
Seat 4: dimetruk (button) showed [Ah Kd] and lost with high card Ace
Seat 6: bigbluesfan1977 (small blind) folded before Flop
Seat 8: coradog0215 (big blind) folded before Flop
Seat 9: ScousePro folded before Flop (didn't bet)


PokerStars Hand #226515877237: Tournament #3187736508, $13.70+$1.30 USD Hold'em No Limit - Level VII (100/200) - 2021/05/06 21:15:17 MSK [2021/05/06 14:15:17 ET]
Table '3187736508 1' 9-max Seat #6 is the button
Seat 2: TUSUR FET (4554 in chips)
Seat 3: WestwoodMuff (4218 in chips)
Seat 4: dimetruk (2000 in chips)
Seat 6: bigbluesfan1977 (4294 in chips)
Seat 8: coradog0215 (2561 in chips)
Seat 9: ScousePro (9373 in chips)
TUSUR FET: posts the ante 25
WestwoodMuff: posts the ante 25
dimetruk: posts the ante 25
bigbluesfan1977: posts the ante 25
coradog0215: posts the ante 25
ScousePro: posts the ante 25
coradog0215: posts small blind 100
ScousePro: posts big blind 200
*** HOLE CARDS ***
Dealt to dimetruk [Ah Kh]
TUSUR FET: folds
WestwoodMuff: folds
dimetruk: raises 1775 to 1975 and is all-in
bigbluesfan1977: folds
coradog0215: folds
ScousePro: calls 1775
*** FLOP *** [Kd 8h 4h]
*** TURN *** [Kd 8h 4h] [8s]
*** RIVER *** [Kd 8h 4h 8s] [Qs]
*** SHOW DOWN ***
ScousePro: shows [Ac 5h] (a pair of Eights)
dimetruk: shows [Ah Kh] (two pair, Kings and Eights)
dimetruk collected 4200 from pot
*** SUMMARY ***
Total pot 4200 | Rake 0
Board [Kd 8h 4h 8s Qs]
Seat 2: TUSUR FET folded before Flop (didn't bet)
Seat 3: WestwoodMuff folded before Flop (didn't bet)
Seat 4: dimetruk showed [Ah Kh] and won (4200) with two pair, Kings and Eights
Seat 6: bigbluesfan1977 (button) folded before Flop (didn't bet)
Seat 8: coradog0215 (small blind) folded before Flop
Seat 9: ScousePro (big blind) showed [Ac 5h] and lost with a pair of Eights


PokerStars Hand #226515899318: Tournament #3187736508, $13.70+$1.30 USD Hold'em No Limit - Level VII (100/200) - 2021/05/06 21:15:58 MSK [2021/05/06 14:15:58 ET]
Table '3187736508 1' 9-max Seat #8 is the button
Seat 2: TUSUR FET (4529 in chips)
Seat 3: WestwoodMuff (4193 in chips)
Seat 4: dimetruk (4200 in chips)
Seat 6: bigbluesfan1977 (4269 in chips)
Seat 8: coradog0215 (2436 in chips)
Seat 9: ScousePro (7373 in chips)
TUSUR FET: posts the ante 25
WestwoodMuff: posts the ante 25
dimetruk: posts the ante 25
bigbluesfan1977: posts the ante 25
coradog0215: posts the ante 25
ScousePro: posts the ante 25
ScousePro: posts small blind 100
TUSUR FET: posts big blind 200
*** HOLE CARDS ***
Dealt to dimetruk [Qc Kc]
WestwoodMuff: folds
dimetruk: raises 200 to 400
bigbluesfan1977: folds
coradog0215: raises 2011 to 2411 and is all-in
ScousePro: folds
TUSUR FET: folds
dimetruk: calls 2011
*** FLOP *** [Jd 7s As]
*** TURN *** [Jd 7s As] [8s]
*** RIVER *** [Jd 7s As 8s] [4c]
*** SHOW DOWN ***
dimetruk: shows [Qc Kc] (high card Ace)
coradog0215: shows [5h 5s] (a pair of Fives)
coradog0215 collected 5272 from pot
*** SUMMARY ***
Total pot 5272 | Rake 0
Board [Jd 7s As 8s 4c]
Seat 2: TUSUR FET (big blind) folded before Flop
Seat 3: WestwoodMuff folded before Flop (didn't bet)
Seat 4: dimetruk showed [Qc Kc] and lost with high card Ace
Seat 6: bigbluesfan1977 folded before Flop (didn't bet)
Seat 8: coradog0215 (button) showed [5h 5s] and won (5272) with a pair of Fives
Seat 9: ScousePro (small blind) folded before Flop


PokerStars Hand #226516144172: Tournament #3187736508, $13.70+$1.30 USD Hold'em No Limit - Level VIII (150/300) - 2021/05/06 21:23:24 MSK [2021/05/06 14:23:24 ET]
Table '3187736508 1' 9-max Seat #6 is the button
Seat 2: TUSUR FET (3804 in chips)
Seat 3: WestwoodMuff (4068 in chips)
Seat 4: dimetruk (2664 in chips)
Seat 6: bigbluesfan1977 (3994 in chips)
Seat 8: coradog0215 (5984 in chips)
Seat 9: ScousePro (6486 in chips)
TUSUR FET: posts the ante 25
WestwoodMuff: posts the ante 25
dimetruk: posts the ante 25
bigbluesfan1977: posts the ante 25
coradog0215: posts the ante 25
ScousePro: posts the ante 25
coradog0215: posts small blind 150
ScousePro: posts big blind 300
*** HOLE CARDS ***
Dealt to dimetruk [Qs Ts]
TUSUR FET: folds
WestwoodMuff: folds
dimetruk: raises 2339 to 2639 and is all-in
bigbluesfan1977: folds
coradog0215: raises 3320 to 5959 and is all-in
ScousePro: folds
Uncalled bet (3320) returned to coradog0215
*** FLOP *** [Qd 4c Ac]
*** TURN *** [Qd 4c Ac] [3h]
*** RIVER *** [Qd 4c Ac 3h] [Jc]
*** SHOW DOWN ***
coradog0215: shows [Ah As] (three of a kind, Aces)
dimetruk: shows [Qs Ts] (a pair of Queens)
coradog0215 collected 5728 from pot
dimetruk finished the tournament in 6th place
*** SUMMARY ***
Total pot 5728 | Rake 0
Board [Qd 4c Ac 3h Jc]
Seat 2: TUSUR FET folded before Flop (didn't bet)
Seat 3: WestwoodMuff folded before Flop (didn't bet)
Seat 4: dimetruk showed [Qs Ts] and lost with a pair of Queens
Seat 6: bigbluesfan1977 (button) folded before Flop (didn't bet)
Seat 8: coradog0215 (small blind) showed [Ah As] and won (5728) with three of a kind, Aces
Seat 9: ScousePro (big blind) folded before Flop


PokerStars Hand #226510713541: Tournament #3187738267, $27.58+$2.42 USD Hold'em No Limit - Level I (10/20) - 2021/05/06 18:10:52 MSK [2021/05/06 11:10:52 ET]
Table '3187738267 1' 6-max Seat #1 is the button
Seat 1: dimetruk (1500 in chips)
Seat 2: BOGYÓ-70 (1500 in chips)
Seat 3: champydon (1500 in chips)
Seat 4: Nikola92975 (1500 in chips)
Seat 5: 1123580 (1500 in chips)
Seat 6: Monk Gallas (1500 in chips)
dimetruk: posts the ante 3
BOGYÓ-70: posts the ante 3
champydon: posts the ante 3
Nikola92975: posts the ante 3
1123580: posts the ante 3
Monk Gallas: posts the ante 3
BOGYÓ-70: posts small blind 10
champydon: posts big blind 20
*** HOLE CARDS ***
Dealt to dimetruk [8d 6d]
Nikola92975: folds
1123580: folds
Monk Gallas: folds
dimetruk: raises 20 to 40
BOGYÓ-70: calls 30
champydon: calls 20
*** FLOP *** [9d 9h 2s]
BOGYÓ-70: checks
champydon: bets 100
dimetruk: folds
BOGYÓ-70: folds
Uncalled bet (100) returned to champydon
champydon collected 138 from pot
*** SUMMARY ***
Total pot 138 | Rake 0
Board [9d 9h 2s]
Seat 1: dimetruk (button) folded on the Flop
Seat 2: BOGYÓ-70 (small blind) folded on the Flop
Seat 3: champydon (big blind) collected (138)
Seat 4: Nikola92975 folded before Flop (didn't bet)
Seat 5: 1123580 folded before Flop (didn't bet)
Seat 6: Monk Gallas folded before Flop (didn't bet)


PokerStars Hand #226510797830: Tournament #3187738267, $27.58+$2.42 USD Hold'em No Limit - Level I (10/20) - 2021/05/06 18:14:17 MSK [2021/05/06 11:14:17 ET]
Table '3187738267 1' 6-max Seat #5 is the button
Seat 1: dimetruk (1448 in chips)
Seat 2: BOGYÓ-70 (1448 in chips)
Seat 3: champydon (1643 in chips)
Seat 4: Nikola92975 (1506 in chips)
Seat 5: 1123580 (1487 in chips)
Seat 6: Monk Gallas (1468 in chips)
dimetruk: posts the ante 3
BOGYÓ-70: posts the ante 3
champydon: posts the ante 3
Nikola92975: posts the ante 3
1123580: posts the ante 3
Monk Gallas: posts the ante 3
Monk Gallas: posts small blind 10
dimetruk: posts big blind 20
*** HOLE CARDS ***
Dealt to dimetruk [Kd 8h]
BOGYÓ-70: folds
champydon: folds
Nikola92975: folds
1123580: folds
Monk Gallas: calls 10
dimetruk: checks
*** FLOP *** [7h 5c Tc]
Monk Gallas: checks
dimetruk: checks
*** TURN *** [7h 5c Tc] [Ks]
Monk Gallas: bets 20
dimetruk: calls 20
*** RIVER *** [7h 5c Tc Ks] [As]
Monk Gallas: checks
dimetruk: checks
*** SHOW DOWN ***
Monk Gallas: shows [Th 6c] (a pair of Tens)
dimetruk: shows [Kd 8h] (a pair of Kings)
dimetruk collected 98 from pot
*** SUMMARY ***
Total pot 98 | Rake 0
Board [7h 5c Tc Ks As]
Seat 1: dimetruk (big blind) showed [Kd 8h] and won (98) with a pair of Kings
Seat 2: BOGYÓ-70 folded before Flop (didn't bet)
Seat 3: champydon folded before Flop (didn't bet)
Seat 4: Nikola92975 folded before Flop (didn't bet)
Seat 5: 1123580 (button) folded before Flop (didn't bet)
Seat 6: Monk Gallas (small blind) showed [Th 6c] and lost with a pair of Tens


PokerStars Hand #226510841698: Tournament #3187738267, $27.58+$2.42 USD Hold'em No Limit - Level I (10/20) - 2021/05/06 18:16:03 MSK [2021/05/06 11:16:03 ET]
Table '3187738267 1' 6-max Seat #1 is the button
Seat 1: dimetruk (1490 in chips)
Seat 2: BOGYÓ-70 (1510 in chips)
Seat 3: champydon (1637 in chips)
Seat 4: Nikola92975 (1500 in chips)
Seat 5: 1123580 (1481 in chips)
Seat 6: Monk Gallas (1382 in chips)
dimetruk: posts the ante 3
BOGYÓ-70: posts the ante 3
champydon: posts the ante 3
Nikola92975: posts the ante 3
1123580: posts the ante 3
Monk Gallas: posts the ante 3
BOGYÓ-70: posts small blind 10
champydon: posts big blind 20
*** HOLE CARDS ***
Dealt to dimetruk [Qc 8s]
Nikola92975: folds
1123580: folds
Monk Gallas: folds
dimetruk: raises 20 to 40
BOGYÓ-70: calls 30
champydon: folds
*** FLOP *** [3s 2c Ac]
BOGYÓ-70: checks
dimetruk: bets 39
BOGYÓ-70: calls 39
*** TURN *** [3s 2c Ac] [9s]
BOGYÓ-70: checks
dimetruk: checks
*** RIVER *** [3s 2c Ac 9s] [Td]
BOGYÓ-70: checks
dimetruk: checks
*** SHOW DOWN ***
BOGYÓ-70: shows [3d Kd] (a pair of Threes)
dimetruk: mucks hand
BOGYÓ-70 collected 196 from pot
*** SUMMARY ***
Total pot 196 | Rake 0
Board [3s 2c Ac 9s Td]
Seat 1: dimetruk (button) mucked [Qc 8s]
Seat 2: BOGYÓ-70 (small blind) showed [3d Kd] and won (196) with a pair of Threes
Seat 3: champydon (big blind) folded before Flop
Seat 4: Nikola92975 folded before Flop (didn't bet)
Seat 5: 1123580 folded before Flop (didn't bet)
Seat 6: Monk Gallas folded before Flop (didn't bet)


PokerStars Hand #226510904051: Tournament #3187738267, $27.58+$2.42 USD Hold'em No Limit - Level I (10/20) - 2021/05/06 18:18:34 MSK [2021/05/06 11:18:34 ET]
Table '3187738267 1' 6-max Seat #5 is the button
Seat 1: dimetruk (1399 in chips)
Seat 2: BOGYÓ-70 (1503 in chips)
Seat 3: champydon (1595 in chips)
Seat 4: Nikola92975 (1666 in chips)
Seat 5: 1123580 (1527 in chips)
Seat 6: Monk Gallas (1310 in chips)
dimetruk: posts the ante 3
BOGYÓ-70: posts the ante 3
champydon: posts the ante 3
Nikola92975: posts the ante 3
1123580: posts the ante 3
Monk Gallas: posts the ante 3
Monk Gallas: posts small blind 10
dimetruk: posts big blind 20
*** HOLE CARDS ***
Dealt to dimetruk [8c Ks]
BOGYÓ-70: folds
champydon: calls 20
Nikola92975: folds
1123580: folds
Monk Gallas: folds
dimetruk: checks
*** FLOP *** [9h 3c Tc]
dimetruk: checks
champydon: bets 34
dimetruk: folds
Uncalled bet (34) returned to champydon
champydon collected 68 from pot
*** SUMMARY ***
Total pot 68 | Rake 0
Board [9h 3c Tc]
Seat 1: dimetruk (big blind) folded on the Flop
Seat 2: BOGYÓ-70 folded before Flop (didn't bet)
Seat 3: champydon collected (68)
Seat 4: Nikola92975 folded before Flop (didn't bet)
Seat 5: 1123580 (button) folded before Flop (didn't bet)
Seat 6: Monk Gallas (small blind) folded before Flop


PokerStars Hand #226511084052: Tournament #3187738267, $27.58+$2.42 USD Hold'em No Limit - Level II (15/30) - 2021/05/06 18:25:34 MSK [2021/05/06 11:25:34 ET]
Table '3187738267 1' 6-max Seat #2 is the button
Seat 1: dimetruk (1291 in chips)
Seat 2: BOGYÓ-70 (1606 in chips)
Seat 3: champydon (1545 in chips)
Seat 4: Nikola92975 (1944 in chips)
Seat 5: 1123580 (1518 in chips)
Seat 6: Monk Gallas (1096 in chips)
dimetruk: posts the ante 4
BOGYÓ-70: posts the ante 4
champydon: posts the ante 4
Nikola92975: posts the ante 4
1123580: posts the ante 4
Monk Gallas: posts the ante 4
champydon: posts small blind 15
Nikola92975: posts big blind 30
*** HOLE CARDS ***
Dealt to dimetruk [7d 7h]
1123580: folds
Monk Gallas: folds
dimetruk: raises 30 to 60
BOGYÓ-70: calls 60
champydon: folds
Nikola92975: folds
*** FLOP *** [7s 5h 2h]
dimetruk: bets 104
BOGYÓ-70: folds
Uncalled bet (104) returned to dimetruk
dimetruk collected 189 from pot
dimetruk: doesn't show hand
*** SUMMARY ***
Total pot 189 | Rake 0
Board [7s 5h 2h]
Seat 1: dimetruk collected (189)
Seat 2: BOGYÓ-70 (button) folded on the Flop
Seat 3: champydon (small blind) folded before Flop
Seat 4: Nikola92975 (big blind) folded before Flop
Seat 5: 1123580 folded before Flop (didn't bet)
Seat 6: Monk Gallas folded before Flop (didn't bet)


PokerStars Hand #226511097972: Tournament #3187738267, $27.58+$2.42 USD Hold'em No Limit - Level II (15/30) - 2021/05/06 18:26:08 MSK [2021/05/06 11:26:08 ET]
Table '3187738267 1' 6-max Seat #3 is the button
Seat 1: dimetruk (1416 in chips)
Seat 2: BOGYÓ-70 (1542 in chips)
Seat 3: champydon (1526 in chips)
Seat 4: Nikola92975 (1910 in chips)
Seat 5: 1123580 (1514 in chips)
Seat 6: Monk Gallas (1092 in chips)
dimetruk: posts the ante 4
BOGYÓ-70: posts the ante 4
champydon: posts the ante 4
Nikola92975: posts the ante 4
1123580: posts the ante 4
Monk Gallas: posts the ante 4
Nikola92975: posts small blind 15
1123580: posts big blind 30
*** HOLE CARDS ***
Dealt to dimetruk [Ad 7h]
Monk Gallas: folds
dimetruk: raises 30 to 60
BOGYÓ-70: folds
champydon: folds
Nikola92975: folds
1123580: calls 30
*** FLOP *** [6c 2h Ks]
1123580: checks
dimetruk: bets 52
1123580: calls 52
*** TURN *** [6c 2h Ks] [5c]
1123580: checks
dimetruk: checks
*** RIVER *** [6c 2h Ks 5c] [3d]
1123580: bets 135
dimetruk: folds
Uncalled bet (135) returned to 1123580
1123580 collected 263 from pot
1123580: doesn't show hand
*** SUMMARY ***
Total pot 263 | Rake 0
Board [6c 2h Ks 5c 3d]
Seat 1: dimetruk folded on the River
Seat 2: BOGYÓ-70 folded before Flop (didn't bet)
Seat 3: champydon (button) folded before Flop (didn't bet)
Seat 4: Nikola92975 (small blind) folded before Flop
Seat 5: 1123580 (big blind) collected (263)
Seat 6: Monk Gallas folded before Flop (didn't bet)


PokerStars Hand #226511117940: Tournament #3187738267, $27.58+$2.42 USD Hold'em No Limit - Level II (15/30) - 2021/05/06 18:26:55 MSK [2021/05/06 11:26:55 ET]
Table '3187738267 1' 6-max Seat #4 is the button
Seat 1: dimetruk (1300 in chips)
Seat 2: BOGYÓ-70 (1538 in chips)
Seat 3: champydon (1522 in chips)
Seat 4: Nikola92975 (1891 in chips)
Seat 5: 1123580 (1661 in chips)
Seat 6: Monk Gallas (1088 in chips)
dimetruk: posts the ante 4
BOGYÓ-70: posts the ante 4
champydon: posts the ante 4
Nikola92975: posts the ante 4
1123580: posts the ante 4
Monk Gallas: posts the ante 4
1123580: posts small blind 15
Monk Gallas: posts big blind 30
*** HOLE CARDS ***
Dealt to dimetruk [Ah 4h]
dimetruk: raises 30 to 60
BOGYÓ-70: folds
champydon: folds
Nikola92975: folds
1123580: folds
Monk Gallas: calls 30
*** FLOP *** [Qh Jh Tc]
Monk Gallas: checks
dimetruk: bets 52
Monk Gallas: folds
Uncalled bet (52) returned to dimetruk
dimetruk collected 159 from pot
dimetruk: doesn't show hand
*** SUMMARY ***
Total pot 159 | Rake 0
Board [Qh Jh Tc]
Seat 1: dimetruk collected (159)
Seat 2: BOGYÓ-70 folded before Flop (didn't bet)
Seat 3: champydon folded before Flop (didn't bet)
Seat 4: Nikola92975 (button) folded before Flop (didn't bet)
Seat 5: 1123580 (small blind) folded before Flop
Seat 6: Monk Gallas (big blind) folded on the Flop


PokerStars Hand #226511245453: Tournament #3187738267, $27.58+$2.42 USD Hold'em No Limit - Level III (25/50) - 2021/05/06 18:32:00 MSK [2021/05/06 11:32:00 ET]
Table '3187738267 1' 6-max Seat #5 is the button
Seat 1: dimetruk (1391 in chips)
Seat 2: BOGYÓ-70 (1236 in chips)
Seat 3: champydon (1445 in chips)
Seat 4: Nikola92975 (2759 in chips)
Seat 5: 1123580 (1539 in chips)
Seat 6: Monk Gallas (630 in chips)
dimetruk: posts the ante 6
BOGYÓ-70: posts the ante 6
champydon: posts the ante 6
Nikola92975: posts the ante 6
1123580: posts the ante 6
Monk Gallas: posts the ante 6
Monk Gallas: posts small blind 25
dimetruk: posts big blind 50
*** HOLE CARDS ***
Dealt to dimetruk [7h 6s]
BOGYÓ-70: folds
champydon: folds
Nikola92975: raises 60 to 110
1123580: folds
Monk Gallas: folds
dimetruk: calls 60
*** FLOP *** [Kh As Tc]
dimetruk: checks
Nikola92975: bets 93
dimetruk: folds
Uncalled bet (93) returned to Nikola92975
Nikola92975 collected 281 from pot
Nikola92975: doesn't show hand
*** SUMMARY ***
Total pot 281 | Rake 0
Board [Kh As Tc]
Seat 1: dimetruk (big blind) folded on the Flop
Seat 2: BOGYÓ-70 folded before Flop (didn't bet)
Seat 3: champydon folded before Flop (didn't bet)
Seat 4: Nikola92975 collected (281)
Seat 5: 1123580 (button) folded before Flop (didn't bet)
Seat 6: Monk Gallas (small blind) folded before Flop


PokerStars Hand #226511339532: Tournament #3187738267, $27.58+$2.42 USD Hold'em No Limit - Level III (25/50) - 2021/05/06 18:35:43 MSK [2021/05/06 11:35:43 ET]
Table '3187738267 1' 6-max Seat #5 is the button
Seat 1: dimetruk (1226 in chips)
Seat 2: BOGYÓ-70 (3340 in chips)
Seat 4: Nikola92975 (2875 in chips)
Seat 5: 1123580 (1384 in chips)
Seat 6: Monk Gallas (175 in chips)
dimetruk: posts the ante 6
BOGYÓ-70: posts the ante 6
Nikola92975: posts the ante 6
1123580: posts the ante 6
Monk Gallas: posts the ante 6
Monk Gallas: posts small blind 25
dimetruk: posts big blind 50
*** HOLE CARDS ***
Dealt to dimetruk [6c Qd]
BOGYÓ-70: folds
Nikola92975: raises 60 to 110
1123580: folds
Monk Gallas: folds
dimetruk: calls 60
*** FLOP *** [3h Qh Td]
dimetruk: checks
Nikola92975: checks
*** TURN *** [3h Qh Td] [6s]
dimetruk: bets 206
Nikola92975: calls 206
*** RIVER *** [3h Qh Td 6s] [5h]
dimetruk: bets 904 and is all-in
Nikola92975: folds
Uncalled bet (904) returned to dimetruk
dimetruk collected 687 from pot
dimetruk: doesn't show hand
*** SUMMARY ***
Total pot 687 | Rake 0
Board [3h Qh Td 6s 5h]
Seat 1: dimetruk (big blind) collected (687)
Seat 2: BOGYÓ-70 folded before Flop (didn't bet)
Seat 4: Nikola92975 folded on the River
Seat 5: 1123580 (button) folded before Flop (didn't bet)
Seat 6: Monk Gallas (small blind) folded before Flop


PokerStars Hand #226511376977: Tournament #3187738267, $27.58+$2.42 USD Hold'em No Limit - Level III (25/50) - 2021/05/06 18:37:11 MSK [2021/05/06 11:37:11 ET]
Table '3187738267 1' 6-max Seat #6 is the button
Seat 1: dimetruk (1591 in chips)
Seat 2: BOGYÓ-70 (3334 in chips)
Seat 4: Nikola92975 (2553 in chips)
Seat 5: 1123580 (1378 in chips)
Seat 6: Monk Gallas (144 in chips)
dimetruk: posts the ante 6
BOGYÓ-70: posts the ante 6
Nikola92975: posts the ante 6
1123580: posts the ante 6
Monk Gallas: posts the ante 6
dimetruk: posts small blind 25
BOGYÓ-70: posts big blind 50
*** HOLE CARDS ***
Dealt to dimetruk [8c Ah]
Nikola92975: folds
1123580: folds
Monk Gallas: folds
dimetruk: raises 50 to 100
BOGYÓ-70: calls 50
*** FLOP *** [Qh Jh Jd]
dimetruk: checks
BOGYÓ-70: checks
*** TURN *** [Qh Jh Jd] [Qs]
dimetruk: bets 104
BOGYÓ-70: calls 104
*** RIVER *** [Qh Jh Jd Qs] [Th]
dimetruk: bets 241
BOGYÓ-70: folds
Uncalled bet (241) returned to dimetruk
dimetruk collected 438 from pot
dimetruk: doesn't show hand
*** SUMMARY ***
Total pot 438 | Rake 0
Board [Qh Jh Jd Qs Th]
Seat 1: dimetruk (small blind) collected (438)
Seat 2: BOGYÓ-70 (big blind) folded on the River
Seat 4: Nikola92975 folded before Flop (didn't bet)
Seat 5: 1123580 folded before Flop (didn't bet)
Seat 6: Monk Gallas (button) folded before Flop (didn't bet)


PokerStars Hand #226511494407: Tournament #3187738267, $27.58+$2.42 USD Hold'em No Limit - Level IV (40/80) - 2021/05/06 18:41:47 MSK [2021/05/06 11:41:47 ET]
Table '3187738267 1' 6-max Seat #4 is the button
Seat 1: dimetruk (1853 in chips)
Seat 2: BOGYÓ-70 (3339 in chips)
Seat 4: Nikola92975 (1767 in chips)
Seat 5: 1123580 (2041 in chips)
dimetruk: posts the ante 10
BOGYÓ-70: posts the ante 10
Nikola92975: posts the ante 10
1123580: posts the ante 10
1123580: posts small blind 40
dimetruk: posts big blind 80
*** HOLE CARDS ***
Dealt to dimetruk [8d 4c]
BOGYÓ-70: folds
Nikola92975: raises 80 to 160
1123580: folds
dimetruk: calls 80
*** FLOP *** [Th 8c 6c]
dimetruk: checks
Nikola92975: checks
*** TURN *** [Th 8c 6c] [Qh]
dimetruk: bets 180
Nikola92975: folds
Uncalled bet (180) returned to dimetruk
dimetruk collected 400 from pot
dimetruk: doesn't show hand
*** SUMMARY ***
Total pot 400 | Rake 0
Board [Th 8c 6c Qh]
Seat 1: dimetruk (big blind) collected (400)
Seat 2: BOGYÓ-70 folded before Flop (didn't bet)
Seat 4: Nikola92975 (button) folded on the Turn
Seat 5: 1123580 (small blind) folded before Flop


PokerStars Hand #226511572836: Tournament #3187738267, $27.58+$2.42 USD Hold'em No Limit - Level IV (40/80) - 2021/05/06 18:44:50 MSK [2021/05/06 11:44:50 ET]
Table '3187738267 1' 6-max Seat #4 is the button
Seat 1: dimetruk (2173 in chips)
Seat 2: BOGYÓ-70 (3259 in chips)
Seat 4: Nikola92975 (1687 in chips)
Seat 5: 1123580 (1881 in chips)
dimetruk: posts the ante 10
BOGYÓ-70: posts the ante 10
Nikola92975: posts the ante 10
1123580: posts the ante 10
1123580: posts small blind 40
dimetruk: posts big blind 80
*** HOLE CARDS ***
Dealt to dimetruk [4c 7d]
BOGYÓ-70: folds
Nikola92975: raises 80 to 160
1123580: folds
dimetruk: calls 80
*** FLOP *** [9c 7h As]
dimetruk: checks
Nikola92975: bets 132
dimetruk: calls 132
*** TURN *** [9c 7h As] [Ah]
dimetruk: checks
Nikola92975: bets 336
dimetruk: folds
Uncalled bet (336) returned to Nikola92975
Nikola92975 collected 664 from pot
Nikola92975: doesn't show hand
*** SUMMARY ***
Total pot 664 | Rake 0
Board [9c 7h As Ah]
Seat 1: dimetruk (big blind) folded on the Turn
Seat 2: BOGYÓ-70 folded before Flop (didn't bet)
Seat 4: Nikola92975 (button) collected (664)
Seat 5: 1123580 (small blind) folded before Flop


PokerStars Hand #226511614978: Tournament #3187738267, $27.58+$2.42 USD Hold'em No Limit - Level IV (40/80) - 2021/05/06 18:46:19 MSK [2021/05/06 11:46:19 ET]
Table '3187738267 1' 6-max Seat #1 is the button
Seat 1: dimetruk (1821 in chips)
Seat 2: BOGYÓ-70 (3159 in chips)
Seat 4: Nikola92975 (2039 in chips)
Seat 5: 1123580 (1981 in chips)
dimetruk: posts the ante 10
BOGYÓ-70: posts the ante 10
Nikola92975: posts the ante 10
1123580: posts the ante 10
BOGYÓ-70: posts small blind 40
Nikola92975: posts big blind 80
*** HOLE CARDS ***
Dealt to dimetruk [Ad Jd]
1123580: folds
dimetruk: raises 80 to 160
BOGYÓ-70: calls 120
Nikola92975: raises 1869 to 2029 and is all-in
dimetruk: calls 1651 and is all-in
BOGYÓ-70: folds
Uncalled bet (218) returned to Nikola92975
*** FLOP *** [4s 8h Qh]
*** TURN *** [4s 8h Qh] [4c]
*** RIVER *** [4s 8h Qh 4c] [9d]
*** SHOW DOWN ***
Nikola92975: shows [6h 6d] (two pair, Sixes and Fours)
dimetruk: shows [Ad Jd] (a pair of Fours)
Nikola92975 collected 3822 from pot
dimetruk finished the tournament in 4th place
*** SUMMARY ***
Total pot 3822 | Rake 0
Board [4s 8h Qh 4c 9d]
Seat 1: dimetruk (button) showed [Ad Jd] and lost with a pair of Fours
Seat 2: BOGYÓ-70 (small blind) folded before Flop
Seat 4: Nikola92975 (big blind) showed [6h 6d] and won (3822) with two pair, Sixes and Fours
Seat 5: 1123580 folded before Flop (didn't bet)


PokerStars Hand #226500890582: Tournament #3187770419, $27.40+$2.60 USD Hold'em No Limit - Level II (15/30) - 2021/05/06 6:45:45 MSK [2021/05/05 23:45:45 ET]
Table '3187770419 1' 9-max Seat #8 is the button
Seat 1: dimetruk (1478 in chips)
Seat 2: Vandbro (1455 in chips)
Seat 3: ShaiC`akes (1902 in chips)
Seat 4: boors19 (1268 in chips)
Seat 5: platosha666 (1069 in chips)
Seat 6: hoyzeefbaby (920 in chips)
Seat 7: Dusty Miles (1744 in chips)
Seat 8: kellogs10377 (2266 in chips)
Seat 9: Luke141269 (1398 in chips)
dimetruk: posts the ante 4
Vandbro: posts the ante 4
ShaiC`akes: posts the ante 4
boors19: posts the ante 4
platosha666: posts the ante 4
hoyzeefbaby: posts the ante 4
Dusty Miles: posts the ante 4
kellogs10377: posts the ante 4
Luke141269: posts the ante 4
Luke141269: posts small blind 15
dimetruk: posts big blind 30
*** HOLE CARDS ***
Dealt to dimetruk [Jc 3d]
Vandbro: raises 30 to 60
ShaiC`akes: folds
boors19: folds
platosha666: folds
hoyzeefbaby: folds
Dusty Miles: folds
kellogs10377: calls 60
Luke141269: folds
dimetruk: calls 30
*** FLOP *** [8d 9d 6c]
dimetruk: checks
Vandbro: checks
kellogs10377: checks
*** TURN *** [8d 9d 6c] [3c]
dimetruk: bets 76
Vandbro: folds
kellogs10377: calls 76
*** RIVER *** [8d 9d 6c 3c] [2c]
dimetruk: bets 211
kellogs10377: folds
Uncalled bet (211) returned to dimetruk
dimetruk collected 383 from pot
dimetruk: doesn't show hand
*** SUMMARY ***
Total pot 383 | Rake 0
Board [8d 9d 6c 3c 2c]
Seat 1: dimetruk (big blind) collected (383)
Seat 2: Vandbro folded on the Turn
Seat 3: ShaiC`akes folded before Flop (didn't bet)
Seat 4: boors19 folded before Flop (didn't bet)
Seat 5: platosha666 folded before Flop (didn't bet)
Seat 6: hoyzeefbaby folded before Flop (didn't bet)
Seat 7: Dusty Miles folded before Flop (didn't bet)
Seat 8: kellogs10377 (button) folded on the River
Seat 9: Luke141269 (small blind) folded before Flop


PokerStars Hand #226501010317: Tournament #3187770419, $27.40+$2.60 USD Hold'em No Limit - Level III (25/50) - 2021/05/06 6:55:56 MSK [2021/05/05 23:55:56 ET]
Table '3187770419 1' 9-max Seat #8 is the button
Seat 1: dimetruk (1672 in chips)
Seat 2: Vandbro (1673 in chips)
Seat 3: ShaiC`akes (1602 in chips)
Seat 4: boors19 (1176 in chips)
Seat 5: platosha666 (2179 in chips)
Seat 6: hoyzeefbaby (693 in chips)
Seat 7: Dusty Miles (1334 in chips)
Seat 8: kellogs10377 (1951 in chips)
Seat 9: Luke141269 (1220 in chips)
dimetruk: posts the ante 6
Vandbro: posts the ante 6
ShaiC`akes: posts the ante 6
boors19: posts the ante 6
platosha666: posts the ante 6
hoyzeefbaby: posts the ante 6
Dusty Miles: posts the ante 6
kellogs10377: posts the ante 6
Luke141269: posts the ante 6
Luke141269: posts small blind 25
dimetruk: posts big blind 50
*** HOLE CARDS ***
Dealt to dimetruk [6c Qs]
Vandbro: folds
ShaiC`akes: raises 55 to 105
boors19: folds
platosha666: folds
hoyzeefbaby: folds
Dusty Miles: calls 105
kellogs10377: folds
Luke141269: folds
dimetruk: calls 55
*** FLOP *** [9h Qd Kh]
dimetruk: checks
ShaiC`akes: bets 87
Dusty Miles: folds
dimetruk: calls 87
*** TURN *** [9h Qd Kh] [2d]
dimetruk: checks
ShaiC`akes: bets 187
dimetruk: calls 187
*** RIVER *** [9h Qd Kh 2d] [2h]
dimetruk: checks
ShaiC`akes: checks
*** SHOW DOWN ***
dimetruk: shows [6c Qs] (two pair, Queens and Deuces)
ShaiC`akes: shows [Ts Ks] (two pair, Kings and Deuces)
ShaiC`akes collected 942 from pot
*** SUMMARY ***
Total pot 942 | Rake 0
Board [9h Qd Kh 2d 2h]
Seat 1: dimetruk (big blind) showed [6c Qs] and lost with two pair, Queens and Deuces
Seat 2: Vandbro folded before Flop (didn't bet)
Seat 3: ShaiC`akes showed [Ts Ks] and won (942) with two pair, Kings and Deuces
Seat 4: boors19 folded before Flop (didn't bet)
Seat 5: platosha666 folded before Flop (didn't bet)
Seat 6: hoyzeefbaby folded before Flop (didn't bet)
Seat 7: Dusty Miles folded on the Flop
Seat 8: kellogs10377 (button) folded before Flop (didn't bet)
Seat 9: Luke141269 (small blind) folded before Flop


PokerStars Hand #226501187790: Tournament #3187770419, $27.40+$2.60 USD Hold'em No Limit - Level IV (40/80) - 2021/05/06 7:11:17 MSK [2021/05/06 0:11:17 ET]
Table '3187770419 1' 9-max Seat #4 is the button
Seat 1: dimetruk (1310 in chips)
Seat 2: Vandbro (4100 in chips)
Seat 3: ShaiC`akes (1382 in chips)
Seat 4: boors19 (1872 in chips)
Seat 5: platosha666 (4836 in chips)
dimetruk: posts the ante 10
Vandbro: posts the ante 10
ShaiC`akes: posts the ante 10
boors19: posts the ante 10
platosha666: posts the ante 10
platosha666: posts small blind 40
dimetruk: posts big blind 80
*** HOLE CARDS ***
Dealt to dimetruk [6c 7h]
Vandbro: raises 80 to 160
ShaiC`akes: folds
boors19: folds
platosha666: folds
dimetruk: calls 80
*** FLOP *** [4s 3c Kh]
dimetruk: checks
Vandbro: bets 90
dimetruk: calls 90
*** TURN *** [4s 3c Kh] [3h]
dimetruk: checks
Vandbro: checks
*** RIVER *** [4s 3c Kh 3h] [Qh]
dimetruk: bets 325
Vandbro: calls 325
*** SHOW DOWN ***
dimetruk: shows [6c 7h] (a pair of Threes)
Vandbro: shows [Kd 8d] (two pair, Kings and Threes)
Vandbro collected 1240 from pot
*** SUMMARY ***
Total pot 1240 | Rake 0
Board [4s 3c Kh 3h Qh]
Seat 1: dimetruk (big blind) showed [6c 7h] and lost with a pair of Threes
Seat 2: Vandbro showed [Kd 8d] and won (1240) with two pair, Kings and Threes
Seat 3: ShaiC`akes folded before Flop (didn't bet)
Seat 4: boors19 (button) folded before Flop (didn't bet)
Seat 5: platosha666 (small blind) folded before Flop


PokerStars Hand #226501205527: Tournament #3187770419, $27.40+$2.60 USD Hold'em No Limit - Level IV (40/80) - 2021/05/06 7:12:51 MSK [2021/05/06 0:12:51 ET]
Table '3187770419 1' 9-max Seat #1 is the button
Seat 1: dimetruk (675 in chips)
Seat 2: Vandbro (4665 in chips)
Seat 3: ShaiC`akes (1362 in chips)
Seat 4: boors19 (1692 in chips)
Seat 5: platosha666 (5106 in chips)
dimetruk: posts the ante 10
Vandbro: posts the ante 10
ShaiC`akes: posts the ante 10
boors19: posts the ante 10
platosha666: posts the ante 10
Vandbro: posts small blind 40
ShaiC`akes: posts big blind 80
*** HOLE CARDS ***
Dealt to dimetruk [Qd Ad]
boors19: folds
platosha666: raises 80 to 160
dimetruk: raises 505 to 665 and is all-in
Vandbro: folds
ShaiC`akes: folds
platosha666: calls 505
*** FLOP *** [Jc 7d 5s]
*** TURN *** [Jc 7d 5s] [8h]
*** RIVER *** [Jc 7d 5s 8h] [8s]
*** SHOW DOWN ***
platosha666: shows [Td Kh] (a pair of Eights)
dimetruk: shows [Qd Ad] (a pair of Eights - Ace kicker)
dimetruk collected 1500 from pot
*** SUMMARY ***
Total pot 1500 | Rake 0
Board [Jc 7d 5s 8h 8s]
Seat 1: dimetruk (button) showed [Qd Ad] and won (1500) with a pair of Eights
Seat 2: Vandbro (small blind) folded before Flop
Seat 3: ShaiC`akes (big blind) folded before Flop
Seat 4: boors19 folded before Flop (didn't bet)
Seat 5: platosha666 showed [Td Kh] and lost with a pair of Eights


PokerStars Hand #226501248143: Tournament #3187770419, $27.40+$2.60 USD Hold'em No Limit - Level V (60/120) - 2021/05/06 7:16:06 MSK [2021/05/06 0:16:06 ET]
Table '3187770419 1' 9-max Seat #1 is the button
Seat 1: dimetruk (1585 in chips)
Seat 2: Vandbro (4190 in chips)
Seat 3: ShaiC`akes (1862 in chips)
Seat 4: boors19 (1257 in chips)
Seat 5: platosha666 (4606 in chips)
dimetruk: posts the ante 15
Vandbro: posts the ante 15
ShaiC`akes: posts the ante 15
boors19: posts the ante 15
platosha666: posts the ante 15
Vandbro: posts small blind 60
ShaiC`akes: posts big blind 120
*** HOLE CARDS ***
Dealt to dimetruk [Kh Qh]
boors19: folds
platosha666: folds
dimetruk: raises 1450 to 1570 and is all-in
Vandbro: folds
ShaiC`akes: calls 1450
*** FLOP *** [Kd 8s 9c]
*** TURN *** [Kd 8s 9c] [Th]
*** RIVER *** [Kd 8s 9c Th] [Jh]
*** SHOW DOWN ***
ShaiC`akes: shows [Ah Kc] (a pair of Kings)
dimetruk: shows [Kh Qh] (a straight, Nine to King)
dimetruk collected 3275 from pot
*** SUMMARY ***
Total pot 3275 | Rake 0
Board [Kd 8s 9c Th Jh]
Seat 1: dimetruk (button) showed [Kh Qh] and won (3275) with a straight, Nine to King
Seat 2: Vandbro (small blind) folded before Flop
Seat 3: ShaiC`akes (big blind) showed [Ah Kc] and lost with a pair of Kings
Seat 4: boors19 folded before Flop (didn't bet)
Seat 5: platosha666 folded before Flop (didn't bet)


PokerStars Hand #226501329117: Tournament #3187770419, $27.40+$2.60 USD Hold'em No Limit - Level V (60/120) - 2021/05/06 7:22:54 MSK [2021/05/06 0:22:54 ET]
Table '3187770419 1' 9-max Seat #4 is the button
Seat 1: dimetruk (2060 in chips)
Seat 2: Vandbro (2900 in chips)
Seat 4: boors19 (1804 in chips)
Seat 5: platosha666 (6736 in chips)
dimetruk: posts the ante 15
Vandbro: posts the ante 15
boors19: posts the ante 15
platosha666: posts the ante 15
platosha666: posts small blind 60
dimetruk: posts big blind 120
*** HOLE CARDS ***
Dealt to dimetruk [9h Qs]
Vandbro: folds
boors19: folds
platosha666: raises 120 to 240
dimetruk: calls 120
*** FLOP *** [8d 3h 9c]
platosha666: bets 178
dimetruk: raises 1627 to 1805 and is all-in
platosha666: folds
Uncalled bet (1627) returned to dimetruk
dimetruk collected 896 from pot
dimetruk: doesn't show hand
*** SUMMARY ***
Total pot 896 | Rake 0
Board [8d 3h 9c]
Seat 1: dimetruk (big blind) collected (896)
Seat 2: Vandbro folded before Flop (didn't bet)
Seat 4: boors19 (button) folded before Flop (didn't bet)
Seat 5: platosha666 (small blind) folded on the Flop


PokerStars Hand #226501417930: Tournament #3187770419, $27.40+$2.60 USD Hold'em No Limit - Level VI (80/160) - 2021/05/06 7:30:04 MSK [2021/05/06 0:30:04 ET]
Table '3187770419 1' 9-max Seat #4 is the button
Seat 1: dimetruk (1448 in chips)
Seat 2: Vandbro (2244 in chips)
Seat 4: boors19 (2228 in chips)
Seat 5: platosha666 (7580 in chips)
dimetruk: posts the ante 20
Vandbro: posts the ante 20
boors19: posts the ante 20
platosha666: posts the ante 20
platosha666: posts small blind 80
dimetruk: posts big blind 160
*** HOLE CARDS ***
Dealt to dimetruk [3h 6c]
Vandbro: folds
boors19: calls 160
platosha666: calls 80
dimetruk: checks
*** FLOP *** [Js 8d 9d]
platosha666: checks
dimetruk: checks
boors19: bets 320
platosha666: folds
dimetruk: folds
Uncalled bet (320) returned to boors19
boors19 collected 560 from pot
*** SUMMARY ***
Total pot 560 | Rake 0
Board [Js 8d 9d]
Seat 1: dimetruk (big blind) folded on the Flop
Seat 2: Vandbro folded before Flop (didn't bet)
Seat 4: boors19 (button) collected (560)
Seat 5: platosha666 (small blind) folded on the Flop


PokerStars Hand #226501422289: Tournament #3187770419, $27.40+$2.60 USD Hold'em No Limit - Level VI (80/160) - 2021/05/06 7:30:28 MSK [2021/05/06 0:30:28 ET]
Table '3187770419 1' 9-max Seat #5 is the button
Seat 1: dimetruk (1268 in chips)
Seat 2: Vandbro (2224 in chips)
Seat 4: boors19 (2608 in chips)
Seat 5: platosha666 (7400 in chips)
dimetruk: posts the ante 20
Vandbro: posts the ante 20
boors19: posts the ante 20
platosha666: posts the ante 20
dimetruk: posts small blind 80
Vandbro: posts big blind 160
*** HOLE CARDS ***
Dealt to dimetruk [Ac Ks]
boors19: folds
platosha666: raises 7220 to 7380 and is all-in
dimetruk: calls 1168 and is all-in
Vandbro: folds
Uncalled bet (6132) returned to platosha666
*** FLOP *** [8s 3s 8d]
*** TURN *** [8s 3s 8d] [5d]
*** RIVER *** [8s 3s 8d 5d] [Td]
*** SHOW DOWN ***
dimetruk: shows [Ac Ks] (a pair of Eights)
platosha666: shows [Qc 3d] (two pair, Eights and Threes)
platosha666 collected 2736 from pot
dimetruk finished the tournament in 4th place
*** SUMMARY ***
Total pot 2736 | Rake 0
Board [8s 3s 8d 5d Td]
Seat 1: dimetruk (small blind) showed [Ac Ks] and lost with a pair of Eights
Seat 2: Vandbro (big blind) folded before Flop
Seat 4: boors19 folded before Flop (didn't bet)
Seat 5: platosha666 (button) showed [Qc 3d] and won (2736) with two pair, Eights and Threes


PokerStars Hand #226511030943: Tournament #3188052591, $13.70+$1.30 USD Hold'em No Limit - Level I (10/20) - 2021/05/06 18:23:37 MSK [2021/05/06 11:23:37 ET]
Table '3188052591 1' 9-max Seat #1 is the button
Seat 1: kutraDima (1500 in chips)
Seat 2: Kein heraus. (1500 in chips) is sitting out
Seat 3: dimetruk (1500 in chips)
Seat 4: Niekuhh (1500 in chips)
Seat 5: suru2010 (1500 in chips)
Seat 6: Nikola92975 (1500 in chips)
Seat 7: pokerpro019 (1500 in chips)
Seat 8: masterpatje0521 (1500 in chips)
Seat 9: AceTchelo (1500 in chips)
kutraDima: posts the ante 3
Kein heraus.: posts the ante 3
dimetruk: posts the ante 3
Niekuhh: posts the ante 3
suru2010: posts the ante 3
Nikola92975: posts the ante 3
pokerpro019: posts the ante 3
masterpatje0521: posts the ante 3
AceTchelo: posts the ante 3
Kein heraus.: posts small blind 10
dimetruk: posts big blind 20
*** HOLE CARDS ***
Dealt to dimetruk [7h 3c]
Niekuhh: calls 20
suru2010: folds
Nikola92975: folds
pokerpro019: folds
masterpatje0521: calls 20
AceTchelo: folds
kutraDima: calls 20
Kein heraus.: folds
dimetruk: checks
*** FLOP *** [7d 3s Kc]
dimetruk: checks
Niekuhh: checks
masterpatje0521: checks
kutraDima: checks
*** TURN *** [7d 3s Kc] [Jh]
dimetruk: bets 64
Niekuhh: calls 64
masterpatje0521: folds
Kein heraus. has returned
kutraDima: calls 64
*** RIVER *** [7d 3s Kc Jh] [2d]
dimetruk: bets 232
Niekuhh: calls 232
kutraDima: folds
*** SHOW DOWN ***
dimetruk: shows [7h 3c] (two pair, Sevens and Threes)
Niekuhh: mucks hand
dimetruk collected 773 from pot
*** SUMMARY ***
Total pot 773 | Rake 0
Board [7d 3s Kc Jh 2d]
Seat 1: kutraDima (button) folded on the River
Seat 2: Kein heraus. (small blind) folded before Flop
Seat 3: dimetruk (big blind) showed [7h 3c] and won (773) with two pair, Sevens and Threes
Seat 4: Niekuhh mucked [Qc Ks]
Seat 5: suru2010 folded before Flop (didn't bet)
Seat 6: Nikola92975 folded before Flop (didn't bet)
Seat 7: pokerpro019 folded before Flop (didn't bet)
Seat 8: masterpatje0521 folded on the Turn
Seat 9: AceTchelo folded before Flop (didn't bet)


PokerStars Hand #226511159729: Tournament #3188052591, $13.70+$1.30 USD Hold'em No Limit - Level I (10/20) - 2021/05/06 18:28:35 MSK [2021/05/06 11:28:35 ET]
Table '3188052591 1' 9-max Seat #6 is the button
Seat 1: kutraDima (1401 in chips)
Seat 2: Kein heraus. (1362 in chips)
Seat 3: dimetruk (1932 in chips)
Seat 4: Niekuhh (1146 in chips)
Seat 5: suru2010 (1455 in chips)
Seat 6: Nikola92975 (1455 in chips)
Seat 7: pokerpro019 (1799 in chips)
Seat 8: masterpatje0521 (1465 in chips)
Seat 9: AceTchelo (1485 in chips)
kutraDima: posts the ante 3
Kein heraus.: posts the ante 3
dimetruk: posts the ante 3
Niekuhh: posts the ante 3
suru2010: posts the ante 3
Nikola92975: posts the ante 3
pokerpro019: posts the ante 3
masterpatje0521: posts the ante 3
AceTchelo: posts the ante 3
pokerpro019: posts small blind 10
masterpatje0521: posts big blind 20
*** HOLE CARDS ***
Dealt to dimetruk [7h As]
AceTchelo: folds
kutraDima: folds
Kein heraus.: folds
dimetruk: raises 20 to 40
Niekuhh: calls 40
suru2010: folds
Nikola92975: folds
pokerpro019: calls 30
masterpatje0521: calls 20
*** FLOP *** [3d Ks Jc]
pokerpro019: checks
masterpatje0521: checks
dimetruk: checks
Niekuhh: checks
*** TURN *** [3d Ks Jc] [6c]
pokerpro019: checks
masterpatje0521: bets 40
dimetruk: folds
Niekuhh: calls 40
pokerpro019: folds
*** RIVER *** [3d Ks Jc 6c] [8h]
masterpatje0521: bets 40
Niekuhh: raises 180 to 220
masterpatje0521: folds [Jd]
Uncalled bet (180) returned to Niekuhh
Niekuhh collected 347 from pot
*** SUMMARY ***
Total pot 347 | Rake 0
Board [3d Ks Jc 6c 8h]
Seat 1: kutraDima folded before Flop (didn't bet)
Seat 2: Kein heraus. folded before Flop (didn't bet)
Seat 3: dimetruk folded on the Turn
Seat 4: Niekuhh collected (347)
Seat 5: suru2010 folded before Flop (didn't bet)
Seat 6: Nikola92975 (button) folded before Flop (didn't bet)
Seat 7: pokerpro019 (small blind) folded on the Turn
Seat 8: masterpatje0521 (big blind) folded on the River
Seat 9: AceTchelo folded before Flop (didn't bet)


PokerStars Hand #226511285990: Tournament #3188052591, $13.70+$1.30 USD Hold'em No Limit - Level I (10/20) - 2021/05/06 18:33:36 MSK [2021/05/06 11:33:36 ET]
Table '3188052591 1' 9-max Seat #3 is the button
Seat 1: kutraDima (1430 in chips)
Seat 2: Kein heraus. (1274 in chips)
Seat 3: dimetruk (1804 in chips)
Seat 4: Niekuhh (1399 in chips)
Seat 5: suru2010 (1417 in chips)
Seat 6: Nikola92975 (1504 in chips)
Seat 7: pokerpro019 (1741 in chips)
Seat 8: masterpatje0521 (1317 in chips)
Seat 9: AceTchelo (1614 in chips)
kutraDima: posts the ante 3
Kein heraus.: posts the ante 3
dimetruk: posts the ante 3
Niekuhh: posts the ante 3
suru2010: posts the ante 3
Nikola92975: posts the ante 3
pokerpro019: posts the ante 3
masterpatje0521: posts the ante 3
AceTchelo: posts the ante 3
Niekuhh: posts small blind 10
suru2010: posts big blind 20
*** HOLE CARDS ***
Dealt to dimetruk [Td Ts]
Nikola92975: folds
pokerpro019: folds
masterpatje0521: folds
AceTchelo: folds
kutraDima: folds
Kein heraus.: calls 20
dimetruk: raises 40 to 60
Niekuhh: folds
suru2010: folds
Kein heraus.: calls 40
*** FLOP *** [7s 2s Ac]
Kein heraus.: checks
dimetruk: bets 58
Kein heraus.: calls 58
*** TURN *** [7s 2s Ac] [Tc]
Kein heraus.: checks
dimetruk: bets 220
Kein heraus.: folds
Uncalled bet (220) returned to dimetruk
dimetruk collected 293 from pot
dimetruk: doesn't show hand
*** SUMMARY ***
Total pot 293 | Rake 0
Board [7s 2s Ac Tc]
Seat 1: kutraDima folded before Flop (didn't bet)
Seat 2: Kein heraus. folded on the Turn
Seat 3: dimetruk (button) collected (293)
Seat 4: Niekuhh (small blind) folded before Flop
Seat 5: suru2010 (big blind) folded before Flop
Seat 6: Nikola92975 folded before Flop (didn't bet)
Seat 7: pokerpro019 folded before Flop (didn't bet)
Seat 8: masterpatje0521 folded before Flop (didn't bet)
Seat 9: AceTchelo folded before Flop (didn't bet)


PokerStars Hand #226511347313: Tournament #3188052591, $13.70+$1.30 USD Hold'em No Limit - Level II (15/30) - 2021/05/06 18:36:01 MSK [2021/05/06 11:36:01 ET]
Table '3188052591 1' 9-max Seat #5 is the button
Seat 1: kutraDima (3107 in chips)
Seat 2: Kein heraus. (1149 in chips)
Seat 3: dimetruk (1972 in chips)
Seat 4: Niekuhh (1382 in chips)
Seat 5: suru2010 (1375 in chips)
Seat 6: Nikola92975 (1467 in chips)
Seat 7: pokerpro019 (1584 in chips)
Seat 8: masterpatje0521 (1280 in chips)
Seat 9: AceTchelo (184 in chips)
kutraDima: posts the ante 4
Kein heraus.: posts the ante 4
dimetruk: posts the ante 4
Niekuhh: posts the ante 4
suru2010: posts the ante 4
Nikola92975: posts the ante 4
pokerpro019: posts the ante 4
masterpatje0521: posts the ante 4
AceTchelo: posts the ante 4
Nikola92975: posts small blind 15
pokerpro019: posts big blind 30
*** HOLE CARDS ***
Dealt to dimetruk [9c Ac]
masterpatje0521: calls 30
AceTchelo: folds
kutraDima: folds
Kein heraus.: calls 30
dimetruk: raises 60 to 90
Niekuhh: folds
suru2010: folds
Nikola92975: folds
pokerpro019: folds
masterpatje0521: calls 60
Kein heraus.: calls 60
*** FLOP *** [Js 6h 4s]
masterpatje0521: checks
Kein heraus.: checks
dimetruk: checks
*** TURN *** [Js 6h 4s] [8c]
masterpatje0521: checks
Kein heraus.: checks
dimetruk: bets 158
masterpatje0521: calls 158
Kein heraus.: calls 158
*** RIVER *** [Js 6h 4s 8c] [4d]
masterpatje0521: checks
Kein heraus.: checks
dimetruk: bets 454
masterpatje0521: folds
Kein heraus.: folds
Uncalled bet (454) returned to dimetruk
dimetruk collected 825 from pot
dimetruk: doesn't show hand
*** SUMMARY ***
Total pot 825 | Rake 0
Board [Js 6h 4s 8c 4d]
Seat 1: kutraDima folded before Flop (didn't bet)
Seat 2: Kein heraus. folded on the River
Seat 3: dimetruk collected (825)
Seat 4: Niekuhh folded before Flop (didn't bet)
Seat 5: suru2010 (button) folded before Flop (didn't bet)
Seat 6: Nikola92975 (small blind) folded before Flop
Seat 7: pokerpro019 (big blind) folded before Flop
Seat 8: masterpatje0521 folded on the River
Seat 9: AceTchelo folded before Flop (didn't bet)


PokerStars Hand #226511646552: Tournament #3188052591, $13.70+$1.30 USD Hold'em No Limit - Level III (25/50) - 2021/05/06 18:47:33 MSK [2021/05/06 11:47:33 ET]
Table '3188052591 1' 9-max Seat #4 is the button
Seat 1: kutraDima (3676 in chips)
Seat 2: Kein heraus. (549 in chips)
Seat 3: dimetruk (2436 in chips)
Seat 4: Niekuhh (1361 in chips)
Seat 5: suru2010 (1109 in chips)
Seat 6: Nikola92975 (1789 in chips)
Seat 7: pokerpro019 (1444 in chips)
Seat 8: masterpatje0521 (1136 in chips)
kutraDima: posts the ante 6
Kein heraus.: posts the ante 6
dimetruk: posts the ante 6
Niekuhh: posts the ante 6
suru2010: posts the ante 6
Nikola92975: posts the ante 6
pokerpro019: posts the ante 6
masterpatje0521: posts the ante 6
suru2010: posts small blind 25
Nikola92975: posts big blind 50
*** HOLE CARDS ***
Dealt to dimetruk [Kh Ac]
pokerpro019: folds
masterpatje0521: folds
kutraDima: folds
Kein heraus.: calls 50
dimetruk: raises 112 to 162
Niekuhh: folds
suru2010: folds
Nikola92975: folds
Kein heraus.: raises 381 to 543 and is all-in
dimetruk: calls 381
*** FLOP *** [9s 6c 6d]
*** TURN *** [9s 6c 6d] [5d]
*** RIVER *** [9s 6c 6d 5d] [8c]
*** SHOW DOWN ***
Kein heraus.: shows [Jd Ah] (a pair of Sixes)
dimetruk: shows [Kh Ac] (a pair of Sixes - Ace+King kicker)
dimetruk collected 1209 from pot
Kein heraus. finished the tournament in 8th place
*** SUMMARY ***
Total pot 1209 | Rake 0
Board [9s 6c 6d 5d 8c]
Seat 1: kutraDima folded before Flop (didn't bet)
Seat 2: Kein heraus. showed [Jd Ah] and lost with a pair of Sixes
Seat 3: dimetruk showed [Kh Ac] and won (1209) with a pair of Sixes
Seat 4: Niekuhh (button) folded before Flop (didn't bet)
Seat 5: suru2010 (small blind) folded before Flop
Seat 6: Nikola92975 (big blind) folded before Flop
Seat 7: pokerpro019 folded before Flop (didn't bet)
Seat 8: masterpatje0521 folded before Flop (didn't bet)


PokerStars Hand #226511711678: Tournament #3188052591, $13.70+$1.30 USD Hold'em No Limit - Level III (25/50) - 2021/05/06 18:49:58 MSK [2021/05/06 11:49:58 ET]
Table '3188052591 1' 9-max Seat #8 is the button
Seat 1: kutraDima (3542 in chips)
Seat 3: dimetruk (3078 in chips)
Seat 4: Niekuhh (1237 in chips)
Seat 5: suru2010 (1227 in chips)
Seat 6: Nikola92975 (1867 in chips)
Seat 7: pokerpro019 (1512 in chips)
Seat 8: masterpatje0521 (1037 in chips)
kutraDima: posts the ante 6
dimetruk: posts the ante 6
Niekuhh: posts the ante 6
suru2010: posts the ante 6
Nikola92975: posts the ante 6
pokerpro019: posts the ante 6
masterpatje0521: posts the ante 6
kutraDima: posts small blind 25
dimetruk: posts big blind 50
*** HOLE CARDS ***
Dealt to dimetruk [9c 2c]
Niekuhh: calls 50
suru2010: folds
Nikola92975: folds
pokerpro019: calls 50
masterpatje0521: folds
kutraDima: calls 25
dimetruk: checks
*** FLOP *** [9s 5h Kh]
kutraDima: checks
dimetruk: checks
Niekuhh: checks
pokerpro019: checks
*** TURN *** [9s 5h Kh] [Tc]
kutraDima: checks
dimetruk: bets 80
Niekuhh: folds
pokerpro019: calls 80
kutraDima: folds
*** RIVER *** [9s 5h Kh Tc] [8s]
dimetruk: bets 221
pokerpro019: folds
Uncalled bet (221) returned to dimetruk
dimetruk collected 402 from pot
dimetruk: doesn't show hand
*** SUMMARY ***
Total pot 402 | Rake 0
Board [9s 5h Kh Tc 8s]
Seat 1: kutraDima (small blind) folded on the Turn
Seat 3: dimetruk (big blind) collected (402)
Seat 4: Niekuhh folded on the Turn
Seat 5: suru2010 folded before Flop (didn't bet)
Seat 6: Nikola92975 folded before Flop (didn't bet)
Seat 7: pokerpro019 folded on the River
Seat 8: masterpatje0521 (button) folded before Flop (didn't bet)


PokerStars Hand #226511854576: Tournament #3188052591, $13.70+$1.30 USD Hold'em No Limit - Level IV (40/80) - 2021/05/06 18:55:41 MSK [2021/05/06 11:55:41 ET]
Table '3188052591 1' 9-max Seat #7 is the button
Seat 1: kutraDima (3448 in chips)
Seat 3: dimetruk (3498 in chips)
Seat 4: Niekuhh (1338 in chips)
Seat 5: suru2010 (1275 in chips)
Seat 6: Nikola92975 (2075 in chips)
Seat 7: pokerpro019 (843 in chips)
Seat 8: masterpatje0521 (1023 in chips)
kutraDima: posts the ante 10
dimetruk: posts the ante 10
Niekuhh: posts the ante 10
suru2010: posts the ante 10
Nikola92975: posts the ante 10
pokerpro019: posts the ante 10
masterpatje0521: posts the ante 10
masterpatje0521: posts small blind 40
kutraDima: posts big blind 80
*** HOLE CARDS ***
Dealt to dimetruk [Ac Qd]
dimetruk: raises 80 to 160
Niekuhh: folds
suru2010: raises 1105 to 1265 and is all-in
Nikola92975: folds
pokerpro019: folds
masterpatje0521: folds
kutraDima: folds
dimetruk: calls 1105
*** FLOP *** [6s 8d 4d]
*** TURN *** [6s 8d 4d] [7h]
*** RIVER *** [6s 8d 4d 7h] [Td]
*** SHOW DOWN ***
dimetruk: shows [Ac Qd] (high card Ace)
suru2010: shows [Ks As] (high card Ace - King kicker)
suru2010 collected 2720 from pot
*** SUMMARY ***
Total pot 2720 | Rake 0
Board [6s 8d 4d 7h Td]
Seat 1: kutraDima (big blind) folded before Flop
Seat 3: dimetruk showed [Ac Qd] and lost with high card Ace
Seat 4: Niekuhh folded before Flop (didn't bet)
Seat 5: suru2010 showed [Ks As] and won (2720) with high card Ace
Seat 6: Nikola92975 folded before Flop (didn't bet)
Seat 7: pokerpro019 (button) folded before Flop (didn't bet)
Seat 8: masterpatje0521 (small blind) folded before Flop


PokerStars Hand #226511952580: Tournament #3188052591, $13.70+$1.30 USD Hold'em No Limit - Level IV (40/80) - 2021/05/06 19:00:34 MSK [2021/05/06 12:00:34 ET]
Table '3188052591 1' 9-max Seat #8 is the button
Seat 1: kutraDima (3358 in chips)
Seat 3: dimetruk (2603 in chips)
Seat 4: Niekuhh (1328 in chips)
Seat 5: suru2010 (1707 in chips)
Seat 6: Nikola92975 (1875 in chips)
Seat 7: pokerpro019 (1576 in chips)
Seat 8: masterpatje0521 (1053 in chips)
kutraDima: posts the ante 10
dimetruk: posts the ante 10
Niekuhh: posts the ante 10
suru2010: posts the ante 10
Nikola92975: posts the ante 10
pokerpro019: posts the ante 10
masterpatje0521: posts the ante 10
kutraDima: posts small blind 40
dimetruk: posts big blind 80
*** HOLE CARDS ***
Dealt to dimetruk [2h Qc]
Niekuhh: calls 80
suru2010: folds
Nikola92975: folds
pokerpro019: folds
masterpatje0521: calls 80
kutraDima: calls 40
dimetruk: checks
*** FLOP *** [As Jd Kc]
kutraDima: checks
dimetruk: checks
Niekuhh: checks
masterpatje0521: checks
*** TURN *** [As Jd Kc] [3c]
kutraDima: bets 133
dimetruk: folds
Niekuhh: folds
masterpatje0521: folds
Uncalled bet (133) returned to kutraDima
kutraDima collected 390 from pot
kutraDima: doesn't show hand
*** SUMMARY ***
Total pot 390 | Rake 0
Board [As Jd Kc 3c]
Seat 1: kutraDima (small blind) collected (390)
Seat 3: dimetruk (big blind) folded on the Turn
Seat 4: Niekuhh folded on the Turn
Seat 5: suru2010 folded before Flop (didn't bet)
Seat 6: Nikola92975 folded before Flop (didn't bet)
Seat 7: pokerpro019 folded before Flop (didn't bet)
Seat 8: masterpatje0521 (button) folded on the Turn


PokerStars Hand #226511979857: Tournament #3188052591, $13.70+$1.30 USD Hold'em No Limit - Level IV (40/80) - 2021/05/06 19:01:46 MSK [2021/05/06 12:01:46 ET]
Table '3188052591 1' 9-max Seat #1 is the button
Seat 1: kutraDima (3658 in chips)
Seat 3: dimetruk (2513 in chips)
Seat 4: Niekuhh (1238 in chips)
Seat 5: suru2010 (1697 in chips)
Seat 6: Nikola92975 (1865 in chips)
Seat 7: pokerpro019 (1566 in chips)
Seat 8: masterpatje0521 (963 in chips)
kutraDima: posts the ante 10
dimetruk: posts the ante 10
Niekuhh: posts the ante 10
suru2010: posts the ante 10
Nikola92975: posts the ante 10
pokerpro019: posts the ante 10
masterpatje0521: posts the ante 10
dimetruk: posts small blind 40
Niekuhh: posts big blind 80
*** HOLE CARDS ***
Dealt to dimetruk [7s As]
suru2010: folds
Nikola92975: folds
pokerpro019: folds
masterpatje0521: folds
kutraDima: raises 94 to 174
dimetruk: raises 306 to 480
Niekuhh: folds
kutraDima: calls 306
*** FLOP *** [8c 5d 4d]
dimetruk: checks
kutraDima: checks
*** TURN *** [8c 5d 4d] [3c]
dimetruk: bets 611
kutraDima: folds
Uncalled bet (611) returned to dimetruk
dimetruk collected 1110 from pot
dimetruk: doesn't show hand
*** SUMMARY ***
Total pot 1110 | Rake 0
Board [8c 5d 4d 3c]
Seat 1: kutraDima (button) folded on the Turn
Seat 3: dimetruk (small blind) collected (1110)
Seat 4: Niekuhh (big blind) folded before Flop
Seat 5: suru2010 folded before Flop (didn't bet)
Seat 6: Nikola92975 folded before Flop (didn't bet)
Seat 7: pokerpro019 folded before Flop (didn't bet)
Seat 8: masterpatje0521 folded before Flop (didn't bet)


PokerStars Hand #226512107725: Tournament #3188052591, $13.70+$1.30 USD Hold'em No Limit - Level V (60/120) - 2021/05/06 19:06:29 MSK [2021/05/06 12:06:29 ET]
Table '3188052591 1' 9-max Seat #8 is the button
Seat 1: kutraDima (2978 in chips)
Seat 3: dimetruk (2903 in chips)
Seat 4: Niekuhh (1623 in chips)
Seat 5: suru2010 (1767 in chips)
Seat 6: Nikola92975 (1935 in chips)
Seat 7: pokerpro019 (1306 in chips)
Seat 8: masterpatje0521 (988 in chips)
kutraDima: posts the ante 15
dimetruk: posts the ante 15
Niekuhh: posts the ante 15
suru2010: posts the ante 15
Nikola92975: posts the ante 15
pokerpro019: posts the ante 15
masterpatje0521: posts the ante 15
kutraDima: posts small blind 60
dimetruk: posts big blind 120
*** HOLE CARDS ***
Dealt to dimetruk [6c Ad]
Niekuhh: folds
suru2010: folds
Nikola92975: folds
pokerpro019: folds
masterpatje0521: folds
kutraDima: calls 60
dimetruk: checks
*** FLOP *** [Js Td 4h]
kutraDima: checks
dimetruk: checks
*** TURN *** [Js Td 4h] [8s]
kutraDima: checks
dimetruk: bets 180
kutraDima: calls 180
*** RIVER *** [Js Td 4h 8s] [9c]
kutraDima: checks
dimetruk: bets 529
kutraDima: calls 529
*** SHOW DOWN ***
dimetruk: shows [6c Ad] (high card Ace)
kutraDima: shows [8c Qd] (a straight, Eight to Queen)
kutraDima collected 1763 from pot
*** SUMMARY ***
Total pot 1763 | Rake 0
Board [Js Td 4h 8s 9c]
Seat 1: kutraDima (small blind) showed [8c Qd] and won (1763) with a straight, Eight to Queen
Seat 3: dimetruk (big blind) showed [6c Ad] and lost with high card Ace
Seat 4: Niekuhh folded before Flop (didn't bet)
Seat 5: suru2010 folded before Flop (didn't bet)
Seat 6: Nikola92975 folded before Flop (didn't bet)
Seat 7: pokerpro019 folded before Flop (didn't bet)
Seat 8: masterpatje0521 (button) folded before Flop (didn't bet)


PokerStars Hand #226512229853: Tournament #3188052591, $13.70+$1.30 USD Hold'em No Limit - Level V (60/120) - 2021/05/06 19:10:43 MSK [2021/05/06 12:10:43 ET]
Table '3188052591 1' 9-max Seat #7 is the button
Seat 1: kutraDima (4107 in chips)
Seat 3: dimetruk (1924 in chips)
Seat 4: Niekuhh (3063 in chips)
Seat 5: suru2010 (1497 in chips)
Seat 6: Nikola92975 (1365 in chips)
Seat 7: pokerpro019 (196 in chips)
Seat 8: masterpatje0521 (1348 in chips)
kutraDima: posts the ante 15
dimetruk: posts the ante 15
Niekuhh: posts the ante 15
suru2010: posts the ante 15
Nikola92975: posts the ante 15
pokerpro019: posts the ante 15
masterpatje0521: posts the ante 15
masterpatje0521: posts small blind 60
kutraDima: posts big blind 120
*** HOLE CARDS ***
Dealt to dimetruk [Qs Kc]
dimetruk: raises 120 to 240
Niekuhh: folds
suru2010: folds
Nikola92975: folds
pokerpro019: calls 181 and is all-in
masterpatje0521: folds
kutraDima: calls 120
*** FLOP *** [9c 8c 4d]
kutraDima: checks
dimetruk: bets 454
kutraDima: calls 454
*** TURN *** [9c 8c 4d] [9d]
Niekuhh is sitting out
kutraDima: checks
dimetruk: checks
*** RIVER *** [9c 8c 4d 9d] [5d]
kutraDima: bets 902
dimetruk: folds
Uncalled bet (902) returned to kutraDima
*** SHOW DOWN ***
kutraDima: shows [Jd Tc] (a pair of Nines)
kutraDima collected 1026 from side pot
pokerpro019: shows [9s Ah] (three of a kind, Nines)
pokerpro019 collected 708 from main pot
*** SUMMARY ***
Total pot 1734 Main pot 708. Side pot 1026. | Rake 0
Board [9c 8c 4d 9d 5d]
Seat 1: kutraDima (big blind) showed [Jd Tc] and won (1026) with a pair of Nines
Seat 3: dimetruk folded on the River
Seat 4: Niekuhh folded before Flop (didn't bet)
Seat 5: suru2010 folded before Flop (didn't bet)
Seat 6: Nikola92975 folded before Flop (didn't bet)
Seat 7: pokerpro019 (button) showed [9s Ah] and won (708) with three of a kind, Nines
Seat 8: masterpatje0521 (small blind) folded before Flop


PokerStars Hand #226512304249: Tournament #3188052591, $13.70+$1.30 USD Hold'em No Limit - Level V (60/120) - 2021/05/06 19:13:23 MSK [2021/05/06 12:13:23 ET]
Table '3188052591 1' 9-max Seat #4 is the button
Seat 1: kutraDima (4425 in chips)
Seat 3: dimetruk (990 in chips)
Seat 4: Niekuhh (2823 in chips)
Seat 5: suru2010 (3024 in chips)
Seat 6: Nikola92975 (1575 in chips)
Seat 7: pokerpro019 (663 in chips)
kutraDima: posts the ante 15
dimetruk: posts the ante 15
Niekuhh: posts the ante 15
suru2010: posts the ante 15
Nikola92975: posts the ante 15
pokerpro019: posts the ante 15
suru2010: posts small blind 60
Nikola92975: posts big blind 120
*** HOLE CARDS ***
Dealt to dimetruk [Ah 5h]
pokerpro019: folds
kutraDima: raises 141 to 261
dimetruk: raises 714 to 975 and is all-in
Niekuhh: folds
suru2010: folds
Nikola92975: folds
kutraDima: calls 714
*** FLOP *** [Jh 4h 7d]
*** TURN *** [Jh 4h 7d] [Ac]
*** RIVER *** [Jh 4h 7d Ac] [7s]
*** SHOW DOWN ***
kutraDima: shows [Td Ts] (two pair, Tens and Sevens)
dimetruk: shows [Ah 5h] (two pair, Aces and Sevens)
dimetruk collected 2220 from pot
*** SUMMARY ***
Total pot 2220 | Rake 0
Board [Jh 4h 7d Ac 7s]
Seat 1: kutraDima showed [Td Ts] and lost with two pair, Tens and Sevens
Seat 3: dimetruk showed [Ah 5h] and won (2220) with two pair, Aces and Sevens
Seat 4: Niekuhh (button) folded before Flop (didn't bet)
Seat 5: suru2010 (small blind) folded before Flop
Seat 6: Nikola92975 (big blind) folded before Flop
Seat 7: pokerpro019 folded before Flop (didn't bet)


PokerStars Hand #226512464669: Tournament #3188052591, $13.70+$1.30 USD Hold'em No Limit - Level VI (80/160) - 2021/05/06 19:19:25 MSK [2021/05/06 12:19:25 ET]
Table '3188052591 1' 9-max Seat #7 is the button
Seat 1: kutraDima (4355 in chips)
Seat 3: dimetruk (1840 in chips)
Seat 4: Niekuhh (1358 in chips)
Seat 5: suru2010 (4443 in chips)
Seat 7: pokerpro019 (1504 in chips)
kutraDima: posts the ante 20
dimetruk: posts the ante 20
Niekuhh: posts the ante 20
suru2010: posts the ante 20
pokerpro019: posts the ante 20
kutraDima: posts small blind 80
dimetruk: posts big blind 160
*** HOLE CARDS ***
Dealt to dimetruk [8c 9c]
Niekuhh: folds
suru2010: raises 160 to 320
pokerpro019: folds
kutraDima: folds
dimetruk: calls 160
*** FLOP *** [Js 3d 9s]
dimetruk: checks
suru2010: checks
*** TURN *** [Js 3d 9s] [3c]
dimetruk: bets 1500 and is all-in
suru2010: folds
Uncalled bet (1500) returned to dimetruk
dimetruk collected 820 from pot
dimetruk: doesn't show hand
*** SUMMARY ***
Total pot 820 | Rake 0
Board [Js 3d 9s 3c]
Seat 1: kutraDima (small blind) folded before Flop
Seat 3: dimetruk (big blind) collected (820)
Seat 4: Niekuhh folded before Flop (didn't bet)
Seat 5: suru2010 folded on the Turn
Seat 7: pokerpro019 (button) folded before Flop (didn't bet)


PokerStars Hand #226512576114: Tournament #3188052591, $13.70+$1.30 USD Hold'em No Limit - Level VI (80/160) - 2021/05/06 19:23:36 MSK [2021/05/06 12:23:36 ET]
Table '3188052591 1' 9-max Seat #7 is the button
Seat 1: kutraDima (3695 in chips)
Seat 3: dimetruk (2520 in chips)
Seat 4: Niekuhh (1018 in chips)
Seat 5: suru2010 (5103 in chips)
Seat 7: pokerpro019 (1164 in chips)
kutraDima: posts the ante 20
dimetruk: posts the ante 20
Niekuhh: posts the ante 20
suru2010: posts the ante 20
pokerpro019: posts the ante 20
kutraDima: posts small blind 80
dimetruk: posts big blind 160
*** HOLE CARDS ***
Dealt to dimetruk [4s Td]
Niekuhh: folds
suru2010: folds
pokerpro019: folds
kutraDima: calls 80
dimetruk: checks
*** FLOP *** [6c 8s 9h]
kutraDima: checks
dimetruk: checks
*** TURN *** [6c 8s 9h] [Kd]
kutraDima: checks
dimetruk: checks
*** RIVER *** [6c 8s 9h Kd] [5h]
kutraDima: checks
dimetruk: bets 315
kutraDima: calls 315
*** SHOW DOWN ***
dimetruk: shows [4s Td] (high card King)
kutraDima: shows [Ks 2d] (a pair of Kings)
kutraDima collected 1050 from pot
*** SUMMARY ***
Total pot 1050 | Rake 0
Board [6c 8s 9h Kd 5h]
Seat 1: kutraDima (small blind) showed [Ks 2d] and won (1050) with a pair of Kings
Seat 3: dimetruk (big blind) showed [4s Td] and lost with high card King
Seat 4: Niekuhh folded before Flop (didn't bet)
Seat 5: suru2010 folded before Flop (didn't bet)
Seat 7: pokerpro019 (button) folded before Flop (didn't bet)


PokerStars Hand #226512815735: Tournament #3188052591, $13.70+$1.30 USD Hold'em No Limit - Level VII (100/200) - 2021/05/06 19:31:46 MSK [2021/05/06 12:31:46 ET]
Table '3188052591 1' 9-max Seat #1 is the button
Seat 1: kutraDima (4977 in chips)
Seat 3: dimetruk (1500 in chips)
Seat 5: suru2010 (3460 in chips)
Seat 7: pokerpro019 (3563 in chips)
kutraDima: posts the ante 25
dimetruk: posts the ante 25
suru2010: posts the ante 25
pokerpro019: posts the ante 25
dimetruk: posts small blind 100
suru2010: posts big blind 200
*** HOLE CARDS ***
Dealt to dimetruk [Th 4h]
pokerpro019: folds
kutraDima: calls 200
dimetruk: calls 100
suru2010: checks
*** FLOP *** [3c 7h Ad]
dimetruk: checks
suru2010: checks
kutraDima: bets 238
dimetruk: folds
suru2010: folds
Uncalled bet (238) returned to kutraDima
kutraDima collected 700 from pot
kutraDima: doesn't show hand
*** SUMMARY ***
Total pot 700 | Rake 0
Board [3c 7h Ad]
Seat 1: kutraDima (button) collected (700)
Seat 3: dimetruk (small blind) folded on the Flop
Seat 5: suru2010 (big blind) folded on the Flop
Seat 7: pokerpro019 folded before Flop (didn't bet)


PokerStars Hand #226512850747: Tournament #3188052591, $13.70+$1.30 USD Hold'em No Limit - Level VII (100/200) - 2021/05/06 19:33:01 MSK [2021/05/06 12:33:01 ET]
Table '3188052591 1' 9-max Seat #7 is the button
Seat 1: kutraDima (6002 in chips)
Seat 3: dimetruk (1225 in chips)
Seat 5: suru2010 (3085 in chips)
Seat 7: pokerpro019 (3188 in chips)
kutraDima: posts the ante 25
dimetruk: posts the ante 25
suru2010: posts the ante 25
pokerpro019: posts the ante 25
kutraDima: posts small blind 100
dimetruk: posts big blind 200
*** HOLE CARDS ***
Dealt to dimetruk [Ah Qc]
suru2010: folds
pokerpro019: raises 2963 to 3163 and is all-in
kutraDima: folds
dimetruk: calls 1000 and is all-in
Uncalled bet (1963) returned to pokerpro019
*** FLOP *** [7s 3s Kh]
*** TURN *** [7s 3s Kh] [9c]
*** RIVER *** [7s 3s Kh 9c] [8s]
*** SHOW DOWN ***
dimetruk: shows [Ah Qc] (high card Ace)
pokerpro019: shows [Ac 9s] (a pair of Nines)
pokerpro019 collected 2600 from pot
dimetruk finished the tournament in 4th place
*** SUMMARY ***
Total pot 2600 | Rake 0
Board [7s 3s Kh 9c 8s]
Seat 1: kutraDima (small blind) folded before Flop
Seat 3: dimetruk (big blind) showed [Ah Qc] and lost with high card Ace
Seat 5: suru2010 folded before Flop (didn't bet)
Seat 7: pokerpro019 (button) showed [Ac 9s] and won (2600) with a pair of Nines


PokerStars Hand #226510587405: Tournament #3188065522, $13.79+$1.21 USD Hold'em No Limit - Level I (10/20) - 2021/05/06 18:05:39 MSK [2021/05/06 11:05:39 ET]
Table '3188065522 1' 6-max Seat #2 is the button
Seat 1: Nikola92975 (1497 in chips)
Seat 2: Fischer1972 (1487 in chips)
Seat 3: horne_16 (1525 in chips)
Seat 4: dimetruk (1497 in chips)
Seat 5: ArtEug (1497 in chips)
Seat 6: Monk Gallas (1497 in chips)
Nikola92975: posts the ante 3
Fischer1972: posts the ante 3
horne_16: posts the ante 3
dimetruk: posts the ante 3
ArtEug: posts the ante 3
Monk Gallas: posts the ante 3
horne_16: posts small blind 10
dimetruk: posts big blind 20
*** HOLE CARDS ***
Dealt to dimetruk [6d Jh]
ArtEug: folds
Monk Gallas: raises 20 to 40
Nikola92975: folds
Fischer1972: folds
horne_16: calls 30
dimetruk: calls 20
*** FLOP *** [9s Qs Jd]
horne_16: checks
dimetruk: checks
Monk Gallas: checks
*** TURN *** [9s Qs Jd] [3c]
horne_16: checks
dimetruk: bets 62
Monk Gallas: folds
horne_16: calls 62
*** RIVER *** [9s Qs Jd 3c] [9c]
horne_16: checks
dimetruk: checks
*** SHOW DOWN ***
horne_16: shows [9d Tc] (three of a kind, Nines)
dimetruk: mucks hand
horne_16 collected 262 from pot
*** SUMMARY ***
Total pot 262 | Rake 0
Board [9s Qs Jd 3c 9c]
Seat 1: Nikola92975 folded before Flop (didn't bet)
Seat 2: Fischer1972 (button) folded before Flop (didn't bet)
Seat 3: horne_16 (small blind) showed [9d Tc] and won (262) with three of a kind, Nines
Seat 4: dimetruk (big blind) mucked [6d Jh]
Seat 5: ArtEug folded before Flop (didn't bet)
Seat 6: Monk Gallas folded on the Turn


PokerStars Hand #226510612681: Tournament #3188065522, $13.79+$1.21 USD Hold'em No Limit - Level I (10/20) - 2021/05/06 18:06:43 MSK [2021/05/06 11:06:43 ET]
Table '3188065522 1' 6-max Seat #3 is the button
Seat 1: Nikola92975 (1494 in chips)
Seat 2: Fischer1972 (1484 in chips)
Seat 3: horne_16 (1682 in chips)
Seat 4: dimetruk (1392 in chips)
Seat 5: ArtEug (1494 in chips)
Seat 6: Monk Gallas (1454 in chips)
Nikola92975: posts the ante 3
Fischer1972: posts the ante 3
horne_16: posts the ante 3
dimetruk: posts the ante 3
ArtEug: posts the ante 3
Monk Gallas: posts the ante 3
dimetruk: posts small blind 10
ArtEug: posts big blind 20
*** HOLE CARDS ***
Dealt to dimetruk [Jh Ad]
Monk Gallas: folds
Nikola92975: folds
Fischer1972: folds
horne_16: folds
dimetruk: raises 20 to 40
ArtEug: raises 80 to 120
dimetruk: raises 240 to 360
ArtEug: calls 240
*** FLOP *** [Ks Jd 3s]
dimetruk: checks
ArtEug: checks
*** TURN *** [Ks Jd 3s] [4c]
dimetruk: checks
ArtEug: checks
*** RIVER *** [Ks Jd 3s 4c] [8h]
dimetruk: checks
ArtEug: checks
*** SHOW DOWN ***
dimetruk: shows [Jh Ad] (a pair of Jacks)
ArtEug: mucks hand
dimetruk collected 738 from pot
*** SUMMARY ***
Total pot 738 | Rake 0
Board [Ks Jd 3s 4c 8h]
Seat 1: Nikola92975 folded before Flop (didn't bet)
Seat 2: Fischer1972 folded before Flop (didn't bet)
Seat 3: horne_16 (button) folded before Flop (didn't bet)
Seat 4: dimetruk (small blind) showed [Jh Ad] and won (738) with a pair of Jacks
Seat 5: ArtEug (big blind) mucked [Ac Qs]
Seat 6: Monk Gallas folded before Flop (didn't bet)


PokerStars Hand #226510652289: Tournament #3188065522, $13.79+$1.21 USD Hold'em No Limit - Level I (10/20) - 2021/05/06 18:08:21 MSK [2021/05/06 11:08:21 ET]
Table '3188065522 1' 6-max Seat #5 is the button
Seat 1: Nikola92975 (1444 in chips)
Seat 2: Fischer1972 (1478 in chips)
Seat 3: horne_16 (1768 in chips)
Seat 4: dimetruk (1764 in chips)
Seat 5: ArtEug (1118 in chips)
Seat 6: Monk Gallas (1428 in chips)
Nikola92975: posts the ante 3
Fischer1972: posts the ante 3
horne_16: posts the ante 3
dimetruk: posts the ante 3
ArtEug: posts the ante 3
Monk Gallas: posts the ante 3
Monk Gallas: posts small blind 10
Nikola92975: posts big blind 20
*** HOLE CARDS ***
Dealt to dimetruk [2h Ah]
Fischer1972: folds
horne_16: calls 20
dimetruk: raises 40 to 60
ArtEug: folds
Monk Gallas: folds
Nikola92975: calls 40
horne_16: calls 40
*** FLOP *** [9s 8h 2d]
Nikola92975: checks
horne_16: checks
dimetruk: bets 69
Nikola92975: folds
horne_16: raises 173 to 242
dimetruk: folds
Uncalled bet (173) returned to horne_16
horne_16 collected 346 from pot
horne_16: doesn't show hand
*** SUMMARY ***
Total pot 346 | Rake 0
Board [9s 8h 2d]
Seat 1: Nikola92975 (big blind) folded on the Flop
Seat 2: Fischer1972 folded before Flop (didn't bet)
Seat 3: horne_16 collected (346)
Seat 4: dimetruk folded on the Flop
Seat 5: ArtEug (button) folded before Flop (didn't bet)
Seat 6: Monk Gallas (small blind) folded before Flop


PokerStars Hand #226510683350: Tournament #3188065522, $13.79+$1.21 USD Hold'em No Limit - Level I (10/20) - 2021/05/06 18:09:38 MSK [2021/05/06 11:09:38 ET]
Table '3188065522 1' 6-max Seat #1 is the button
Seat 1: Nikola92975 (1368 in chips)
Seat 2: Fischer1972 (1452 in chips)
Seat 3: horne_16 (1979 in chips)
Seat 4: dimetruk (1677 in chips)
Seat 5: ArtEug (1112 in chips)
Seat 6: Monk Gallas (1412 in chips)
Nikola92975: posts the ante 3
Fischer1972: posts the ante 3
horne_16: posts the ante 3
dimetruk: posts the ante 3
ArtEug: posts the ante 3
Monk Gallas: posts the ante 3
Fischer1972: posts small blind 10
horne_16: posts big blind 20
*** HOLE CARDS ***
Dealt to dimetruk [Ac 7c]
dimetruk: raises 20 to 40
ArtEug: folds
Monk Gallas: folds
Nikola92975: folds
Fischer1972: folds
horne_16: calls 20
*** FLOP *** [Th 5h 5s]
horne_16: checks
dimetruk: checks
*** TURN *** [Th 5h 5s] [8h]
horne_16: bets 20
dimetruk: calls 20
*** RIVER *** [Th 5h 5s 8h] [5c]
horne_16: bets 20
dimetruk: calls 20
*** SHOW DOWN ***
horne_16: shows [4s 8s] (a full house, Fives full of Eights)
dimetruk: mucks hand
horne_16 collected 188 from pot
*** SUMMARY ***
Total pot 188 | Rake 0
Board [Th 5h 5s 8h 5c]
Seat 1: Nikola92975 (button) folded before Flop (didn't bet)
Seat 2: Fischer1972 (small blind) folded before Flop
Seat 3: horne_16 (big blind) showed [4s 8s] and won (188) with a full house, Fives full of Eights
Seat 4: dimetruk mucked [Ac 7c]
Seat 5: ArtEug folded before Flop (didn't bet)
Seat 6: Monk Gallas folded before Flop (didn't bet)


PokerStars Hand #226510725337: Tournament #3188065522, $13.79+$1.21 USD Hold'em No Limit - Level I (10/20) - 2021/05/06 18:11:21 MSK [2021/05/06 11:11:21 ET]
Table '3188065522 1' 6-max Seat #5 is the button
Seat 1: Nikola92975 (1221 in chips)
Seat 2: Fischer1972 (1478 in chips)
Seat 3: horne_16 (969 in chips)
Seat 4: dimetruk (1555 in chips)
Seat 5: ArtEug (2397 in chips)
Seat 6: Monk Gallas (1380 in chips)
Nikola92975: posts the ante 3
Fischer1972: posts the ante 3
horne_16: posts the ante 3
dimetruk: posts the ante 3
ArtEug: posts the ante 3
Monk Gallas: posts the ante 3
Monk Gallas: posts small blind 10
Nikola92975: posts big blind 20
*** HOLE CARDS ***
Dealt to dimetruk [7c 9c]
Fischer1972: folds
horne_16: folds
dimetruk: raises 20 to 40
ArtEug: raises 80 to 120
Monk Gallas: folds
Nikola92975: folds
dimetruk: calls 80
*** FLOP *** [9h Jd Jh]
dimetruk: checks
ArtEug: bets 95
dimetruk: raises 215 to 310
ArtEug: calls 215
*** TURN *** [9h Jd Jh] [Kd]
dimetruk: checks
ArtEug: checks
*** RIVER *** [9h Jd Jh Kd] [7h]
dimetruk: checks
ArtEug: bets 454
dimetruk: folds
Uncalled bet (454) returned to ArtEug
ArtEug collected 908 from pot
*** SUMMARY ***
Total pot 908 | Rake 0
Board [9h Jd Jh Kd 7h]
Seat 1: Nikola92975 (big blind) folded before Flop
Seat 2: Fischer1972 folded before Flop (didn't bet)
Seat 3: horne_16 folded before Flop (didn't bet)
Seat 4: dimetruk folded on the River
Seat 5: ArtEug (button) collected (908)
Seat 6: Monk Gallas (small blind) folded before Flop


PokerStars Hand #226510796728: Tournament #3188065522, $13.79+$1.21 USD Hold'em No Limit - Level I (10/20) - 2021/05/06 18:14:14 MSK [2021/05/06 11:14:14 ET]
Table '3188065522 1' 6-max Seat #2 is the button
Seat 1: Nikola92975 (1182 in chips)
Seat 2: Fischer1972 (1561 in chips)
Seat 3: horne_16 (914 in chips)
Seat 4: dimetruk (1116 in chips)
Seat 5: ArtEug (2866 in chips)
Seat 6: Monk Gallas (1361 in chips)
Nikola92975: posts the ante 3
Fischer1972: posts the ante 3
horne_16: posts the ante 3
dimetruk: posts the ante 3
ArtEug: posts the ante 3
Monk Gallas: posts the ante 3
horne_16: posts small blind 10
dimetruk: posts big blind 20
*** HOLE CARDS ***
Dealt to dimetruk [4c 5d]
ArtEug: raises 25 to 45
Monk Gallas: folds
Nikola92975: folds
Fischer1972: folds
horne_16: folds
dimetruk: calls 25
*** FLOP *** [7c Jh 2c]
dimetruk: checks
ArtEug: bets 77
dimetruk: folds
Uncalled bet (77) returned to ArtEug
ArtEug collected 118 from pot
*** SUMMARY ***
Total pot 118 | Rake 0
Board [7c Jh 2c]
Seat 1: Nikola92975 folded before Flop (didn't bet)
Seat 2: Fischer1972 (button) folded before Flop (didn't bet)
Seat 3: horne_16 (small blind) folded before Flop
Seat 4: dimetruk (big blind) folded on the Flop
Seat 5: ArtEug collected (118)
Seat 6: Monk Gallas folded before Flop (didn't bet)


PokerStars Hand #226510882712: Tournament #3188065522, $13.79+$1.21 USD Hold'em No Limit - Level II (15/30) - 2021/05/06 18:17:43 MSK [2021/05/06 11:17:43 ET]
Table '3188065522 1' 6-max Seat #2 is the button
Seat 1: Nikola92975 (965 in chips)
Seat 2: Fischer1972 (1495 in chips)
Seat 3: horne_16 (1200 in chips)
Seat 4: dimetruk (1139 in chips)
Seat 5: ArtEug (2888 in chips)
Seat 6: Monk Gallas (1313 in chips)
Nikola92975: posts the ante 4
Fischer1972: posts the ante 4
horne_16: posts the ante 4
dimetruk: posts the ante 4
ArtEug: posts the ante 4
Monk Gallas: posts the ante 4
horne_16: posts small blind 15
dimetruk: posts big blind 30
*** HOLE CARDS ***
Dealt to dimetruk [Tc Ts]
ArtEug: folds
Monk Gallas: folds
Nikola92975: folds
Fischer1972: folds
horne_16: calls 15
dimetruk: raises 67 to 97
horne_16: calls 67
*** FLOP *** [9h As Td]
horne_16: checks
dimetruk: bets 98
horne_16: calls 98
*** TURN *** [9h As Td] [2s]
horne_16: checks
dimetruk: bets 228
horne_16: calls 228
*** RIVER *** [9h As Td 2s] [3c]
horne_16: checks
dimetruk: bets 712 and is all-in
horne_16: folds
Uncalled bet (712) returned to dimetruk
dimetruk collected 870 from pot
dimetruk: doesn't show hand
*** SUMMARY ***
Total pot 870 | Rake 0
Board [9h As Td 2s 3c]
Seat 1: Nikola92975 folded before Flop (didn't bet)
Seat 2: Fischer1972 (button) folded before Flop (didn't bet)
Seat 3: horne_16 (small blind) folded on the River
Seat 4: dimetruk (big blind) collected (870)
Seat 5: ArtEug folded before Flop (didn't bet)
Seat 6: Monk Gallas folded before Flop (didn't bet)


PokerStars Hand #226510901675: Tournament #3188065522, $13.79+$1.21 USD Hold'em No Limit - Level II (15/30) - 2021/05/06 18:18:28 MSK [2021/05/06 11:18:28 ET]
Table '3188065522 1' 6-max Seat #3 is the button
Seat 1: Nikola92975 (961 in chips)
Seat 2: Fischer1972 (1491 in chips)
Seat 3: horne_16 (773 in chips)
Seat 4: dimetruk (1582 in chips)
Seat 5: ArtEug (2884 in chips)
Seat 6: Monk Gallas (1309 in chips)
Nikola92975: posts the ante 4
Fischer1972: posts the ante 4
horne_16: posts the ante 4
dimetruk: posts the ante 4
ArtEug: posts the ante 4
Monk Gallas: posts the ante 4
dimetruk: posts small blind 15
ArtEug: posts big blind 30
*** HOLE CARDS ***
Dealt to dimetruk [9c Kc]
Monk Gallas: folds
Nikola92975: folds
Fischer1972: folds
horne_16: calls 30
dimetruk: raises 67 to 97
ArtEug: folds
horne_16: calls 67
*** FLOP *** [9h 2s 9d]
dimetruk: bets 112
horne_16: raises 560 to 672 and is all-in
dimetruk: calls 560
*** TURN *** [9h 2s 9d] [Qc]
*** RIVER *** [9h 2s 9d Qc] [2h]
*** SHOW DOWN ***
dimetruk: shows [9c Kc] (a full house, Nines full of Deuces)
horne_16: shows [Ah Jd] (two pair, Nines and Deuces)
dimetruk collected 1592 from pot
horne_16 finished the tournament in 6th place
*** SUMMARY ***
Total pot 1592 | Rake 0
Board [9h 2s 9d Qc 2h]
Seat 1: Nikola92975 folded before Flop (didn't bet)
Seat 2: Fischer1972 folded before Flop (didn't bet)
Seat 3: horne_16 (button) showed [Ah Jd] and lost with two pair, Nines and Deuces
Seat 4: dimetruk (small blind) showed [9c Kc] and won (1592) with a full house, Nines full of Deuces
Seat 5: ArtEug (big blind) folded before Flop
Seat 6: Monk Gallas folded before Flop (didn't bet)


PokerStars Hand #226510921005: Tournament #3188065522, $13.79+$1.21 USD Hold'em No Limit - Level II (15/30) - 2021/05/06 18:19:15 MSK [2021/05/06 11:19:15 ET]
Table '3188065522 1' 6-max Seat #5 is the button
Seat 1: Nikola92975 (953 in chips)
Seat 2: Fischer1972 (1483 in chips)
Seat 4: dimetruk (2397 in chips)
Seat 5: ArtEug (2831 in chips)
Seat 6: Monk Gallas (1336 in chips)
Nikola92975: posts the ante 4
Fischer1972: posts the ante 4
dimetruk: posts the ante 4
ArtEug: posts the ante 4
Monk Gallas: posts the ante 4
Monk Gallas: posts small blind 15
Nikola92975: posts big blind 30
*** HOLE CARDS ***
Dealt to dimetruk [Kd 9h]
Fischer1972: folds
dimetruk: raises 30 to 60
ArtEug: folds
Monk Gallas: folds
Nikola92975: calls 30
*** FLOP *** [Jd Js 8d]
Nikola92975: checks
dimetruk: checks
*** TURN *** [Jd Js 8d] [Td]
Nikola92975: bets 104
dimetruk: calls 104
*** RIVER *** [Jd Js 8d Td] [3c]
Nikola92975: checks
dimetruk: bets 200
Nikola92975: calls 200
*** SHOW DOWN ***
dimetruk: shows [Kd 9h] (a pair of Jacks)
Nikola92975: shows [8h Ts] (two pair, Jacks and Tens)
Nikola92975 collected 763 from pot
*** SUMMARY ***
Total pot 763 | Rake 0
Board [Jd Js 8d Td 3c]
Seat 1: Nikola92975 (big blind) showed [8h Ts] and won (763) with two pair, Jacks and Tens
Seat 2: Fischer1972 folded before Flop (didn't bet)
Seat 4: dimetruk showed [Kd 9h] and lost with a pair of Jacks
Seat 5: ArtEug (button) folded before Flop (didn't bet)
Seat 6: Monk Gallas (small blind) folded before Flop


PokerStars Hand #226510958068: Tournament #3188065522, $13.79+$1.21 USD Hold'em No Limit - Level II (15/30) - 2021/05/06 18:20:43 MSK [2021/05/06 11:20:43 ET]
Table '3188065522 1' 6-max Seat #2 is the button
Seat 1: Nikola92975 (1325 in chips)
Seat 2: Fischer1972 (1426 in chips)
Seat 4: dimetruk (2056 in chips)
Seat 5: ArtEug (2819 in chips)
Seat 6: Monk Gallas (1374 in chips)
Nikola92975: posts the ante 4
Fischer1972: posts the ante 4
dimetruk: posts the ante 4
ArtEug: posts the ante 4
Monk Gallas: posts the ante 4
dimetruk: posts small blind 15
ArtEug: posts big blind 30
*** HOLE CARDS ***
Dealt to dimetruk [Ac Qd]
Monk Gallas: folds
Nikola92975: folds
Fischer1972: folds
dimetruk: raises 30 to 60
ArtEug: raises 120 to 180
dimetruk: raises 1872 to 2052 and is all-in
ArtEug: calls 1872
*** FLOP *** [Ks 6c 8d]
*** TURN *** [Ks 6c 8d] [Kc]
*** RIVER *** [Ks 6c 8d Kc] [Td]
*** SHOW DOWN ***
dimetruk: shows [Ac Qd] (a pair of Kings)
ArtEug: shows [Kh Ah] (three of a kind, Kings)
ArtEug collected 4124 from pot
dimetruk finished the tournament in 5th place
*** SUMMARY ***
Total pot 4124 | Rake 0
Board [Ks 6c 8d Kc Td]
Seat 1: Nikola92975 folded before Flop (didn't bet)
Seat 2: Fischer1972 (button) folded before Flop (didn't bet)
Seat 4: dimetruk (small blind) showed [Ac Qd] and lost with a pair of Kings
Seat 5: ArtEug (big blind) showed [Kh Ah] and won (4124) with three of a kind, Kings
Seat 6: Monk Gallas folded before Flop (didn't bet)


PokerStars Hand #226511905133: Tournament #3188077995, $13.79+$1.21 USD Hold'em No Limit - Level I (10/20) - 2021/05/06 18:58:13 MSK [2021/05/06 11:58:13 ET]
Table '3188077995 1' 6-max Seat #1 is the button
Seat 1: Picolo52 (1500 in chips)
Seat 2: SD ANDRE (1500 in chips)
Seat 3: Nikola92975 (1500 in chips)
Seat 4: dimetruk (1500 in chips)
Seat 5: alex-80686 (1500 in chips)
Seat 6: elpato2020 (1500 in chips)
Picolo52: posts the ante 3
SD ANDRE: posts the ante 3
Nikola92975: posts the ante 3
dimetruk: posts the ante 3
alex-80686: posts the ante 3
elpato2020: posts the ante 3
SD ANDRE: posts small blind 10
Nikola92975: posts big blind 20
*** HOLE CARDS ***
Dealt to dimetruk [Js Jc]
dimetruk: raises 20 to 40
alex-80686: calls 40
elpato2020: calls 40
Picolo52: folds
SD ANDRE: folds
Nikola92975: calls 20
*** FLOP *** [9c Qd 2h]
Nikola92975: checks
dimetruk: bets 62
alex-80686: folds
elpato2020: folds
Nikola92975: folds
Uncalled bet (62) returned to dimetruk
dimetruk collected 188 from pot
dimetruk: doesn't show hand
*** SUMMARY ***
Total pot 188 | Rake 0
Board [9c Qd 2h]
Seat 1: Picolo52 (button) folded before Flop (didn't bet)
Seat 2: SD ANDRE (small blind) folded before Flop
Seat 3: Nikola92975 (big blind) folded on the Flop
Seat 4: dimetruk collected (188)
Seat 5: alex-80686 folded on the Flop
Seat 6: elpato2020 folded on the Flop


PokerStars Hand #226511943630: Tournament #3188077995, $13.79+$1.21 USD Hold'em No Limit - Level I (10/20) - 2021/05/06 19:00:08 MSK [2021/05/06 12:00:08 ET]
Table '3188077995 1' 6-max Seat #3 is the button
Seat 1: Picolo52 (1802 in chips)
Seat 2: SD ANDRE (1484 in chips)
Seat 3: Nikola92975 (1444 in chips)
Seat 4: dimetruk (1622 in chips)
Seat 5: alex-80686 (1194 in chips)
Seat 6: elpato2020 (1454 in chips)
Picolo52: posts the ante 3
SD ANDRE: posts the ante 3
Nikola92975: posts the ante 3
dimetruk: posts the ante 3
alex-80686: posts the ante 3
elpato2020: posts the ante 3
dimetruk: posts small blind 10
alex-80686: posts big blind 20
*** HOLE CARDS ***
Dealt to dimetruk [Ah Ks]
elpato2020: raises 24 to 44
Picolo52: folds
SD ANDRE: folds
Nikola92975: folds
dimetruk: raises 76 to 120
alex-80686: folds
elpato2020: calls 76
*** FLOP *** [4h Qd 2c]
dimetruk: checks
elpato2020: checks
*** TURN *** [4h Qd 2c] [5s]
dimetruk: bets 125
elpato2020: folds
Uncalled bet (125) returned to dimetruk
dimetruk collected 278 from pot
dimetruk: doesn't show hand
*** SUMMARY ***
Total pot 278 | Rake 0
Board [4h Qd 2c 5s]
Seat 1: Picolo52 folded before Flop (didn't bet)
Seat 2: SD ANDRE folded before Flop (didn't bet)
Seat 3: Nikola92975 (button) folded before Flop (didn't bet)
Seat 4: dimetruk (small blind) collected (278)
Seat 5: alex-80686 (big blind) folded before Flop
Seat 6: elpato2020 folded on the Turn


PokerStars Hand #226511993603: Tournament #3188077995, $13.79+$1.21 USD Hold'em No Limit - Level I (10/20) - 2021/05/06 19:02:19 MSK [2021/05/06 12:02:19 ET]
Table '3188077995 1' 6-max Seat #1 is the button
Seat 1: Picolo52 (1710 in chips)
Seat 2: SD ANDRE (1510 in chips)
Seat 3: Nikola92975 (1382 in chips)
Seat 4: dimetruk (1768 in chips)
Seat 5: alex-80686 (1220 in chips)
Seat 6: elpato2020 (1410 in chips)
Picolo52: posts the ante 3
SD ANDRE: posts the ante 3
Nikola92975: posts the ante 3
dimetruk: posts the ante 3
alex-80686: posts the ante 3
elpato2020: posts the ante 3
SD ANDRE: posts small blind 10
Nikola92975: posts big blind 20
*** HOLE CARDS ***
Dealt to dimetruk [Qh Ad]
dimetruk: raises 20 to 40
alex-80686: folds
elpato2020: folds
Picolo52: calls 40
SD ANDRE: calls 30
Nikola92975: calls 20
*** FLOP *** [4h Ts 9c]
SD ANDRE: checks
Nikola92975: checks
dimetruk: checks
Picolo52: bets 100
SD ANDRE: folds
Nikola92975: calls 100
dimetruk: folds
*** TURN *** [4h Ts 9c] [Kc]
Nikola92975: checks
Picolo52: checks
*** RIVER *** [4h Ts 9c Kc] [4c]
Nikola92975: bets 253
Picolo52: calls 253
*** SHOW DOWN ***
Nikola92975: shows [Jd Ks] (two pair, Kings and Fours)
Picolo52: mucks hand
Nikola92975 collected 884 from pot
*** SUMMARY ***
Total pot 884 | Rake 0
Board [4h Ts 9c Kc 4c]
Seat 1: Picolo52 (button) mucked [As Th]
Seat 2: SD ANDRE (small blind) folded on the Flop
Seat 3: Nikola92975 (big blind) showed [Jd Ks] and won (884) with two pair, Kings and Fours
Seat 4: dimetruk folded on the Flop
Seat 5: alex-80686 folded before Flop (didn't bet)
Seat 6: elpato2020 folded before Flop (didn't bet)


PokerStars Hand #226512030227: Tournament #3188077995, $13.79+$1.21 USD Hold'em No Limit - Level I (10/20) - 2021/05/06 19:03:43 MSK [2021/05/06 12:03:43 ET]
Table '3188077995 1' 6-max Seat #2 is the button
Seat 1: Picolo52 (1314 in chips)
Seat 2: SD ANDRE (1467 in chips)
Seat 3: Nikola92975 (1870 in chips)
Seat 4: dimetruk (1725 in chips)
Seat 5: alex-80686 (1217 in chips)
Seat 6: elpato2020 (1407 in chips)
Picolo52: posts the ante 3
SD ANDRE: posts the ante 3
Nikola92975: posts the ante 3
dimetruk: posts the ante 3
alex-80686: posts the ante 3
elpato2020: posts the ante 3
Nikola92975: posts small blind 10
dimetruk: posts big blind 20
*** HOLE CARDS ***
Dealt to dimetruk [Kd As]
alex-80686: folds
elpato2020: raises 20 to 40
Picolo52: calls 40
SD ANDRE: folds
Nikola92975: calls 30
dimetruk: raises 90 to 130
elpato2020: folds
Picolo52: folds
Nikola92975: calls 90
*** FLOP *** [5s 6h Jc]
Nikola92975: checks
dimetruk: checks
*** TURN *** [5s 6h Jc] [3h]
Nikola92975: bets 240
dimetruk: folds
Uncalled bet (240) returned to Nikola92975
Nikola92975 collected 358 from pot
Nikola92975: doesn't show hand
*** SUMMARY ***
Total pot 358 | Rake 0
Board [5s 6h Jc 3h]
Seat 1: Picolo52 folded before Flop
Seat 2: SD ANDRE (button) folded before Flop (didn't bet)
Seat 3: Nikola92975 (small blind) collected (358)
Seat 4: dimetruk (big blind) folded on the Turn
Seat 5: alex-80686 folded before Flop (didn't bet)
Seat 6: elpato2020 folded before Flop


PokerStars Hand #226512227416: Tournament #3188077995, $13.79+$1.21 USD Hold'em No Limit - Level II (15/30) - 2021/05/06 19:10:37 MSK [2021/05/06 12:10:37 ET]
Table '3188077995 1' 6-max Seat #5 is the button
Seat 1: Picolo52 (1978 in chips)
Seat 2: SD ANDRE (1428 in chips)
Seat 3: Nikola92975 (2121 in chips)
Seat 4: dimetruk (1510 in chips)
Seat 5: alex-80686 (702 in chips)
Seat 6: elpato2020 (1261 in chips)
Picolo52: posts the ante 4
SD ANDRE: posts the ante 4
Nikola92975: posts the ante 4
dimetruk: posts the ante 4
alex-80686: posts the ante 4
elpato2020: posts the ante 4
elpato2020: posts small blind 15
Picolo52: posts big blind 30
*** HOLE CARDS ***
Dealt to dimetruk [Jc Ad]
SD ANDRE: folds
Nikola92975: folds
dimetruk: raises 30 to 60
alex-80686: calls 60
elpato2020: calls 45
Picolo52: calls 30
*** FLOP *** [4d 7h Ah]
elpato2020: checks
Picolo52: checks
dimetruk: bets 119
alex-80686: calls 119
elpato2020: folds
Picolo52: folds
*** TURN *** [4d 7h Ah] [5d]
dimetruk: bets 276
alex-80686: calls 276
*** RIVER *** [4d 7h Ah 5d] [Kh]
dimetruk: checks
alex-80686: checks
*** SHOW DOWN ***
dimetruk: shows [Jc Ad] (a pair of Aces)
alex-80686: mucks hand
dimetruk collected 1054 from pot
*** SUMMARY ***
Total pot 1054 | Rake 0
Board [4d 7h Ah 5d Kh]
Seat 1: Picolo52 (big blind) folded on the Flop
Seat 2: SD ANDRE folded before Flop (didn't bet)
Seat 3: Nikola92975 folded before Flop (didn't bet)
Seat 4: dimetruk showed [Jc Ad] and won (1054) with a pair of Aces
Seat 5: alex-80686 (button) mucked [6d 7c]
Seat 6: elpato2020 (small blind) folded on the Flop


PokerStars Hand #226512276903: Tournament #3188077995, $13.79+$1.21 USD Hold'em No Limit - Level II (15/30) - 2021/05/06 19:12:21 MSK [2021/05/06 12:12:21 ET]
Table '3188077995 1' 6-max Seat #2 is the button
Seat 1: Picolo52 (1891 in chips)
Seat 2: SD ANDRE (1371 in chips)
Seat 3: Nikola92975 (2079 in chips)
Seat 4: dimetruk (2097 in chips)
Seat 5: alex-80686 (274 in chips)
Seat 6: elpato2020 (1288 in chips)
Picolo52: posts the ante 4
SD ANDRE: posts the ante 4
Nikola92975: posts the ante 4
dimetruk: posts the ante 4
alex-80686: posts the ante 4
elpato2020: posts the ante 4
Nikola92975: posts small blind 15
dimetruk: posts big blind 30
*** HOLE CARDS ***
Dealt to dimetruk [6c 4s]
alex-80686: folds
elpato2020: raises 30 to 60
Picolo52: folds
SD ANDRE: calls 60
Nikola92975: folds
dimetruk: calls 30
*** FLOP *** [Qd Kh 3c]
dimetruk: checks
elpato2020: bets 53
SD ANDRE: folds
dimetruk: folds
Uncalled bet (53) returned to elpato2020
elpato2020 collected 219 from pot
*** SUMMARY ***
Total pot 219 | Rake 0
Board [Qd Kh 3c]
Seat 1: Picolo52 folded before Flop (didn't bet)
Seat 2: SD ANDRE (button) folded on the Flop
Seat 3: Nikola92975 (small blind) folded before Flop
Seat 4: dimetruk (big blind) folded on the Flop
Seat 5: alex-80686 folded before Flop (didn't bet)
Seat 6: elpato2020 collected (219)


PokerStars Hand #226512291156: Tournament #3188077995, $13.79+$1.21 USD Hold'em No Limit - Level II (15/30) - 2021/05/06 19:12:53 MSK [2021/05/06 12:12:53 ET]
Table '3188077995 1' 6-max Seat #3 is the button
Seat 1: Picolo52 (1887 in chips)
Seat 2: SD ANDRE (1307 in chips)
Seat 3: Nikola92975 (2060 in chips)
Seat 4: dimetruk (2033 in chips)
Seat 5: alex-80686 (270 in chips)
Seat 6: elpato2020 (1443 in chips)
Picolo52: posts the ante 4
SD ANDRE: posts the ante 4
Nikola92975: posts the ante 4
dimetruk: posts the ante 4
alex-80686: posts the ante 4
elpato2020: posts the ante 4
dimetruk: posts small blind 15
alex-80686: posts big blind 30
*** HOLE CARDS ***
Dealt to dimetruk [8h 8d]
elpato2020: folds
Picolo52: calls 30
SD ANDRE: raises 75 to 105
Nikola92975: calls 105
dimetruk: calls 90
alex-80686: folds
Picolo52: folds
*** FLOP *** [7d Qh 8s]
dimetruk: checks
SD ANDRE: bets 200
Nikola92975: folds
dimetruk: raises 200 to 400
SD ANDRE: raises 798 to 1198 and is all-in
dimetruk: calls 798
*** TURN *** [7d Qh 8s] [2s]
*** RIVER *** [7d Qh 8s 2s] [Ad]
*** SHOW DOWN ***
dimetruk: shows [8h 8d] (three of a kind, Eights)
SD ANDRE: shows [Ks Kh] (a pair of Kings)
dimetruk collected 2795 from pot
SD ANDRE finished the tournament in 6th place
*** SUMMARY ***
Total pot 2795 | Rake 0
Board [7d Qh 8s 2s Ad]
Seat 1: Picolo52 folded before Flop
Seat 2: SD ANDRE showed [Ks Kh] and lost with a pair of Kings
Seat 3: Nikola92975 (button) folded on the Flop
Seat 4: dimetruk (small blind) showed [8h 8d] and won (2795) with three of a kind, Eights
Seat 5: alex-80686 (big blind) folded before Flop
Seat 6: elpato2020 folded before Flop (didn't bet)


PokerStars Hand #226512384003: Tournament #3188077995, $13.79+$1.21 USD Hold'em No Limit - Level II (15/30) - 2021/05/06 19:16:23 MSK [2021/05/06 12:16:23 ET]
Table '3188077995 1' 6-max Seat #1 is the button
Seat 1: Picolo52 (1861 in chips)
Seat 3: Nikola92975 (1530 in chips)
Seat 4: dimetruk (3509 in chips)
Seat 5: alex-80686 (209 in chips)
Seat 6: elpato2020 (1891 in chips)
Picolo52: posts the ante 4
Nikola92975: posts the ante 4
dimetruk: posts the ante 4
alex-80686: posts the ante 4
elpato2020: posts the ante 4
Nikola92975: posts small blind 15
dimetruk: posts big blind 30
*** HOLE CARDS ***
Dealt to dimetruk [Kh Kc]
alex-80686: raises 175 to 205 and is all-in
elpato2020: folds
Picolo52: folds
Nikola92975: folds
dimetruk: calls 175
*** FLOP *** [Qd Tc 8c]
*** TURN *** [Qd Tc 8c] [9d]
*** RIVER *** [Qd Tc 8c 9d] [2d]
*** SHOW DOWN ***
dimetruk: shows [Kh Kc] (a pair of Kings)
alex-80686: shows [Ac 7d] (high card Ace)
dimetruk collected 445 from pot
alex-80686 finished the tournament in 5th place
*** SUMMARY ***
Total pot 445 | Rake 0
Board [Qd Tc 8c 9d 2d]
Seat 1: Picolo52 (button) folded before Flop (didn't bet)
Seat 3: Nikola92975 (small blind) folded before Flop
Seat 4: dimetruk (big blind) showed [Kh Kc] and won (445) with a pair of Kings
Seat 5: alex-80686 showed [Ac 7d] and lost with high card Ace
Seat 6: elpato2020 folded before Flop (didn't bet)


PokerStars Hand #226512420306: Tournament #3188077995, $13.79+$1.21 USD Hold'em No Limit - Level II (15/30) - 2021/05/06 19:17:44 MSK [2021/05/06 12:17:44 ET]
Table '3188077995 1' 6-max Seat #1 is the button
Seat 1: Picolo52 (1831 in chips)
Seat 3: Nikola92975 (1469 in chips)
Seat 4: dimetruk (3779 in chips)
Seat 6: elpato2020 (1921 in chips)
Picolo52: posts the ante 4
Nikola92975: posts the ante 4
dimetruk: posts the ante 4
elpato2020: posts the ante 4
Nikola92975: posts small blind 15
dimetruk: posts big blind 30
*** HOLE CARDS ***
Dealt to dimetruk [3s As]
elpato2020: folds
Picolo52: folds
Nikola92975: raises 75 to 105
dimetruk: calls 75
*** FLOP *** [2d 9s 8s]
Nikola92975: checks
dimetruk: bets 124
Nikola92975: calls 124
*** TURN *** [2d 9s 8s] [5s]
Nikola92975: checks
dimetruk: bets 261
Nikola92975: folds
Uncalled bet (261) returned to dimetruk
dimetruk collected 474 from pot
dimetruk: doesn't show hand
*** SUMMARY ***
Total pot 474 | Rake 0
Board [2d 9s 8s 5s]
Seat 1: Picolo52 (button) folded before Flop (didn't bet)
Seat 3: Nikola92975 (small blind) folded on the Turn
Seat 4: dimetruk (big blind) collected (474)
Seat 6: elpato2020 folded before Flop (didn't bet)


PokerStars Hand #226512443478: Tournament #3188077995, $13.79+$1.21 USD Hold'em No Limit - Level III (25/50) - 2021/05/06 19:18:37 MSK [2021/05/06 12:18:37 ET]
Table '3188077995 1' 6-max Seat #3 is the button
Seat 1: Picolo52 (1827 in chips)
Seat 3: Nikola92975 (1236 in chips)
Seat 4: dimetruk (4020 in chips)
Seat 6: elpato2020 (1917 in chips)
Picolo52: posts the ante 6
Nikola92975: posts the ante 6
dimetruk: posts the ante 6
elpato2020: posts the ante 6
dimetruk: posts small blind 25
elpato2020: posts big blind 50
*** HOLE CARDS ***
Dealt to dimetruk [2c Ks]
Picolo52: folds
Nikola92975: folds
dimetruk: raises 50 to 100
elpato2020: calls 50
*** FLOP *** [5s 6h 5c]
dimetruk: bets 200
elpato2020: folds
Uncalled bet (200) returned to dimetruk
dimetruk collected 224 from pot
dimetruk: doesn't show hand
*** SUMMARY ***
Total pot 224 | Rake 0
Board [5s 6h 5c]
Seat 1: Picolo52 folded before Flop (didn't bet)
Seat 3: Nikola92975 (button) folded before Flop (didn't bet)
Seat 4: dimetruk (small blind) collected (224)
Seat 6: elpato2020 (big blind) folded on the Flop


PokerStars Hand #226512451450: Tournament #3188077995, $13.79+$1.21 USD Hold'em No Limit - Level III (25/50) - 2021/05/06 19:18:55 MSK [2021/05/06 12:18:55 ET]
Table '3188077995 1' 6-max Seat #4 is the button
Seat 1: Picolo52 (1821 in chips)
Seat 3: Nikola92975 (1230 in chips)
Seat 4: dimetruk (4138 in chips)
Seat 6: elpato2020 (1811 in chips)
Picolo52: posts the ante 6
Nikola92975: posts the ante 6
dimetruk: posts the ante 6
elpato2020: posts the ante 6
elpato2020: posts small blind 25
Picolo52: posts big blind 50
*** HOLE CARDS ***
Dealt to dimetruk [9c Ah]
Nikola92975: raises 50 to 100
dimetruk: raises 100 to 200
elpato2020: folds
Picolo52: folds
Nikola92975: calls 100
*** FLOP *** [4h 9d 6h]
Nikola92975: checks
dimetruk: bets 374
Nikola92975: raises 650 to 1024 and is all-in
dimetruk: calls 650
*** TURN *** [4h 9d 6h] [Ks]
*** RIVER *** [4h 9d 6h Ks] [Jh]
*** SHOW DOWN ***
Nikola92975: shows [Qd Ad] (high card Ace)
dimetruk: shows [9c Ah] (a pair of Nines)
dimetruk collected 2547 from pot
Nikola92975 finished the tournament in 4th place
*** SUMMARY ***
Total pot 2547 | Rake 0
Board [4h 9d 6h Ks Jh]
Seat 1: Picolo52 (big blind) folded before Flop
Seat 3: Nikola92975 showed [Qd Ad] and lost with high card Ace
Seat 4: dimetruk (button) showed [9c Ah] and won (2547) with a pair of Nines
Seat 6: elpato2020 (small blind) folded before Flop


PokerStars Hand #226512493816: Tournament #3188077995, $13.79+$1.21 USD Hold'em No Limit - Level III (25/50) - 2021/05/06 19:20:31 MSK [2021/05/06 12:20:31 ET]
Table '3188077995 1' 6-max Seat #1 is the button
Seat 1: Picolo52 (1709 in chips)
Seat 4: dimetruk (5517 in chips)
Seat 6: elpato2020 (1774 in chips)
Picolo52: posts the ante 6
dimetruk: posts the ante 6
elpato2020: posts the ante 6
dimetruk: posts small blind 25
elpato2020: posts big blind 50
*** HOLE CARDS ***
Dealt to dimetruk [As 2h]
Picolo52: folds
dimetruk: raises 50 to 100
elpato2020: calls 50
*** FLOP *** [Js Qc 2d]
dimetruk: bets 98
elpato2020: calls 98
*** TURN *** [Js Qc 2d] [4h]
dimetruk: bets 228
elpato2020: calls 228
*** RIVER *** [Js Qc 2d 4h] [4s]
dimetruk: checks
elpato2020: checks
*** SHOW DOWN ***
dimetruk: shows [As 2h] (two pair, Fours and Deuces)
elpato2020: shows [Qd Ts] (two pair, Queens and Fours)
elpato2020 collected 870 from pot
*** SUMMARY ***
Total pot 870 | Rake 0
Board [Js Qc 2d 4h 4s]
Seat 1: Picolo52 (button) folded before Flop (didn't bet)
Seat 4: dimetruk (small blind) showed [As 2h] and lost with two pair, Fours and Deuces
Seat 6: elpato2020 (big blind) showed [Qd Ts] and won (870) with two pair, Queens and Fours


PokerStars Hand #226512512603: Tournament #3188077995, $13.79+$1.21 USD Hold'em No Limit - Level III (25/50) - 2021/05/06 19:21:13 MSK [2021/05/06 12:21:13 ET]
Table '3188077995 1' 6-max Seat #6 is the button
Seat 1: Picolo52 (1740 in chips)
Seat 4: dimetruk (5079 in chips)
Seat 6: elpato2020 (2181 in chips)
Picolo52: posts the ante 6
dimetruk: posts the ante 6
elpato2020: posts the ante 6
Picolo52: posts small blind 25
dimetruk: posts big blind 50
*** HOLE CARDS ***
Dealt to dimetruk [8d 6d]
elpato2020: folds
Picolo52: calls 25
dimetruk: checks
*** FLOP *** [8c Kh 5d]
Picolo52: checks
dimetruk: bets 50
Picolo52: calls 50
*** TURN *** [8c Kh 5d] [Qc]
Picolo52: checks
dimetruk: bets 98
Picolo52: calls 98
*** RIVER *** [8c Kh 5d Qc] [3s]
Picolo52: checks
dimetruk: checks
*** SHOW DOWN ***
Picolo52: shows [Jd Tc] (high card King)
dimetruk: shows [8d 6d] (a pair of Eights)
dimetruk collected 414 from pot
*** SUMMARY ***
Total pot 414 | Rake 0
Board [8c Kh 5d Qc 3s]
Seat 1: Picolo52 (small blind) showed [Jd Tc] and lost with high card King
Seat 4: dimetruk (big blind) showed [8d 6d] and won (414) with a pair of Eights
Seat 6: elpato2020 (button) folded before Flop (didn't bet)


PokerStars Hand #226512523123: Tournament #3188077995, $13.79+$1.21 USD Hold'em No Limit - Level III (25/50) - 2021/05/06 19:21:37 MSK [2021/05/06 12:21:37 ET]
Table '3188077995 1' 6-max Seat #1 is the button
Seat 1: Picolo52 (1536 in chips)
Seat 4: dimetruk (5289 in chips)
Seat 6: elpato2020 (2175 in chips)
Picolo52: posts the ante 6
dimetruk: posts the ante 6
elpato2020: posts the ante 6
dimetruk: posts small blind 25
elpato2020: posts big blind 50
*** HOLE CARDS ***
Dealt to dimetruk [8h 5s]
Picolo52: folds
dimetruk: raises 112 to 162
elpato2020: calls 112
*** FLOP *** [4h Qd 6h]
dimetruk: bets 113
elpato2020: folds
Uncalled bet (113) returned to dimetruk
dimetruk collected 342 from pot
dimetruk: doesn't show hand
*** SUMMARY ***
Total pot 342 | Rake 0
Board [4h Qd 6h]
Seat 1: Picolo52 (button) folded before Flop (didn't bet)
Seat 4: dimetruk (small blind) collected (342)
Seat 6: elpato2020 (big blind) folded on the Flop


PokerStars Hand #226512540252: Tournament #3188077995, $13.79+$1.21 USD Hold'em No Limit - Level III (25/50) - 2021/05/06 19:22:15 MSK [2021/05/06 12:22:15 ET]
Table '3188077995 1' 6-max Seat #6 is the button
Seat 1: Picolo52 (1567 in chips)
Seat 4: dimetruk (5457 in chips)
Seat 6: elpato2020 (1976 in chips)
Picolo52: posts the ante 6
dimetruk: posts the ante 6
elpato2020: posts the ante 6
Picolo52: posts small blind 25
dimetruk: posts big blind 50
*** HOLE CARDS ***
Dealt to dimetruk [Jc 9d]
elpato2020: folds
Picolo52: calls 25
dimetruk: raises 50 to 100
Picolo52: calls 50
*** FLOP *** [Qs 6s 9c]
Picolo52: checks
dimetruk: bets 98
Picolo52: folds
Uncalled bet (98) returned to dimetruk
dimetruk collected 218 from pot
dimetruk: doesn't show hand
*** SUMMARY ***
Total pot 218 | Rake 0
Board [Qs 6s 9c]
Seat 1: Picolo52 (small blind) folded on the Flop
Seat 4: dimetruk (big blind) collected (218)
Seat 6: elpato2020 (button) folded before Flop (didn't bet)


PokerStars Hand #226512556155: Tournament #3188077995, $13.79+$1.21 USD Hold'em No Limit - Level III (25/50) - 2021/05/06 19:22:51 MSK [2021/05/06 12:22:51 ET]
Table '3188077995 1' 6-max Seat #6 is the button
Seat 1: Picolo52 (1399 in chips)
Seat 4: dimetruk (5718 in chips)
Seat 6: elpato2020 (1883 in chips)
Picolo52: posts the ante 6
dimetruk: posts the ante 6
elpato2020: posts the ante 6
Picolo52: posts small blind 25
dimetruk: posts big blind 50
*** HOLE CARDS ***
Dealt to dimetruk [Qd 9s]
elpato2020: folds
Picolo52: calls 25
dimetruk: raises 50 to 100
Picolo52: calls 50
*** FLOP *** [Jc Ks Ac]
Picolo52: checks
dimetruk: bets 72
Picolo52: calls 72
*** TURN *** [Jc Ks Ac] [Qh]
Picolo52: checks
dimetruk: checks
*** RIVER *** [Jc Ks Ac Qh] [Kh]
Picolo52: bets 200
dimetruk: folds
Uncalled bet (200) returned to Picolo52
Picolo52 collected 362 from pot
Picolo52: doesn't show hand
*** SUMMARY ***
Total pot 362 | Rake 0
Board [Jc Ks Ac Qh Kh]
Seat 1: Picolo52 (small blind) collected (362)
Seat 4: dimetruk (big blind) folded on the River
Seat 6: elpato2020 (button) folded before Flop (didn't bet)


PokerStars Hand #226512579452: Tournament #3188077995, $13.79+$1.21 USD Hold'em No Limit - Level III (25/50) - 2021/05/06 19:23:43 MSK [2021/05/06 12:23:43 ET]
Table '3188077995 1' 6-max Seat #6 is the button
Seat 1: Picolo52 (1614 in chips)
Seat 4: dimetruk (5503 in chips)
Seat 6: elpato2020 (1883 in chips)
Picolo52: posts the ante 6
dimetruk: posts the ante 6
elpato2020: posts the ante 6
Picolo52: posts small blind 25
dimetruk: posts big blind 50
*** HOLE CARDS ***
Dealt to dimetruk [5d 3h]
elpato2020: raises 50 to 100
Picolo52: calls 75
dimetruk: calls 50
*** FLOP *** [Ks 2h 7c]
Picolo52: checks
dimetruk: checks
elpato2020: checks
*** TURN *** [Ks 2h 7c] [6h]
Picolo52: checks
dimetruk: bets 143
elpato2020: folds
Picolo52: folds
Uncalled bet (143) returned to dimetruk
dimetruk collected 318 from pot
dimetruk: doesn't show hand
*** SUMMARY ***
Total pot 318 | Rake 0
Board [Ks 2h 7c 6h]
Seat 1: Picolo52 (small blind) folded on the Turn
Seat 4: dimetruk (big blind) collected (318)
Seat 6: elpato2020 (button) folded on the Turn


PokerStars Hand #226512592737: Tournament #3188077995, $13.79+$1.21 USD Hold'em No Limit - Level III (25/50) - 2021/05/06 19:24:14 MSK [2021/05/06 12:24:14 ET]
Table '3188077995 1' 6-max Seat #1 is the button
Seat 1: Picolo52 (1508 in chips)
Seat 4: dimetruk (5715 in chips)
Seat 6: elpato2020 (1777 in chips)
Picolo52: posts the ante 6
dimetruk: posts the ante 6
elpato2020: posts the ante 6
dimetruk: posts small blind 25
elpato2020: posts big blind 50
*** HOLE CARDS ***
Dealt to dimetruk [Jc Qs]
Picolo52: calls 50
dimetruk: raises 112 to 162
elpato2020: folds
Picolo52: calls 112
*** FLOP *** [2h Jh Ac]
dimetruk: bets 129
Picolo52: calls 129
*** TURN *** [2h Jh Ac] [3h]
dimetruk: checks
Picolo52: bets 100
dimetruk: calls 100
*** RIVER *** [2h Jh Ac 3h] [As]
dimetruk: checks
Picolo52: bets 250
dimetruk: calls 250
*** SHOW DOWN ***
Picolo52: shows [7h Ad] (three of a kind, Aces)
dimetruk: mucks hand
Picolo52 collected 1350 from pot
*** SUMMARY ***
Total pot 1350 | Rake 0
Board [2h Jh Ac 3h As]
Seat 1: Picolo52 (button) showed [7h Ad] and won (1350) with three of a kind, Aces
Seat 4: dimetruk (small blind) mucked [Jc Qs]
Seat 6: elpato2020 (big blind) folded before Flop


PokerStars Hand #226512606458: Tournament #3188077995, $13.79+$1.21 USD Hold'em No Limit - Level III (25/50) - 2021/05/06 19:24:44 MSK [2021/05/06 12:24:44 ET]
Table '3188077995 1' 6-max Seat #4 is the button
Seat 1: Picolo52 (2211 in chips)
Seat 4: dimetruk (5068 in chips)
Seat 6: elpato2020 (1721 in chips)
Picolo52: posts the ante 6
dimetruk: posts the ante 6
elpato2020: posts the ante 6
elpato2020: posts small blind 25
Picolo52: posts big blind 50
*** HOLE CARDS ***
Dealt to dimetruk [Ts Kc]
dimetruk: raises 50 to 100
elpato2020: folds
Picolo52: calls 50
*** FLOP *** [5c 7s 3c]
Picolo52: checks
dimetruk: checks
*** TURN *** [5c 7s 3c] [9d]
Picolo52: checks
dimetruk: bets 134
Picolo52: calls 134
*** RIVER *** [5c 7s 3c 9d] [7c]
Picolo52: bets 300
dimetruk: folds
Uncalled bet (300) returned to Picolo52
Picolo52 collected 511 from pot
Picolo52: doesn't show hand
*** SUMMARY ***
Total pot 511 | Rake 0
Board [5c 7s 3c 9d 7c]
Seat 1: Picolo52 (big blind) collected (511)
Seat 4: dimetruk (button) folded on the River
Seat 6: elpato2020 (small blind) folded before Flop


PokerStars Hand #226512619382: Tournament #3188077995, $13.79+$1.21 USD Hold'em No Limit - Level III (25/50) - 2021/05/06 19:25:13 MSK [2021/05/06 12:25:13 ET]
Table '3188077995 1' 6-max Seat #6 is the button
Seat 1: Picolo52 (2482 in chips)
Seat 4: dimetruk (4828 in chips)
Seat 6: elpato2020 (1690 in chips)
Picolo52: posts the ante 6
dimetruk: posts the ante 6
elpato2020: posts the ante 6
Picolo52: posts small blind 25
dimetruk: posts big blind 50
*** HOLE CARDS ***
Dealt to dimetruk [Kh 4c]
elpato2020: raises 50 to 100
Picolo52: folds
dimetruk: calls 50
*** FLOP *** [4h 2h 7c]
dimetruk: checks
elpato2020: checks
*** TURN *** [4h 2h 7c] [As]
dimetruk: bets 80
elpato2020: calls 80
*** RIVER *** [4h 2h 7c As] [Td]
dimetruk: checks
elpato2020: bets 302
dimetruk: folds
Uncalled bet (302) returned to elpato2020
elpato2020 collected 403 from pot
*** SUMMARY ***
Total pot 403 | Rake 0
Board [4h 2h 7c As Td]
Seat 1: Picolo52 (small blind) folded before Flop
Seat 4: dimetruk (big blind) folded on the River
Seat 6: elpato2020 (button) collected (403)


PokerStars Hand #226512646339: Tournament #3188077995, $13.79+$1.21 USD Hold'em No Limit - Level III (25/50) - 2021/05/06 19:26:11 MSK [2021/05/06 12:26:11 ET]
Table '3188077995 1' 6-max Seat #6 is the button
Seat 1: Picolo52 (2389 in chips)
Seat 4: dimetruk (4623 in chips)
Seat 6: elpato2020 (1988 in chips)
Picolo52: posts the ante 6
dimetruk: posts the ante 6
elpato2020: posts the ante 6
Picolo52: posts small blind 25
dimetruk: posts big blind 50
*** HOLE CARDS ***
Dealt to dimetruk [7c 8d]
elpato2020: folds
Picolo52: calls 25
dimetruk: checks
*** FLOP *** [Js Qs Ad]
Picolo52: checks
dimetruk: checks
*** TURN *** [Js Qs Ad] [Th]
Picolo52: bets 50
dimetruk: folds
Uncalled bet (50) returned to Picolo52
Picolo52 collected 118 from pot
Picolo52: doesn't show hand
*** SUMMARY ***
Total pot 118 | Rake 0
Board [Js Qs Ad Th]
Seat 1: Picolo52 (small blind) collected (118)
Seat 4: dimetruk (big blind) folded on the Turn
Seat 6: elpato2020 (button) folded before Flop (didn't bet)


PokerStars Hand #226512666514: Tournament #3188077995, $13.79+$1.21 USD Hold'em No Limit - Level III (25/50) - 2021/05/06 19:26:54 MSK [2021/05/06 12:26:54 ET]
Table '3188077995 1' 6-max Seat #6 is the button
Seat 1: Picolo52 (2582 in chips)
Seat 4: dimetruk (4430 in chips)
Seat 6: elpato2020 (1988 in chips)
Picolo52: posts the ante 6
dimetruk: posts the ante 6
elpato2020: posts the ante 6
Picolo52: posts small blind 25
dimetruk: posts big blind 50
*** HOLE CARDS ***
Dealt to dimetruk [Js 4d]
elpato2020: folds
Picolo52: calls 25
dimetruk: checks
*** FLOP *** [8c 9h Kd]
Picolo52: bets 50
dimetruk: folds
Uncalled bet (50) returned to Picolo52
Picolo52 collected 118 from pot
Picolo52: doesn't show hand
*** SUMMARY ***
Total pot 118 | Rake 0
Board [8c 9h Kd]
Seat 1: Picolo52 (small blind) collected (118)
Seat 4: dimetruk (big blind) folded on the Flop
Seat 6: elpato2020 (button) folded before Flop (didn't bet)


PokerStars Hand #226512738752: Tournament #3188077995, $13.79+$1.21 USD Hold'em No Limit - Level IV (40/80) - 2021/05/06 19:29:12 MSK [2021/05/06 12:29:12 ET]
Table '3188077995 1' 6-max Seat #4 is the button
Seat 1: Picolo52 (2223 in chips)
Seat 4: dimetruk (4978 in chips)
Seat 6: elpato2020 (1799 in chips)
Picolo52: posts the ante 10
dimetruk: posts the ante 10
elpato2020: posts the ante 10
elpato2020: posts small blind 40
Picolo52: posts big blind 80
*** HOLE CARDS ***
Dealt to dimetruk [Ac 6c]
dimetruk: raises 180 to 260
elpato2020: folds
Picolo52: calls 180
*** FLOP *** [2c 9h 4d]
Picolo52: checks
dimetruk: checks
*** TURN *** [2c 9h 4d] [Ad]
Picolo52: checks
dimetruk: bets 266
Picolo52: folds
Uncalled bet (266) returned to dimetruk
dimetruk collected 590 from pot
dimetruk: doesn't show hand
*** SUMMARY ***
Total pot 590 | Rake 0
Board [2c 9h 4d Ad]
Seat 1: Picolo52 (big blind) folded on the Turn
Seat 4: dimetruk (button) collected (590)
Seat 6: elpato2020 (small blind) folded before Flop


PokerStars Hand #226512753925: Tournament #3188077995, $13.79+$1.21 USD Hold'em No Limit - Level IV (40/80) - 2021/05/06 19:29:46 MSK [2021/05/06 12:29:46 ET]
Table '3188077995 1' 6-max Seat #6 is the button
Seat 1: Picolo52 (1953 in chips)
Seat 4: dimetruk (5298 in chips)
Seat 6: elpato2020 (1749 in chips)
Picolo52: posts the ante 10
dimetruk: posts the ante 10
elpato2020: posts the ante 10
Picolo52: posts small blind 40
dimetruk: posts big blind 80
*** HOLE CARDS ***
Dealt to dimetruk [Ks 2s]
elpato2020: folds
Picolo52: calls 40
dimetruk: raises 180 to 260
Picolo52: calls 180
*** FLOP *** [9h 7s Tc]
Picolo52: checks
dimetruk: checks
*** TURN *** [9h 7s Tc] [2c]
Picolo52: bets 80
dimetruk: calls 80
*** RIVER *** [9h 7s Tc 2c] [3d]
Picolo52: bets 160
dimetruk: calls 160
*** SHOW DOWN ***
Picolo52: shows [As 2d] (a pair of Deuces)
dimetruk: mucks hand
Picolo52 collected 1030 from pot
*** SUMMARY ***
Total pot 1030 | Rake 0
Board [9h 7s Tc 2c 3d]
Seat 1: Picolo52 (small blind) showed [As 2d] and won (1030) with a pair of Deuces
Seat 4: dimetruk (big blind) mucked [Ks 2s]
Seat 6: elpato2020 (button) folded before Flop (didn't bet)


PokerStars Hand #226512773611: Tournament #3188077995, $13.79+$1.21 USD Hold'em No Limit - Level IV (40/80) - 2021/05/06 19:30:28 MSK [2021/05/06 12:30:28 ET]
Table '3188077995 1' 6-max Seat #1 is the button
Seat 1: Picolo52 (2473 in chips)
Seat 4: dimetruk (4788 in chips)
Seat 6: elpato2020 (1739 in chips)
Picolo52: posts the ante 10
dimetruk: posts the ante 10
elpato2020: posts the ante 10
dimetruk: posts small blind 40
elpato2020: posts big blind 80
*** HOLE CARDS ***
Dealt to dimetruk [Tc 9s]
Picolo52: folds
dimetruk: raises 80 to 160
elpato2020: calls 80
*** FLOP *** [Kc 4h Ah]
dimetruk: bets 116
elpato2020: raises 192 to 308
dimetruk: folds
Uncalled bet (192) returned to elpato2020
elpato2020 collected 582 from pot
*** SUMMARY ***
Total pot 582 | Rake 0
Board [Kc 4h Ah]
Seat 1: Picolo52 (button) folded before Flop (didn't bet)
Seat 4: dimetruk (small blind) folded on the Flop
Seat 6: elpato2020 (big blind) collected (582)


PokerStars Hand #226512784073: Tournament #3188077995, $13.79+$1.21 USD Hold'em No Limit - Level IV (40/80) - 2021/05/06 19:30:50 MSK [2021/05/06 12:30:50 ET]
Table '3188077995 1' 6-max Seat #4 is the button
Seat 1: Picolo52 (2463 in chips)
Seat 4: dimetruk (4502 in chips)
Seat 6: elpato2020 (2035 in chips)
Picolo52: posts the ante 10
dimetruk: posts the ante 10
elpato2020: posts the ante 10
elpato2020: posts small blind 40
Picolo52: posts big blind 80
*** HOLE CARDS ***
Dealt to dimetruk [Tc Kc]
dimetruk: raises 80 to 160
elpato2020: folds
Picolo52: calls 80
*** FLOP *** [8c Js Th]
Picolo52: checks
dimetruk: checks
*** TURN *** [8c Js Th] [7c]
Picolo52: checks
dimetruk: bets 120
Picolo52: folds
Uncalled bet (120) returned to dimetruk
dimetruk collected 390 from pot
dimetruk: doesn't show hand
*** SUMMARY ***
Total pot 390 | Rake 0
Board [8c Js Th 7c]
Seat 1: Picolo52 (big blind) folded on the Turn
Seat 4: dimetruk (button) collected (390)
Seat 6: elpato2020 (small blind) folded before Flop


PokerStars Hand #226512802422: Tournament #3188077995, $13.79+$1.21 USD Hold'em No Limit - Level IV (40/80) - 2021/05/06 19:31:29 MSK [2021/05/06 12:31:29 ET]
Table '3188077995 1' 6-max Seat #6 is the button
Seat 1: Picolo52 (2293 in chips)
Seat 4: dimetruk (4722 in chips)
Seat 6: elpato2020 (1985 in chips)
Picolo52: posts the ante 10
dimetruk: posts the ante 10
elpato2020: posts the ante 10
Picolo52: posts small blind 40
dimetruk: posts big blind 80
*** HOLE CARDS ***
Dealt to dimetruk [6h 7s]
elpato2020: folds
Picolo52: calls 40
dimetruk: checks
*** FLOP *** [6s Jc 5s]
Picolo52: bets 80
dimetruk: calls 80
*** TURN *** [6s Jc 5s] [8d]
Picolo52: checks
dimetruk: bets 158
Picolo52: calls 158
*** RIVER *** [6s Jc 5s 8d] [Ah]
Picolo52: bets 333
dimetruk: folds
Uncalled bet (333) returned to Picolo52
Picolo52 collected 666 from pot
Picolo52: doesn't show hand
*** SUMMARY ***
Total pot 666 | Rake 0
Board [6s Jc 5s 8d Ah]
Seat 1: Picolo52 (small blind) collected (666)
Seat 4: dimetruk (big blind) folded on the River
Seat 6: elpato2020 (button) folded before Flop (didn't bet)


PokerStars Hand #226512830682: Tournament #3188077995, $13.79+$1.21 USD Hold'em No Limit - Level IV (40/80) - 2021/05/06 19:32:18 MSK [2021/05/06 12:32:18 ET]
Table '3188077995 1' 6-max Seat #4 is the button
Seat 1: Picolo52 (2621 in chips)
Seat 4: dimetruk (4494 in chips)
Seat 6: elpato2020 (1885 in chips)
Picolo52: posts the ante 10
dimetruk: posts the ante 10
elpato2020: posts the ante 10
elpato2020: posts small blind 40
Picolo52: posts big blind 80
*** HOLE CARDS ***
Dealt to dimetruk [2h Ad]
dimetruk: raises 80 to 160
elpato2020: folds
Picolo52: calls 80
*** FLOP *** [7c Qd Jd]
Picolo52: checks
dimetruk: checks
*** TURN *** [7c Qd Jd] [8d]
Picolo52: checks
dimetruk: checks
*** RIVER *** [7c Qd Jd 8d] [Tc]
Picolo52: checks
dimetruk: checks
*** SHOW DOWN ***
Picolo52: shows [5s Kh] (high card King)
dimetruk: shows [2h Ad] (high card Ace)
dimetruk collected 390 from pot
*** SUMMARY ***
Total pot 390 | Rake 0
Board [7c Qd Jd 8d Tc]
Seat 1: Picolo52 (big blind) showed [5s Kh] and lost with high card King
Seat 4: dimetruk (button) showed [2h Ad] and won (390) with high card Ace
Seat 6: elpato2020 (small blind) folded before Flop


PokerStars Hand #226512854736: Tournament #3188077995, $13.79+$1.21 USD Hold'em No Limit - Level IV (40/80) - 2021/05/06 19:33:10 MSK [2021/05/06 12:33:10 ET]
Table '3188077995 1' 6-max Seat #6 is the button
Seat 1: Picolo52 (2601 in chips)
Seat 4: dimetruk (4714 in chips)
Seat 6: elpato2020 (1685 in chips)
Picolo52: posts the ante 10
dimetruk: posts the ante 10
elpato2020: posts the ante 10
Picolo52: posts small blind 40
dimetruk: posts big blind 80
*** HOLE CARDS ***
Dealt to dimetruk [6c 4s]
elpato2020: folds
Picolo52: calls 40
dimetruk: checks
*** FLOP *** [Tc 3s 2c]
Picolo52: bets 190
dimetruk: folds
Uncalled bet (190) returned to Picolo52
Picolo52 collected 190 from pot
Picolo52: doesn't show hand
*** SUMMARY ***
Total pot 190 | Rake 0
Board [Tc 3s 2c]
Seat 1: Picolo52 (small blind) collected (190)
Seat 4: dimetruk (big blind) folded on the Flop
Seat 6: elpato2020 (button) folded before Flop (didn't bet)


PokerStars Hand #226512869041: Tournament #3188077995, $13.79+$1.21 USD Hold'em No Limit - Level IV (40/80) - 2021/05/06 19:33:41 MSK [2021/05/06 12:33:41 ET]
Table '3188077995 1' 6-max Seat #4 is the button
Seat 1: Picolo52 (2841 in chips)
Seat 4: dimetruk (4574 in chips)
Seat 6: elpato2020 (1585 in chips)
Picolo52: posts the ante 10
dimetruk: posts the ante 10
elpato2020: posts the ante 10
elpato2020: posts small blind 40
Picolo52: posts big blind 80
*** HOLE CARDS ***
Dealt to dimetruk [9d Qs]
dimetruk: raises 80 to 160
elpato2020: folds
Picolo52: calls 80
*** FLOP *** [Ts Ks 4d]
Picolo52: checks
dimetruk: bets 129
Picolo52: folds
Uncalled bet (129) returned to dimetruk
dimetruk collected 390 from pot
dimetruk: doesn't show hand
*** SUMMARY ***
Total pot 390 | Rake 0
Board [Ts Ks 4d]
Seat 1: Picolo52 (big blind) folded on the Flop
Seat 4: dimetruk (button) collected (390)
Seat 6: elpato2020 (small blind) folded before Flop


PokerStars Hand #226512882600: Tournament #3188077995, $13.79+$1.21 USD Hold'em No Limit - Level IV (40/80) - 2021/05/06 19:34:10 MSK [2021/05/06 12:34:10 ET]
Table '3188077995 1' 6-max Seat #1 is the button
Seat 1: Picolo52 (2621 in chips)
Seat 4: dimetruk (5014 in chips)
Seat 6: elpato2020 (1365 in chips)
Picolo52: posts the ante 10
dimetruk: posts the ante 10
elpato2020: posts the ante 10
dimetruk: posts small blind 40
elpato2020: posts big blind 80
*** HOLE CARDS ***
Dealt to dimetruk [4h Qc]
Picolo52: folds
dimetruk: raises 80 to 160
elpato2020: calls 80
*** FLOP *** [Js 3s As]
dimetruk: bets 116
elpato2020: raises 437 to 553
dimetruk: folds
Uncalled bet (437) returned to elpato2020
elpato2020 collected 582 from pot
*** SUMMARY ***
Total pot 582 | Rake 0
Board [Js 3s As]
Seat 1: Picolo52 (button) folded before Flop (didn't bet)
Seat 4: dimetruk (small blind) folded on the Flop
Seat 6: elpato2020 (big blind) collected (582)


PokerStars Hand #226512951828: Tournament #3188077995, $13.79+$1.21 USD Hold'em No Limit - Level IV (40/80) - 2021/05/06 19:36:37 MSK [2021/05/06 12:36:37 ET]
Table '3188077995 1' 6-max Seat #6 is the button
Seat 1: Picolo52 (1901 in chips)
Seat 4: dimetruk (5088 in chips)
Seat 6: elpato2020 (2011 in chips)
Picolo52: posts the ante 10
dimetruk: posts the ante 10
elpato2020: posts the ante 10
Picolo52: posts small blind 40
dimetruk: posts big blind 80
*** HOLE CARDS ***
Dealt to dimetruk [5s 9c]
elpato2020: folds
Picolo52: calls 40
dimetruk: checks
*** FLOP *** [8c Td 3d]
Picolo52: bets 80
dimetruk: folds
Uncalled bet (80) returned to Picolo52
Picolo52 collected 190 from pot
Picolo52: doesn't show hand
*** SUMMARY ***
Total pot 190 | Rake 0
Board [8c Td 3d]
Seat 1: Picolo52 (small blind) collected (190)
Seat 4: dimetruk (big blind) folded on the Flop
Seat 6: elpato2020 (button) folded before Flop (didn't bet)


PokerStars Hand #226512957518: Tournament #3188077995, $13.79+$1.21 USD Hold'em No Limit - Level IV (40/80) - 2021/05/06 19:36:49 MSK [2021/05/06 12:36:49 ET]
Table '3188077995 1' 6-max Seat #1 is the button
Seat 1: Picolo52 (2001 in chips)
Seat 4: dimetruk (4998 in chips)
Seat 6: elpato2020 (2001 in chips)
Picolo52: posts the ante 10
dimetruk: posts the ante 10
elpato2020: posts the ante 10
dimetruk: posts small blind 40
elpato2020: posts big blind 80
*** HOLE CARDS ***
Dealt to dimetruk [9s 7s]
Picolo52: calls 80
dimetruk: raises 180 to 260
elpato2020: folds
Picolo52: calls 180
*** FLOP *** [9c Ad 7h]
dimetruk: bets 347
Picolo52: folds
Uncalled bet (347) returned to dimetruk
dimetruk collected 630 from pot
dimetruk: doesn't show hand
*** SUMMARY ***
Total pot 630 | Rake 0
Board [9c Ad 7h]
Seat 1: Picolo52 (button) folded on the Flop
Seat 4: dimetruk (small blind) collected (630)
Seat 6: elpato2020 (big blind) folded before Flop


PokerStars Hand #226512968489: Tournament #3188077995, $13.79+$1.21 USD Hold'em No Limit - Level IV (40/80) - 2021/05/06 19:37:12 MSK [2021/05/06 12:37:12 ET]
Table '3188077995 1' 6-max Seat #6 is the button
Seat 1: Picolo52 (1641 in chips)
Seat 4: dimetruk (5498 in chips)
Seat 6: elpato2020 (1861 in chips)
Picolo52: posts the ante 10
dimetruk: posts the ante 10
elpato2020: posts the ante 10
Picolo52: posts small blind 40
dimetruk: posts big blind 80
*** HOLE CARDS ***
Dealt to dimetruk [7d 6c]
elpato2020: raises 96 to 176
Picolo52: calls 136
dimetruk: calls 96
*** FLOP *** [4s 3d 7h]
Picolo52: checks
dimetruk: checks
elpato2020: checks
*** TURN *** [4s 3d 7h] [Qs]
Picolo52: bets 80
dimetruk: calls 80
elpato2020: calls 80
*** RIVER *** [4s 3d 7h Qs] [5h]
Picolo52: checks
dimetruk: bets 359
elpato2020: folds
Picolo52: calls 359
*** SHOW DOWN ***
dimetruk: shows [7d 6c] (a straight, Three to Seven)
Picolo52: mucks hand
dimetruk collected 1516 from pot
*** SUMMARY ***
Total pot 1516 | Rake 0
Board [4s 3d 7h Qs 5h]
Seat 1: Picolo52 (small blind) mucked [9h 9c]
Seat 4: dimetruk (big blind) showed [7d 6c] and won (1516) with a straight, Three to Seven
Seat 6: elpato2020 (button) folded on the River


PokerStars Hand #226512994580: Tournament #3188077995, $13.79+$1.21 USD Hold'em No Limit - Level IV (40/80) - 2021/05/06 19:38:08 MSK [2021/05/06 12:38:08 ET]
Table '3188077995 1' 6-max Seat #1 is the button
Seat 1: Picolo52 (1016 in chips)
Seat 4: dimetruk (6389 in chips)
Seat 6: elpato2020 (1595 in chips)
Picolo52: posts the ante 10
dimetruk: posts the ante 10
elpato2020: posts the ante 10
dimetruk: posts small blind 40
elpato2020: posts big blind 80
*** HOLE CARDS ***
Dealt to dimetruk [5d 4d]
Picolo52: folds
dimetruk: raises 80 to 160
elpato2020: calls 80
*** FLOP *** [4h Ac Td]
dimetruk: bets 116
elpato2020: folds
Uncalled bet (116) returned to dimetruk
dimetruk collected 350 from pot
dimetruk: doesn't show hand
*** SUMMARY ***
Total pot 350 | Rake 0
Board [4h Ac Td]
Seat 1: Picolo52 (button) folded before Flop (didn't bet)
Seat 4: dimetruk (small blind) collected (350)
Seat 6: elpato2020 (big blind) folded on the Flop


PokerStars Hand #226513014873: Tournament #3188077995, $13.79+$1.21 USD Hold'em No Limit - Level V (60/120) - 2021/05/06 19:38:51 MSK [2021/05/06 12:38:51 ET]
Table '3188077995 1' 6-max Seat #6 is the button
Seat 1: Picolo52 (871 in chips)
Seat 4: dimetruk (6554 in chips)
Seat 6: elpato2020 (1575 in chips)
Picolo52: posts the ante 15
dimetruk: posts the ante 15
elpato2020: posts the ante 15
Picolo52: posts small blind 60
dimetruk: posts big blind 120
*** HOLE CARDS ***
Dealt to dimetruk [9c 9d]
elpato2020: folds
Picolo52: raises 736 to 856 and is all-in
dimetruk: calls 736
*** FLOP *** [6d 6h 4s]
*** TURN *** [6d 6h 4s] [As]
*** RIVER *** [6d 6h 4s As] [8s]
*** SHOW DOWN ***
Picolo52: shows [6c Kc] (three of a kind, Sixes)
dimetruk: shows [9c 9d] (two pair, Nines and Sixes)
Picolo52 collected 1757 from pot
*** SUMMARY ***
Total pot 1757 | Rake 0
Board [6d 6h 4s As 8s]
Seat 1: Picolo52 (small blind) showed [6c Kc] and won (1757) with three of a kind, Sixes
Seat 4: dimetruk (big blind) showed [9c 9d] and lost with two pair, Nines and Sixes
Seat 6: elpato2020 (button) folded before Flop (didn't bet)


PokerStars Hand #226513044738: Tournament #3188077995, $13.79+$1.21 USD Hold'em No Limit - Level V (60/120) - 2021/05/06 19:39:54 MSK [2021/05/06 12:39:54 ET]
Table '3188077995 1' 6-max Seat #6 is the button
Seat 1: Picolo52 (1847 in chips)
Seat 4: dimetruk (5398 in chips)
Seat 6: elpato2020 (1755 in chips)
Picolo52: posts the ante 15
dimetruk: posts the ante 15
elpato2020: posts the ante 15
Picolo52: posts small blind 60
dimetruk: posts big blind 120
*** HOLE CARDS ***
Dealt to dimetruk [2h Kh]
elpato2020: raises 144 to 264
Picolo52: calls 204
dimetruk: calls 144
*** FLOP *** [9h Td 4s]
Picolo52: checks
dimetruk: checks
elpato2020: bets 628
Picolo52: folds
dimetruk: folds
Uncalled bet (628) returned to elpato2020
elpato2020 collected 837 from pot
*** SUMMARY ***
Total pot 837 | Rake 0
Board [9h Td 4s]
Seat 1: Picolo52 (small blind) folded on the Flop
Seat 4: dimetruk (big blind) folded on the Flop
Seat 6: elpato2020 (button) collected (837)


PokerStars Hand #226513072013: Tournament #3188077995, $13.79+$1.21 USD Hold'em No Limit - Level V (60/120) - 2021/05/06 19:40:52 MSK [2021/05/06 12:40:52 ET]
Table '3188077995 1' 6-max Seat #6 is the button
Seat 1: Picolo52 (1883 in chips)
Seat 4: dimetruk (4609 in chips)
Seat 6: elpato2020 (2508 in chips)
Picolo52: posts the ante 15
dimetruk: posts the ante 15
elpato2020: posts the ante 15
Picolo52: posts small blind 60
dimetruk: posts big blind 120
*** HOLE CARDS ***
Dealt to dimetruk [Jc 3c]
elpato2020: raises 120 to 240
Picolo52: folds
dimetruk: calls 120
*** FLOP *** [6c Ts 9d]
dimetruk: checks
elpato2020: checks
*** TURN *** [6c Ts 9d] [Qd]
dimetruk: bets 263
elpato2020: folds
Uncalled bet (263) returned to dimetruk
dimetruk collected 585 from pot
dimetruk: doesn't show hand
*** SUMMARY ***
Total pot 585 | Rake 0
Board [6c Ts 9d Qd]
Seat 1: Picolo52 (small blind) folded before Flop
Seat 4: dimetruk (big blind) collected (585)
Seat 6: elpato2020 (button) folded on the Turn


PokerStars Hand #226513121816: Tournament #3188077995, $13.79+$1.21 USD Hold'em No Limit - Level V (60/120) - 2021/05/06 19:42:37 MSK [2021/05/06 12:42:37 ET]
Table '3188077995 1' 6-max Seat #4 is the button
Seat 1: Picolo52 (563 in chips)
Seat 4: dimetruk (5314 in chips)
Seat 6: elpato2020 (3123 in chips)
Picolo52: posts the ante 15
dimetruk: posts the ante 15
elpato2020: posts the ante 15
elpato2020: posts small blind 60
Picolo52: posts big blind 120
*** HOLE CARDS ***
Dealt to dimetruk [Td Js]
dimetruk: raises 120 to 240
elpato2020: folds
Picolo52: calls 120
*** FLOP *** [8c 4d 8h]
Picolo52: checks
dimetruk: bets 360
Picolo52: folds
Uncalled bet (360) returned to dimetruk
dimetruk collected 585 from pot
dimetruk: doesn't show hand
*** SUMMARY ***
Total pot 585 | Rake 0
Board [8c 4d 8h]
Seat 1: Picolo52 (big blind) folded on the Flop
Seat 4: dimetruk (button) collected (585)
Seat 6: elpato2020 (small blind) folded before Flop


PokerStars Hand #226513146851: Tournament #3188077995, $13.79+$1.21 USD Hold'em No Limit - Level V (60/120) - 2021/05/06 19:43:30 MSK [2021/05/06 12:43:30 ET]
Table '3188077995 1' 6-max Seat #6 is the button
Seat 4: dimetruk (5644 in chips)
Seat 6: elpato2020 (3356 in chips)
dimetruk: posts the ante 15
elpato2020: posts the ante 15
elpato2020: posts small blind 60
dimetruk: posts big blind 120
*** HOLE CARDS ***
Dealt to dimetruk [As 9c]
elpato2020: raises 120 to 240
dimetruk: raises 420 to 660
elpato2020: calls 420
*** FLOP *** [6d Qc Ac]
dimetruk: bets 608
elpato2020: calls 608
*** TURN *** [6d Qc Ac] [7s]
dimetruk: bets 2340
elpato2020: folds
Uncalled bet (2340) returned to dimetruk
dimetruk collected 2566 from pot
dimetruk: doesn't show hand
*** SUMMARY ***
Total pot 2566 | Rake 0
Board [6d Qc Ac 7s]
Seat 4: dimetruk (big blind) collected (2566)
Seat 6: elpato2020 (button) (small blind) folded on the Turn


PokerStars Hand #226513174405: Tournament #3188077995, $13.79+$1.21 USD Hold'em No Limit - Level V (60/120) - 2021/05/06 19:44:29 MSK [2021/05/06 12:44:29 ET]
Table '3188077995 1' 6-max Seat #6 is the button
Seat 4: dimetruk (6672 in chips)
Seat 6: elpato2020 (2328 in chips)
dimetruk: posts the ante 15
elpato2020: posts the ante 15
elpato2020: posts small blind 60
dimetruk: posts big blind 120
*** HOLE CARDS ***
Dealt to dimetruk [Th 4d]
elpato2020: calls 60
dimetruk: checks
*** FLOP *** [7d 8c 5c]
dimetruk: checks
elpato2020: bets 120
dimetruk: folds
Uncalled bet (120) returned to elpato2020
elpato2020 collected 270 from pot
*** SUMMARY ***
Total pot 270 | Rake 0
Board [7d 8c 5c]
Seat 4: dimetruk (big blind) folded on the Flop
Seat 6: elpato2020 (button) (small blind) collected (270)


PokerStars Hand #226513179928: Tournament #3188077995, $13.79+$1.21 USD Hold'em No Limit - Level V (60/120) - 2021/05/06 19:44:40 MSK [2021/05/06 12:44:40 ET]
Table '3188077995 1' 6-max Seat #4 is the button
Seat 4: dimetruk (6537 in chips)
Seat 6: elpato2020 (2463 in chips)
dimetruk: posts the ante 15
elpato2020: posts the ante 15
dimetruk: posts small blind 60
elpato2020: posts big blind 120
*** HOLE CARDS ***
Dealt to dimetruk [Th Qc]
dimetruk: raises 120 to 240
elpato2020: calls 120
*** FLOP *** [Jd 4s 3h]
elpato2020: checks
dimetruk: bets 230
elpato2020: calls 230
*** TURN *** [Jd 4s 3h] [5h]
elpato2020: checks
dimetruk: checks
*** RIVER *** [Jd 4s 3h 5h] [Kd]
elpato2020: checks
dimetruk: bets 534
elpato2020: raises 534 to 1068
dimetruk: folds
Uncalled bet (534) returned to elpato2020
elpato2020 collected 2038 from pot
*** SUMMARY ***
Total pot 2038 | Rake 0
Board [Jd 4s 3h 5h Kd]
Seat 4: dimetruk (button) (small blind) folded on the River
Seat 6: elpato2020 (big blind) collected (2038)


PokerStars Hand #226513203507: Tournament #3188077995, $13.79+$1.21 USD Hold'em No Limit - Level V (60/120) - 2021/05/06 19:45:30 MSK [2021/05/06 12:45:30 ET]
Table '3188077995 1' 6-max Seat #4 is the button
Seat 4: dimetruk (5593 in chips)
Seat 6: elpato2020 (3407 in chips)
dimetruk: posts the ante 15
elpato2020: posts the ante 15
dimetruk: posts small blind 60
elpato2020: posts big blind 120
*** HOLE CARDS ***
Dealt to dimetruk [3d 4c]
dimetruk: raises 120 to 240
elpato2020: calls 120
*** FLOP *** [Tc Qh 8d]
elpato2020: checks
dimetruk: checks
*** TURN *** [Tc Qh 8d] [2h]
elpato2020: bets 245
dimetruk: folds
Uncalled bet (245) returned to elpato2020
elpato2020 collected 510 from pot
*** SUMMARY ***
Total pot 510 | Rake 0
Board [Tc Qh 8d 2h]
Seat 4: dimetruk (button) (small blind) folded on the Turn
Seat 6: elpato2020 (big blind) collected (510)


PokerStars Hand #226513218830: Tournament #3188077995, $13.79+$1.21 USD Hold'em No Limit - Level V (60/120) - 2021/05/06 19:46:03 MSK [2021/05/06 12:46:03 ET]
Table '3188077995 1' 6-max Seat #6 is the button
Seat 4: dimetruk (5548 in chips)
Seat 6: elpato2020 (3452 in chips)
dimetruk: posts the ante 15
elpato2020: posts the ante 15
elpato2020: posts small blind 60
dimetruk: posts big blind 120
*** HOLE CARDS ***
Dealt to dimetruk [2h Jd]
elpato2020: calls 60
dimetruk: checks
*** FLOP *** [8s Ad As]
dimetruk: checks
elpato2020: checks
*** TURN *** [8s Ad As] [Ks]
dimetruk: checks
elpato2020: bets 130
dimetruk: folds
Uncalled bet (130) returned to elpato2020
elpato2020 collected 270 from pot
*** SUMMARY ***
Total pot 270 | Rake 0
Board [8s Ad As Ks]
Seat 4: dimetruk (big blind) folded on the Turn
Seat 6: elpato2020 (button) (small blind) collected (270)


PokerStars Hand #226513229524: Tournament #3188077995, $13.79+$1.21 USD Hold'em No Limit - Level V (60/120) - 2021/05/06 19:46:25 MSK [2021/05/06 12:46:25 ET]
Table '3188077995 1' 6-max Seat #4 is the button
Seat 4: dimetruk (5413 in chips)
Seat 6: elpato2020 (3587 in chips)
dimetruk: posts the ante 15
elpato2020: posts the ante 15
dimetruk: posts small blind 60
elpato2020: posts big blind 120
*** HOLE CARDS ***
Dealt to dimetruk [8c Qd]
dimetruk: raises 120 to 240
elpato2020: calls 120
*** FLOP *** [5s 4d 8h]
elpato2020: checks
dimetruk: bets 281
elpato2020: raises 515 to 796
dimetruk: calls 515
*** TURN *** [5s 4d 8h] [2c]
elpato2020: checks
dimetruk: checks
*** RIVER *** [5s 4d 8h 2c] [9h]
elpato2020: bets 504
dimetruk: calls 504
*** SHOW DOWN ***
elpato2020: shows [8d Qc] (a pair of Eights)
dimetruk: shows [8c Qd] (a pair of Eights)
elpato2020 collected 1555 from pot
dimetruk collected 1555 from pot
*** SUMMARY ***
Total pot 3110 | Rake 0
Board [5s 4d 8h 2c 9h]
Seat 4: dimetruk (button) (small blind) showed [8c Qd] and won (1555) with a pair of Eights
Seat 6: elpato2020 (big blind) showed [8d Qc] and won (1555) with a pair of Eights


PokerStars Hand #226513265038: Tournament #3188077995, $13.79+$1.21 USD Hold'em No Limit - Level V (60/120) - 2021/05/06 19:47:41 MSK [2021/05/06 12:47:41 ET]
Table '3188077995 1' 6-max Seat #6 is the button
Seat 4: dimetruk (5233 in chips)
Seat 6: elpato2020 (3767 in chips)
dimetruk: posts the ante 15
elpato2020: posts the ante 15
elpato2020: posts small blind 60
dimetruk: posts big blind 120
*** HOLE CARDS ***
Dealt to dimetruk [Ad 2c]
elpato2020: calls 60
dimetruk: raises 270 to 390
elpato2020: calls 270
*** FLOP *** [Th 8c Qh]
dimetruk: checks
elpato2020: bets 360
dimetruk: folds
Uncalled bet (360) returned to elpato2020
elpato2020 collected 810 from pot
*** SUMMARY ***
Total pot 810 | Rake 0
Board [Th 8c Qh]
Seat 4: dimetruk (big blind) folded on the Flop
Seat 6: elpato2020 (button) (small blind) collected (810)


PokerStars Hand #226513276798: Tournament #3188077995, $13.79+$1.21 USD Hold'em No Limit - Level V (60/120) - 2021/05/06 19:48:06 MSK [2021/05/06 12:48:06 ET]
Table '3188077995 1' 6-max Seat #4 is the button
Seat 4: dimetruk (4828 in chips)
Seat 6: elpato2020 (4172 in chips)
dimetruk: posts the ante 15
elpato2020: posts the ante 15
dimetruk: posts small blind 60
elpato2020: posts big blind 120
*** HOLE CARDS ***
Dealt to dimetruk [4d Kd]
dimetruk: raises 120 to 240
elpato2020: calls 120
*** FLOP *** [4h 6d 7s]
elpato2020: checks
dimetruk: checks
*** TURN *** [4h 6d 7s] [Qh]
elpato2020: bets 240
dimetruk: calls 240
*** RIVER *** [4h 6d 7s Qh] [Ks]
elpato2020: bets 743
dimetruk: raises 3590 to 4333 and is all-in
elpato2020: folds [Kh]
Uncalled bet (3590) returned to dimetruk
dimetruk collected 2476 from pot
dimetruk: doesn't show hand
*** SUMMARY ***
Total pot 2476 | Rake 0
Board [4h 6d 7s Qh Ks]
Seat 4: dimetruk (button) (small blind) collected (2476)
Seat 6: elpato2020 (big blind) folded on the River


PokerStars Hand #226513301680: Tournament #3188077995, $13.79+$1.21 USD Hold'em No Limit - Level VI (80/160) - 2021/05/06 19:48:58 MSK [2021/05/06 12:48:58 ET]
Table '3188077995 1' 6-max Seat #6 is the button
Seat 4: dimetruk (6066 in chips)
Seat 6: elpato2020 (2934 in chips)
dimetruk: posts the ante 20
elpato2020: posts the ante 20
elpato2020: posts small blind 80
dimetruk: posts big blind 160
*** HOLE CARDS ***
Dealt to dimetruk [Ad Qd]
elpato2020: raises 2754 to 2914 and is all-in
dimetruk: calls 2754
*** FLOP *** [5s Ac 8s]
*** TURN *** [5s Ac 8s] [3c]
*** RIVER *** [5s Ac 8s 3c] [6s]
*** SHOW DOWN ***
dimetruk: shows [Ad Qd] (a pair of Aces)
elpato2020: shows [7s 7d] (a pair of Sevens)
dimetruk collected 5868 from pot
elpato2020 finished the tournament in 2nd place and received $28.95.
dimetruk wins the tournament and receives $53.79 - congratulations!
*** SUMMARY ***
Total pot 5868 | Rake 0
Board [5s Ac 8s 3c 6s]
Seat 4: dimetruk (big blind) showed [Ad Qd] and won (5868) with a pair of Aces
Seat 6: elpato2020 (button) (small blind) showed [7s 7d] and lost with a pair of Sevens


PokerStars Hand #226512927490: Tournament #3188080898, $27.58+$2.42 USD Hold'em No Limit - Level I (10/20) - 2021/05/06 19:35:45 MSK [2021/05/06 12:35:45 ET]
Table '3188080898 1' 6-max Seat #1 is the button
Seat 1: ScousePro (1500 in chips)
Seat 2: tomyta1710 (1500 in chips)
Seat 3: 1123580 (1500 in chips)
Seat 4: dimetruk (1500 in chips)
Seat 5: punti77777 (1500 in chips)
Seat 6: BBIIGG-ZZ (1500 in chips)
ScousePro: posts the ante 3
tomyta1710: posts the ante 3
1123580: posts the ante 3
dimetruk: posts the ante 3
punti77777: posts the ante 3
BBIIGG-ZZ: posts the ante 3
tomyta1710: posts small blind 10
1123580: posts big blind 20
*** HOLE CARDS ***
Dealt to dimetruk [Ks Ah]
dimetruk: raises 20 to 40
punti77777: calls 40
BBIIGG-ZZ: calls 40
ScousePro: folds
tomyta1710: folds
1123580: folds
*** FLOP *** [2h Tc 5s]
dimetruk: checks
punti77777: checks
BBIIGG-ZZ: bets 120
dimetruk: folds
punti77777: folds
Uncalled bet (120) returned to BBIIGG-ZZ
BBIIGG-ZZ collected 168 from pot
BBIIGG-ZZ: doesn't show hand
*** SUMMARY ***
Total pot 168 | Rake 0
Board [2h Tc 5s]
Seat 1: ScousePro (button) folded before Flop (didn't bet)
Seat 2: tomyta1710 (small blind) folded before Flop
Seat 3: 1123580 (big blind) folded before Flop
Seat 4: dimetruk folded on the Flop
Seat 5: punti77777 folded on the Flop
Seat 6: BBIIGG-ZZ collected (168)


PokerStars Hand #226513022134: Tournament #3188080898, $27.58+$2.42 USD Hold'em No Limit - Level I (10/20) - 2021/05/06 19:39:06 MSK [2021/05/06 12:39:06 ET]
Table '3188080898 1' 6-max Seat #5 is the button
Seat 1: ScousePro (1488 in chips)
Seat 2: tomyta1710 (1428 in chips)
Seat 3: 1123580 (1586 in chips)
Seat 4: dimetruk (1466 in chips)
Seat 5: punti77777 (1198 in chips)
Seat 6: BBIIGG-ZZ (1834 in chips)
ScousePro: posts the ante 3
tomyta1710: posts the ante 3
1123580: posts the ante 3
dimetruk: posts the ante 3
punti77777: posts the ante 3
BBIIGG-ZZ: posts the ante 3
BBIIGG-ZZ: posts small blind 10
ScousePro: posts big blind 20
*** HOLE CARDS ***
Dealt to dimetruk [9h Td]
tomyta1710: folds
1123580: folds
dimetruk: raises 20 to 40
punti77777: raises 20 to 60
BBIIGG-ZZ: calls 50
ScousePro: folds
dimetruk: calls 20
*** FLOP *** [Jd Kh Qh]
BBIIGG-ZZ: checks
dimetruk: checks
punti77777: bets 20
BBIIGG-ZZ: calls 20
dimetruk: raises 209 to 229
punti77777: calls 209
BBIIGG-ZZ: calls 209
*** TURN *** [Jd Kh Qh] [Qc]
BBIIGG-ZZ: checks
dimetruk: bets 1174 and is all-in
punti77777: calls 906 and is all-in
BBIIGG-ZZ: folds
Uncalled bet (268) returned to dimetruk
*** RIVER *** [Jd Kh Qh Qc] [Ts]
*** SHOW DOWN ***
dimetruk: shows [9h Td] (a straight, Nine to King)
punti77777: shows [Tc As] (a straight, Ten to Ace)
punti77777 collected 2717 from pot
*** SUMMARY ***
Total pot 2717 | Rake 0
Board [Jd Kh Qh Qc Ts]
Seat 1: ScousePro (big blind) folded before Flop
Seat 2: tomyta1710 folded before Flop (didn't bet)
Seat 3: 1123580 folded before Flop (didn't bet)
Seat 4: dimetruk showed [9h Td] and lost with a straight, Nine to King
Seat 5: punti77777 (button) showed [Tc As] and won (2717) with a straight, Ten to Ace
Seat 6: BBIIGG-ZZ (small blind) folded on the Turn


PokerStars Hand #226513099654: Tournament #3188080898, $27.58+$2.42 USD Hold'em No Limit - Level I (10/20) - 2021/05/06 19:41:50 MSK [2021/05/06 12:41:50 ET]
Table '3188080898 1' 6-max Seat #2 is the button
Seat 1: ScousePro (1449 in chips)
Seat 2: tomyta1710 (1389 in chips)
Seat 3: 1123580 (1675 in chips)
Seat 4: dimetruk (262 in chips)
Seat 5: punti77777 (2689 in chips)
Seat 6: BBIIGG-ZZ (1536 in chips)
ScousePro: posts the ante 3
tomyta1710: posts the ante 3
1123580: posts the ante 3
dimetruk: posts the ante 3
punti77777: posts the ante 3
BBIIGG-ZZ: posts the ante 3
1123580: posts small blind 10
dimetruk: posts big blind 20
*** HOLE CARDS ***
Dealt to dimetruk [Tc Qd]
punti77777: raises 20 to 40
BBIIGG-ZZ: folds
ScousePro: folds
tomyta1710: folds
1123580: folds
dimetruk: calls 20
*** FLOP *** [Kh 9s 5s]
dimetruk: checks
punti77777: bets 108
dimetruk: folds
Uncalled bet (108) returned to punti77777
punti77777 collected 108 from pot
*** SUMMARY ***
Total pot 108 | Rake 0
Board [Kh 9s 5s]
Seat 1: ScousePro folded before Flop (didn't bet)
Seat 2: tomyta1710 (button) folded before Flop (didn't bet)
Seat 3: 1123580 (small blind) folded before Flop
Seat 4: dimetruk (big blind) folded on the Flop
Seat 5: punti77777 collected (108)
Seat 6: BBIIGG-ZZ folded before Flop (didn't bet)


PokerStars Hand #226513169863: Tournament #3188080898, $27.58+$2.42 USD Hold'em No Limit - Level I (10/20) - 2021/05/06 19:44:19 MSK [2021/05/06 12:44:19 ET]
Table '3188080898 1' 6-max Seat #5 is the button
Seat 1: ScousePro (1488 in chips)
Seat 2: tomyta1710 (1380 in chips)
Seat 3: 1123580 (1516 in chips)
Seat 4: dimetruk (203 in chips)
Seat 5: punti77777 (2906 in chips)
Seat 6: BBIIGG-ZZ (1507 in chips)
ScousePro: posts the ante 3
tomyta1710: posts the ante 3
1123580: posts the ante 3
dimetruk: posts the ante 3
punti77777: posts the ante 3
BBIIGG-ZZ: posts the ante 3
BBIIGG-ZZ: posts small blind 10
ScousePro: posts big blind 20
*** HOLE CARDS ***
Dealt to dimetruk [8s 6s]
tomyta1710: folds
1123580: folds
dimetruk: raises 180 to 200 and is all-in
punti77777: calls 200
BBIIGG-ZZ: folds
ScousePro: folds
*** FLOP *** [Qh 8c 5h]
*** TURN *** [Qh 8c 5h] [6d]
*** RIVER *** [Qh 8c 5h 6d] [3h]
*** SHOW DOWN ***
dimetruk: shows [8s 6s] (two pair, Eights and Sixes)
punti77777: shows [9h Jh] (a flush, Queen high)
punti77777 collected 448 from pot
dimetruk finished the tournament in 6th place
*** SUMMARY ***
Total pot 448 | Rake 0
Board [Qh 8c 5h 6d 3h]
Seat 1: ScousePro (big blind) folded before Flop
Seat 2: tomyta1710 folded before Flop (didn't bet)
Seat 3: 1123580 folded before Flop (didn't bet)
Seat 4: dimetruk showed [8s 6s] and lost with two pair, Eights and Sixes
Seat 5: punti77777 (button) showed [9h Jh] and won (448) with a flush, Queen high
Seat 6: BBIIGG-ZZ (small blind) folded before Flop


PokerStars Hand #226511949093: Tournament #3188088059, $13.70+$1.30 USD Hold'em No Limit - Level I (10/20) - 2021/05/06 19:00:24 MSK [2021/05/06 12:00:24 ET]
Table '3188088059 1' 9-max Seat #2 is the button
Seat 1: dimetruk (1497 in chips)
Seat 2: TaiyaL (1487 in chips) is sitting out
Seat 3: jmc995 (1477 in chips)
Seat 4: suru2010 (1497 in chips)
Seat 5: Norbertxxx13 (1497 in chips)
Seat 6: Nick033099 (1477 in chips)
Seat 7: GivMeMonies (1157 in chips)
Seat 8: 599alex (1357 in chips)
Seat 9: SD ANDRE (2054 in chips)
dimetruk: posts the ante 3
TaiyaL: posts the ante 3
jmc995: posts the ante 3
suru2010: posts the ante 3
Norbertxxx13: posts the ante 3
Nick033099: posts the ante 3
GivMeMonies: posts the ante 3
599alex: posts the ante 3
SD ANDRE: posts the ante 3
jmc995: posts small blind 10
suru2010: posts big blind 20
*** HOLE CARDS ***
Dealt to dimetruk [Kc Ks]
Norbertxxx13: folds
Nick033099: folds
GivMeMonies: raises 20 to 40
599alex: calls 40
SD ANDRE: calls 40
dimetruk: raises 120 to 160
TaiyaL: folds
jmc995: folds
suru2010: folds
GivMeMonies: calls 120
599alex: calls 120
SD ANDRE: folds
*** FLOP *** [3c 4c 6h]
GivMeMonies: checks
599alex: checks
dimetruk: bets 317
GivMeMonies: folds
599alex: folds
Uncalled bet (317) returned to dimetruk
dimetruk collected 577 from pot
dimetruk: doesn't show hand
*** SUMMARY ***
Total pot 577 | Rake 0
Board [3c 4c 6h]
Seat 1: dimetruk collected (577)
Seat 2: TaiyaL (button) folded before Flop (didn't bet)
Seat 3: jmc995 (small blind) folded before Flop
Seat 4: suru2010 (big blind) folded before Flop
Seat 5: Norbertxxx13 folded before Flop (didn't bet)
Seat 6: Nick033099 folded before Flop (didn't bet)
Seat 7: GivMeMonies folded on the Flop
Seat 8: 599alex folded on the Flop
Seat 9: SD ANDRE folded before Flop


PokerStars Hand #226512066555: Tournament #3188088059, $13.70+$1.30 USD Hold'em No Limit - Level I (10/20) - 2021/05/06 19:04:55 MSK [2021/05/06 12:04:55 ET]
Table '3188088059 1' 9-max Seat #7 is the button
Seat 1: dimetruk (1902 in chips)
Seat 2: TaiyaL (1475 in chips) is sitting out
Seat 3: jmc995 (1358 in chips)
Seat 4: suru2010 (1455 in chips)
Seat 5: Norbertxxx13 (3339 in chips)
Seat 7: GivMeMonies (881 in chips)
Seat 8: 599alex (1088 in chips)
Seat 9: SD ANDRE (2002 in chips)
dimetruk: posts the ante 3
TaiyaL: posts the ante 3
jmc995: posts the ante 3
suru2010: posts the ante 3
Norbertxxx13: posts the ante 3
GivMeMonies: posts the ante 3
599alex: posts the ante 3
SD ANDRE: posts the ante 3
599alex: posts small blind 10
SD ANDRE: posts big blind 20
*** HOLE CARDS ***
Dealt to dimetruk [Ah Kc]
dimetruk: raises 20 to 40
TaiyaL: folds
jmc995: folds
suru2010: folds
Norbertxxx13: folds
GivMeMonies: folds
599alex: folds
SD ANDRE: calls 20
*** FLOP *** [6s 2c Ks]
SD ANDRE: checks
dimetruk: bets 63
SD ANDRE: folds
Uncalled bet (63) returned to dimetruk
dimetruk collected 114 from pot
dimetruk: doesn't show hand
*** SUMMARY ***
Total pot 114 | Rake 0
Board [6s 2c Ks]
Seat 1: dimetruk collected (114)
Seat 2: TaiyaL folded before Flop (didn't bet)
Seat 3: jmc995 folded before Flop (didn't bet)
Seat 4: suru2010 folded before Flop (didn't bet)
Seat 5: Norbertxxx13 folded before Flop (didn't bet)
Seat 7: GivMeMonies (button) folded before Flop (didn't bet)
Seat 8: 599alex (small blind) folded before Flop
Seat 9: SD ANDRE (big blind) folded on the Flop


PokerStars Hand #226512081705: Tournament #3188088059, $13.70+$1.30 USD Hold'em No Limit - Level I (10/20) - 2021/05/06 19:05:29 MSK [2021/05/06 12:05:29 ET]
Table '3188088059 1' 9-max Seat #8 is the button
Seat 1: dimetruk (1973 in chips)
Seat 2: TaiyaL (1472 in chips) is sitting out
Seat 3: jmc995 (1355 in chips)
Seat 4: suru2010 (1452 in chips)
Seat 5: Norbertxxx13 (3336 in chips)
Seat 7: GivMeMonies (878 in chips)
Seat 8: 599alex (1075 in chips)
Seat 9: SD ANDRE (1959 in chips)
dimetruk: posts the ante 3
TaiyaL: posts the ante 3
jmc995: posts the ante 3
suru2010: posts the ante 3
Norbertxxx13: posts the ante 3
GivMeMonies: posts the ante 3
599alex: posts the ante 3
SD ANDRE: posts the ante 3
SD ANDRE: posts small blind 10
dimetruk: posts big blind 20
*** HOLE CARDS ***
Dealt to dimetruk [Jd Ks]
TaiyaL: folds
jmc995: raises 20 to 40
suru2010: folds
Norbertxxx13: folds
GivMeMonies: folds
599alex: calls 40
SD ANDRE: folds
dimetruk: calls 20
*** FLOP *** [6h 7c 8c]
dimetruk: checks
jmc995: bets 60
599alex: calls 60
TaiyaL has returned
dimetruk: folds
*** TURN *** [6h 7c 8c] [6s]
jmc995: checks
599alex: checks
*** RIVER *** [6h 7c 8c 6s] [Jc]
jmc995: checks
599alex: bets 150
jmc995: folds
Uncalled bet (150) returned to 599alex
599alex collected 274 from pot
599alex: doesn't show hand
*** SUMMARY ***
Total pot 274 | Rake 0
Board [6h 7c 8c 6s Jc]
Seat 1: dimetruk (big blind) folded on the Flop
Seat 2: TaiyaL folded before Flop (didn't bet)
Seat 3: jmc995 folded on the River
Seat 4: suru2010 folded before Flop (didn't bet)
Seat 5: Norbertxxx13 folded before Flop (didn't bet)
Seat 7: GivMeMonies folded before Flop (didn't bet)
Seat 8: 599alex (button) collected (274)
Seat 9: SD ANDRE (small blind) folded before Flop


PokerStars Hand #226512266252: Tournament #3188088059, $13.70+$1.30 USD Hold'em No Limit - Level II (15/30) - 2021/05/06 19:11:57 MSK [2021/05/06 12:11:57 ET]
Table '3188088059 1' 9-max Seat #8 is the button
Seat 1: dimetruk (1898 in chips)
Seat 2: TaiyaL (2155 in chips)
Seat 4: suru2010 (1431 in chips)
Seat 5: Norbertxxx13 (3301 in chips)
Seat 7: GivMeMonies (705 in chips)
Seat 8: 599alex (2083 in chips)
Seat 9: SD ANDRE (1927 in chips)
dimetruk: posts the ante 4
TaiyaL: posts the ante 4
suru2010: posts the ante 4
Norbertxxx13: posts the ante 4
GivMeMonies: posts the ante 4
599alex: posts the ante 4
SD ANDRE: posts the ante 4
SD ANDRE: posts small blind 15
dimetruk: posts big blind 30
*** HOLE CARDS ***
Dealt to dimetruk [5s 7d]
TaiyaL: folds
suru2010: raises 52 to 82
Norbertxxx13: folds
GivMeMonies: folds
599alex: folds
SD ANDRE: folds
dimetruk: calls 52
*** FLOP *** [5h As 9d]
dimetruk: checks
suru2010: bets 104
dimetruk: calls 104
*** TURN *** [5h As 9d] [8s]
dimetruk: checks
suru2010: bets 208
dimetruk: folds
Uncalled bet (208) returned to suru2010
suru2010 collected 415 from pot
suru2010: doesn't show hand
*** SUMMARY ***
Total pot 415 | Rake 0
Board [5h As 9d 8s]
Seat 1: dimetruk (big blind) folded on the Turn
Seat 2: TaiyaL folded before Flop (didn't bet)
Seat 4: suru2010 collected (415)
Seat 5: Norbertxxx13 folded before Flop (didn't bet)
Seat 7: GivMeMonies folded before Flop (didn't bet)
Seat 8: 599alex (button) folded before Flop (didn't bet)
Seat 9: SD ANDRE (small blind) folded before Flop


PokerStars Hand #226512286820: Tournament #3188088059, $13.70+$1.30 USD Hold'em No Limit - Level II (15/30) - 2021/05/06 19:12:43 MSK [2021/05/06 12:12:43 ET]
Table '3188088059 1' 9-max Seat #9 is the button
Seat 1: dimetruk (1708 in chips)
Seat 2: TaiyaL (2151 in chips)
Seat 4: suru2010 (1656 in chips)
Seat 5: Norbertxxx13 (3297 in chips)
Seat 7: GivMeMonies (701 in chips)
Seat 8: 599alex (2079 in chips)
Seat 9: SD ANDRE (1908 in chips)
dimetruk: posts the ante 4
TaiyaL: posts the ante 4
suru2010: posts the ante 4
Norbertxxx13: posts the ante 4
GivMeMonies: posts the ante 4
599alex: posts the ante 4
SD ANDRE: posts the ante 4
dimetruk: posts small blind 15
TaiyaL: posts big blind 30
*** HOLE CARDS ***
Dealt to dimetruk [Qd Kh]
suru2010: folds
Norbertxxx13: folds
GivMeMonies: calls 30
599alex: calls 30
SD ANDRE: calls 30
dimetruk: calls 15
TaiyaL: checks
*** FLOP *** [Ac 9s 3c]
dimetruk: checks
TaiyaL: checks
GivMeMonies: bets 30
599alex: calls 30
SD ANDRE: folds
dimetruk: calls 30
TaiyaL: folds
*** TURN *** [Ac 9s 3c] [8c]
dimetruk: checks
GivMeMonies: bets 60
599alex: calls 60
dimetruk: folds
*** RIVER *** [Ac 9s 3c 8c] [3h]
GivMeMonies: bets 194
599alex: raises 314 to 508
GivMeMonies: calls 314
*** SHOW DOWN ***
599alex: shows [9c 9h] (a full house, Nines full of Threes)
GivMeMonies: mucks hand
599alex collected 1404 from pot
*** SUMMARY ***
Total pot 1404 | Rake 0
Board [Ac 9s 3c 8c 3h]
Seat 1: dimetruk (small blind) folded on the Turn
Seat 2: TaiyaL (big blind) folded on the Flop
Seat 4: suru2010 folded before Flop (didn't bet)
Seat 5: Norbertxxx13 folded before Flop (didn't bet)
Seat 7: GivMeMonies mucked [Qh Ad]
Seat 8: 599alex showed [9c 9h] and won (1404) with a full house, Nines full of Threes
Seat 9: SD ANDRE (button) folded on the Flop


PokerStars Hand #226512385178: Tournament #3188088059, $13.70+$1.30 USD Hold'em No Limit - Level II (15/30) - 2021/05/06 19:16:25 MSK [2021/05/06 12:16:25 ET]
Table '3188088059 1' 9-max Seat #8 is the button
Seat 1: dimetruk (1628 in chips)
Seat 2: TaiyaL (2582 in chips)
Seat 4: suru2010 (1556 in chips)
Seat 5: Norbertxxx13 (3077 in chips)
Seat 8: 599alex (2745 in chips)
Seat 9: SD ANDRE (1912 in chips)
dimetruk: posts the ante 4
TaiyaL: posts the ante 4
suru2010: posts the ante 4
Norbertxxx13: posts the ante 4
599alex: posts the ante 4
SD ANDRE: posts the ante 4
SD ANDRE: posts small blind 15
dimetruk: posts big blind 30
*** HOLE CARDS ***
Dealt to dimetruk [8c Ks]
TaiyaL: folds
suru2010: folds
Norbertxxx13: folds
599alex: calls 30
SD ANDRE: folds
dimetruk: checks
*** FLOP *** [4d Ts Qh]
dimetruk: checks
599alex: checks
*** TURN *** [4d Ts Qh] [Jh]
dimetruk: bets 45
599alex: calls 45
*** RIVER *** [4d Ts Qh Jh] [6s]
dimetruk: bets 142
599alex: raises 142 to 284
dimetruk: folds
Uncalled bet (142) returned to 599alex
599alex collected 473 from pot
599alex: doesn't show hand
*** SUMMARY ***
Total pot 473 | Rake 0
Board [4d Ts Qh Jh 6s]
Seat 1: dimetruk (big blind) folded on the River
Seat 2: TaiyaL folded before Flop (didn't bet)
Seat 4: suru2010 folded before Flop (didn't bet)
Seat 5: Norbertxxx13 folded before Flop (didn't bet)
Seat 8: 599alex (button) collected (473)
Seat 9: SD ANDRE (small blind) folded before Flop


PokerStars Hand #226512461914: Tournament #3188088059, $13.70+$1.30 USD Hold'em No Limit - Level III (25/50) - 2021/05/06 19:19:19 MSK [2021/05/06 12:19:19 ET]
Table '3188088059 1' 9-max Seat #8 is the button
Seat 1: dimetruk (1546 in chips)
Seat 2: TaiyaL (2222 in chips)
Seat 4: suru2010 (1471 in chips)
Seat 5: Norbertxxx13 (3083 in chips)
Seat 8: 599alex (2726 in chips)
Seat 9: SD ANDRE (2452 in chips)
dimetruk: posts the ante 6
TaiyaL: posts the ante 6
suru2010: posts the ante 6
Norbertxxx13: posts the ante 6
599alex: posts the ante 6
SD ANDRE: posts the ante 6
SD ANDRE: posts small blind 25
dimetruk: posts big blind 50
*** HOLE CARDS ***
Dealt to dimetruk [2c Ks]
TaiyaL: folds
suru2010: folds
Norbertxxx13: raises 75 to 125
599alex: calls 125
SD ANDRE: folds
dimetruk: calls 75
*** FLOP *** [3d Js 6c]
dimetruk: checks
Norbertxxx13: bets 250
599alex: calls 250
dimetruk: folds
*** TURN *** [3d Js 6c] [9c]
Norbertxxx13: checks
599alex: bets 200
Norbertxxx13: calls 200
*** RIVER *** [3d Js 6c 9c] [8c]
Norbertxxx13: checks
599alex: bets 300
Norbertxxx13: calls 300
*** SHOW DOWN ***
599alex: shows [9h Jh] (two pair, Jacks and Nines)
Norbertxxx13: mucks hand
599alex collected 1936 from pot
*** SUMMARY ***
Total pot 1936 | Rake 0
Board [3d Js 6c 9c 8c]
Seat 1: dimetruk (big blind) folded on the Flop
Seat 2: TaiyaL folded before Flop (didn't bet)
Seat 4: suru2010 folded before Flop (didn't bet)
Seat 5: Norbertxxx13 mucked [7d 7h]
Seat 8: 599alex (button) showed [9h Jh] and won (1936) with two pair, Jacks and Nines
Seat 9: SD ANDRE (small blind) folded before Flop


PokerStars Hand #226512487540: Tournament #3188088059, $13.70+$1.30 USD Hold'em No Limit - Level III (25/50) - 2021/05/06 19:20:17 MSK [2021/05/06 12:20:17 ET]
Table '3188088059 1' 9-max Seat #9 is the button
Seat 1: dimetruk (1415 in chips)
Seat 2: TaiyaL (2216 in chips)
Seat 4: suru2010 (1465 in chips)
Seat 5: Norbertxxx13 (2202 in chips)
Seat 8: 599alex (3781 in chips)
Seat 9: SD ANDRE (2421 in chips)
dimetruk: posts the ante 6
TaiyaL: posts the ante 6
suru2010: posts the ante 6
Norbertxxx13: posts the ante 6
599alex: posts the ante 6
SD ANDRE: posts the ante 6
dimetruk: posts small blind 25
TaiyaL: posts big blind 50
*** HOLE CARDS ***
Dealt to dimetruk [7h 4d]
suru2010: folds
Norbertxxx13: folds
599alex: folds
SD ANDRE: folds
dimetruk: raises 50 to 100
TaiyaL: calls 50
*** FLOP *** [9d 3h Ah]
dimetruk: bets 78
TaiyaL: folds
Uncalled bet (78) returned to dimetruk
dimetruk collected 236 from pot
dimetruk: doesn't show hand
*** SUMMARY ***
Total pot 236 | Rake 0
Board [9d 3h Ah]
Seat 1: dimetruk (small blind) collected (236)
Seat 2: TaiyaL (big blind) folded on the Flop
Seat 4: suru2010 folded before Flop (didn't bet)
Seat 5: Norbertxxx13 folded before Flop (didn't bet)
Seat 8: 599alex folded before Flop (didn't bet)
Seat 9: SD ANDRE (button) folded before Flop (didn't bet)


PokerStars Hand #226512518240: Tournament #3188088059, $13.70+$1.30 USD Hold'em No Limit - Level III (25/50) - 2021/05/06 19:21:26 MSK [2021/05/06 12:21:26 ET]
Table '3188088059 1' 9-max Seat #4 is the button
Seat 1: dimetruk (1533 in chips)
Seat 2: TaiyaL (2073 in chips)
Seat 4: suru2010 (1372 in chips)
Seat 5: Norbertxxx13 (2134 in chips)
Seat 8: 599alex (3874 in chips)
Seat 9: SD ANDRE (2514 in chips)
dimetruk: posts the ante 6
TaiyaL: posts the ante 6
suru2010: posts the ante 6
Norbertxxx13: posts the ante 6
599alex: posts the ante 6
SD ANDRE: posts the ante 6
Norbertxxx13: posts small blind 25
599alex: posts big blind 50
*** HOLE CARDS ***
Dealt to dimetruk [8d 7d]
SD ANDRE: folds
dimetruk: raises 50 to 100
TaiyaL: folds
suru2010: folds
Norbertxxx13: folds
599alex: calls 50
*** FLOP *** [6h Th 5c]
599alex: bets 150
dimetruk: calls 150
*** TURN *** [6h Th 5c] [Jd]
599alex: checks
dimetruk: checks
*** RIVER *** [6h Th 5c Jd] [Ks]
599alex: bets 300
dimetruk: folds
Uncalled bet (300) returned to 599alex
599alex collected 561 from pot
599alex: doesn't show hand
*** SUMMARY ***
Total pot 561 | Rake 0
Board [6h Th 5c Jd Ks]
Seat 1: dimetruk folded on the River
Seat 2: TaiyaL folded before Flop (didn't bet)
Seat 4: suru2010 (button) folded before Flop (didn't bet)
Seat 5: Norbertxxx13 (small blind) folded before Flop
Seat 8: 599alex (big blind) collected (561)
Seat 9: SD ANDRE folded before Flop (didn't bet)


PokerStars Hand #226512551852: Tournament #3188088059, $13.70+$1.30 USD Hold'em No Limit - Level III (25/50) - 2021/05/06 19:22:41 MSK [2021/05/06 12:22:41 ET]
Table '3188088059 1' 9-max Seat #9 is the button
Seat 1: dimetruk (1215 in chips)
Seat 2: TaiyaL (2277 in chips)
Seat 4: suru2010 (1354 in chips)
Seat 5: Norbertxxx13 (2091 in chips)
Seat 8: 599alex (4142 in chips)
Seat 9: SD ANDRE (2421 in chips)
dimetruk: posts the ante 6
TaiyaL: posts the ante 6
suru2010: posts the ante 6
Norbertxxx13: posts the ante 6
599alex: posts the ante 6
SD ANDRE: posts the ante 6
dimetruk: posts small blind 25
TaiyaL: posts big blind 50
*** HOLE CARDS ***
Dealt to dimetruk [7h Ts]
suru2010: folds
Norbertxxx13: folds
599alex: calls 50
SD ANDRE: folds
dimetruk: calls 25
TaiyaL: checks
*** FLOP *** [8c 2d Jh]
dimetruk: checks
TaiyaL: bets 93
599alex: calls 93
dimetruk: calls 93
*** TURN *** [8c 2d Jh] [As]
dimetruk: checks
TaiyaL: checks
599alex: checks
*** RIVER *** [8c 2d Jh As] [5d]
dimetruk: bets 256
TaiyaL: folds
599alex: folds
Uncalled bet (256) returned to dimetruk
dimetruk collected 465 from pot
dimetruk: doesn't show hand
*** SUMMARY ***
Total pot 465 | Rake 0
Board [8c 2d Jh As 5d]
Seat 1: dimetruk (small blind) collected (465)
Seat 2: TaiyaL (big blind) folded on the River
Seat 4: suru2010 folded before Flop (didn't bet)
Seat 5: Norbertxxx13 folded before Flop (didn't bet)
Seat 8: 599alex folded on the River
Seat 9: SD ANDRE (button) folded before Flop (didn't bet)


PokerStars Hand #226512584934: Tournament #3188088059, $13.70+$1.30 USD Hold'em No Limit - Level III (25/50) - 2021/05/06 19:23:56 MSK [2021/05/06 12:23:56 ET]
Table '3188088059 1' 9-max Seat #2 is the button
Seat 1: dimetruk (1525 in chips)
Seat 2: TaiyaL (2097 in chips)
Seat 4: suru2010 (1292 in chips)
Seat 5: Norbertxxx13 (2079 in chips)
Seat 8: 599alex (4098 in chips)
Seat 9: SD ANDRE (2409 in chips)
dimetruk: posts the ante 6
TaiyaL: posts the ante 6
suru2010: posts the ante 6
Norbertxxx13: posts the ante 6
599alex: posts the ante 6
SD ANDRE: posts the ante 6
suru2010: posts small blind 25
Norbertxxx13: posts big blind 50
*** HOLE CARDS ***
Dealt to dimetruk [Jh Jc]
599alex: folds
SD ANDRE: folds
dimetruk: raises 50 to 100
TaiyaL: calls 100
suru2010: folds
Norbertxxx13: calls 50
*** FLOP *** [Qs 6c 8s]
Norbertxxx13: checks
dimetruk: bets 119
TaiyaL: folds
Norbertxxx13: folds
Uncalled bet (119) returned to dimetruk
dimetruk collected 361 from pot
dimetruk: doesn't show hand
*** SUMMARY ***
Total pot 361 | Rake 0
Board [Qs 6c 8s]
Seat 1: dimetruk collected (361)
Seat 2: TaiyaL (button) folded on the Flop
Seat 4: suru2010 (small blind) folded before Flop
Seat 5: Norbertxxx13 (big blind) folded on the Flop
Seat 8: 599alex folded before Flop (didn't bet)
Seat 9: SD ANDRE folded before Flop (didn't bet)


PokerStars Hand #226512613139: Tournament #3188088059, $13.70+$1.30 USD Hold'em No Limit - Level III (25/50) - 2021/05/06 19:24:59 MSK [2021/05/06 12:24:59 ET]
Table '3188088059 1' 9-max Seat #5 is the button
Seat 1: dimetruk (1885 in chips)
Seat 2: TaiyaL (1985 in chips)
Seat 4: suru2010 (1255 in chips)
Seat 5: Norbertxxx13 (1942 in chips)
Seat 8: 599alex (4036 in chips)
Seat 9: SD ANDRE (2397 in chips)
dimetruk: posts the ante 6
TaiyaL: posts the ante 6
suru2010: posts the ante 6
Norbertxxx13: posts the ante 6
599alex: posts the ante 6
SD ANDRE: posts the ante 6
599alex: posts small blind 25
SD ANDRE: posts big blind 50
*** HOLE CARDS ***
Dealt to dimetruk [Jc Kh]
dimetruk: raises 50 to 100
TaiyaL: folds
suru2010: folds
Norbertxxx13: folds
599alex: folds
SD ANDRE: calls 50
*** FLOP *** [5s 2d 3d]
SD ANDRE: checks
dimetruk: bets 144
SD ANDRE: folds
Uncalled bet (144) returned to dimetruk
dimetruk collected 261 from pot
dimetruk: doesn't show hand
*** SUMMARY ***
Total pot 261 | Rake 0
Board [5s 2d 3d]
Seat 1: dimetruk collected (261)
Seat 2: TaiyaL folded before Flop (didn't bet)
Seat 4: suru2010 folded before Flop (didn't bet)
Seat 5: Norbertxxx13 (button) folded before Flop (didn't bet)
Seat 8: 599alex (small blind) folded before Flop
Seat 9: SD ANDRE (big blind) folded on the Flop


PokerStars Hand #226512626061: Tournament #3188088059, $13.70+$1.30 USD Hold'em No Limit - Level III (25/50) - 2021/05/06 19:25:27 MSK [2021/05/06 12:25:27 ET]
Table '3188088059 1' 9-max Seat #8 is the button
Seat 1: dimetruk (2040 in chips)
Seat 2: TaiyaL (1979 in chips)
Seat 4: suru2010 (1249 in chips)
Seat 5: Norbertxxx13 (1936 in chips)
Seat 8: 599alex (4005 in chips)
Seat 9: SD ANDRE (2291 in chips)
dimetruk: posts the ante 6
TaiyaL: posts the ante 6
suru2010: posts the ante 6
Norbertxxx13: posts the ante 6
599alex: posts the ante 6
SD ANDRE: posts the ante 6
SD ANDRE: posts small blind 25
dimetruk: posts big blind 50
*** HOLE CARDS ***
Dealt to dimetruk [As 8s]
TaiyaL: folds
suru2010: folds
Norbertxxx13: raises 75 to 125
599alex: calls 125
SD ANDRE: folds
dimetruk: calls 75
*** FLOP *** [8d 9s 7h]
dimetruk: checks
Norbertxxx13: checks
599alex: checks
*** TURN *** [8d 9s 7h] [8c]
dimetruk: bets 196
Norbertxxx13: folds
599alex: calls 196
*** RIVER *** [8d 9s 7h 8c] [Ah]
dimetruk: bets 621
599alex: calls 621
*** SHOW DOWN ***
dimetruk: shows [As 8s] (a full house, Eights full of Aces)
599alex: mucks hand
dimetruk collected 2070 from pot
*** SUMMARY ***
Total pot 2070 | Rake 0
Board [8d 9s 7h 8c Ah]
Seat 1: dimetruk (big blind) showed [As 8s] and won (2070) with a full house, Eights full of Aces
Seat 2: TaiyaL folded before Flop (didn't bet)
Seat 4: suru2010 folded before Flop (didn't bet)
Seat 5: Norbertxxx13 folded on the Turn
Seat 8: 599alex (button) mucked [6d 5h]
Seat 9: SD ANDRE (small blind) folded before Flop


PokerStars Hand #226512722162: Tournament #3188088059, $13.70+$1.30 USD Hold'em No Limit - Level IV (40/80) - 2021/05/06 19:28:36 MSK [2021/05/06 12:28:36 ET]
Table '3188088059 1' 9-max Seat #8 is the button
Seat 1: dimetruk (3390 in chips)
Seat 2: TaiyaL (2444 in chips)
Seat 4: suru2010 (1130 in chips)
Seat 5: Norbertxxx13 (1571 in chips)
Seat 8: 599alex (2743 in chips)
Seat 9: SD ANDRE (2222 in chips)
dimetruk: posts the ante 10
TaiyaL: posts the ante 10
suru2010: posts the ante 10
Norbertxxx13: posts the ante 10
599alex: posts the ante 10
SD ANDRE: posts the ante 10
SD ANDRE: posts small blind 40
dimetruk: posts big blind 80
*** HOLE CARDS ***
Dealt to dimetruk [3c 4h]
TaiyaL: folds
suru2010: folds
Norbertxxx13: raises 120 to 200
599alex: calls 200
SD ANDRE: folds
dimetruk: calls 120
*** FLOP *** [6c 9h 4s]
dimetruk: checks
Norbertxxx13: bets 400
599alex: calls 400
dimetruk: folds
*** TURN *** [6c 9h 4s] [5c]
Norbertxxx13: bets 961 and is all-in
599alex: calls 961
*** RIVER *** [6c 9h 4s 5c] [2d]
*** SHOW DOWN ***
Norbertxxx13: shows [Ac Js] (high card Ace)
599alex: shows [9s Tc] (a pair of Nines)
599alex collected 3422 from pot
Norbertxxx13 finished the tournament in 6th place
*** SUMMARY ***
Total pot 3422 | Rake 0
Board [6c 9h 4s 5c 2d]
Seat 1: dimetruk (big blind) folded on the Flop
Seat 2: TaiyaL folded before Flop (didn't bet)
Seat 4: suru2010 folded before Flop (didn't bet)
Seat 5: Norbertxxx13 showed [Ac Js] and lost with high card Ace
Seat 8: 599alex (button) showed [9s Tc] and won (3422) with a pair of Nines
Seat 9: SD ANDRE (small blind) folded before Flop


PokerStars Hand #226512737503: Tournament #3188088059, $13.70+$1.30 USD Hold'em No Limit - Level IV (40/80) - 2021/05/06 19:29:10 MSK [2021/05/06 12:29:10 ET]
Table '3188088059 1' 9-max Seat #9 is the button
Seat 1: dimetruk (3180 in chips)
Seat 2: TaiyaL (2434 in chips)
Seat 4: suru2010 (1120 in chips)
Seat 8: 599alex (4594 in chips)
Seat 9: SD ANDRE (2172 in chips)
dimetruk: posts the ante 10
TaiyaL: posts the ante 10
suru2010: posts the ante 10
599alex: posts the ante 10
SD ANDRE: posts the ante 10
dimetruk: posts small blind 40
TaiyaL: posts big blind 80
*** HOLE CARDS ***
Dealt to dimetruk [Kc 6s]
suru2010: folds
599alex: calls 80
SD ANDRE: folds
dimetruk: calls 40
TaiyaL: checks
*** FLOP *** [Kd Ac 3s]
dimetruk: checks
TaiyaL: bets 160
599alex: folds
dimetruk: calls 160
*** TURN *** [Kd Ac 3s] [4s]
dimetruk: checks
TaiyaL: checks
*** RIVER *** [Kd Ac 3s 4s] [3h]
dimetruk: bets 201
TaiyaL: calls 201
*** SHOW DOWN ***
dimetruk: shows [Kc 6s] (two pair, Kings and Threes)
TaiyaL: shows [2d Ah] (two pair, Aces and Threes)
TaiyaL collected 1012 from pot
*** SUMMARY ***
Total pot 1012 | Rake 0
Board [Kd Ac 3s 4s 3h]
Seat 1: dimetruk (small blind) showed [Kc 6s] and lost with two pair, Kings and Threes
Seat 2: TaiyaL (big blind) showed [2d Ah] and won (1012) with two pair, Aces and Threes
Seat 4: suru2010 folded before Flop (didn't bet)
Seat 8: 599alex folded on the Flop
Seat 9: SD ANDRE (button) folded before Flop (didn't bet)


PokerStars Hand #226512755856: Tournament #3188088059, $13.70+$1.30 USD Hold'em No Limit - Level IV (40/80) - 2021/05/06 19:29:50 MSK [2021/05/06 12:29:50 ET]
Table '3188088059 1' 9-max Seat #1 is the button
Seat 1: dimetruk (2729 in chips)
Seat 2: TaiyaL (2995 in chips)
Seat 4: suru2010 (1110 in chips)
Seat 8: 599alex (4504 in chips)
Seat 9: SD ANDRE (2162 in chips)
dimetruk: posts the ante 10
TaiyaL: posts the ante 10
suru2010: posts the ante 10
599alex: posts the ante 10
SD ANDRE: posts the ante 10
TaiyaL: posts small blind 40
suru2010: posts big blind 80
*** HOLE CARDS ***
Dealt to dimetruk [Td Th]
599alex: calls 80
SD ANDRE: folds
dimetruk: raises 160 to 240
TaiyaL: folds
suru2010: folds
599alex: calls 160
*** FLOP *** [7s 3h Qd]
599alex: bets 200
dimetruk: calls 200
*** TURN *** [7s 3h Qd] [2d]
599alex: checks
dimetruk: bets 347
599alex: folds
Uncalled bet (347) returned to dimetruk
dimetruk collected 1050 from pot
dimetruk: doesn't show hand
*** SUMMARY ***
Total pot 1050 | Rake 0
Board [7s 3h Qd 2d]
Seat 1: dimetruk (button) collected (1050)
Seat 2: TaiyaL (small blind) folded before Flop
Seat 4: suru2010 (big blind) folded before Flop
Seat 8: 599alex folded on the Turn
Seat 9: SD ANDRE folded before Flop (didn't bet)


PokerStars Hand #226512795633: Tournament #3188088059, $13.70+$1.30 USD Hold'em No Limit - Level IV (40/80) - 2021/05/06 19:31:15 MSK [2021/05/06 12:31:15 ET]
Table '3188088059 1' 9-max Seat #8 is the button
Seat 1: dimetruk (3149 in chips)
Seat 2: TaiyaL (2925 in chips)
Seat 4: suru2010 (1130 in chips)
Seat 8: 599alex (3914 in chips)
Seat 9: SD ANDRE (2382 in chips)
dimetruk: posts the ante 10
TaiyaL: posts the ante 10
suru2010: posts the ante 10
599alex: posts the ante 10
SD ANDRE: posts the ante 10
SD ANDRE: posts small blind 40
dimetruk: posts big blind 80
*** HOLE CARDS ***
Dealt to dimetruk [4c 8h]
TaiyaL: folds
suru2010: folds
599alex: calls 80
SD ANDRE: folds
dimetruk: checks
*** FLOP *** [Kh 4s Tc]
dimetruk: checks
599alex: checks
*** TURN *** [Kh 4s Tc] [7d]
dimetruk: bets 120
599alex: calls 120
*** RIVER *** [Kh 4s Tc 7d] [Ah]
dimetruk: bets 270
599alex: raises 350 to 620
dimetruk: folds
Uncalled bet (350) returned to 599alex
599alex collected 1030 from pot
599alex: doesn't show hand
*** SUMMARY ***
Total pot 1030 | Rake 0
Board [Kh 4s Tc 7d Ah]
Seat 1: dimetruk (big blind) folded on the River
Seat 2: TaiyaL folded before Flop (didn't bet)
Seat 4: suru2010 folded before Flop (didn't bet)
Seat 8: 599alex (button) collected (1030)
Seat 9: SD ANDRE (small blind) folded before Flop


PokerStars Hand #226512898622: Tournament #3188088059, $13.70+$1.30 USD Hold'em No Limit - Level IV (40/80) - 2021/05/06 19:34:44 MSK [2021/05/06 12:34:44 ET]
Table '3188088059 1' 9-max Seat #2 is the button
Seat 1: dimetruk (2439 in chips)
Seat 2: TaiyaL (2775 in chips)
Seat 4: suru2010 (1440 in chips)
Seat 8: 599alex (4469 in chips)
Seat 9: SD ANDRE (2377 in chips)
dimetruk: posts the ante 10
TaiyaL: posts the ante 10
suru2010: posts the ante 10
599alex: posts the ante 10
SD ANDRE: posts the ante 10
suru2010: posts small blind 40
599alex: posts big blind 80
*** HOLE CARDS ***
Dealt to dimetruk [3d 3c]
SD ANDRE: folds
dimetruk: raises 80 to 160
TaiyaL: folds
suru2010: folds
599alex: calls 80
*** FLOP *** [8d 9h Qc]
599alex: checks
dimetruk: checks
*** TURN *** [8d 9h Qc] [Tc]
599alex: checks
dimetruk: bets 226
599alex: calls 226
*** RIVER *** [8d 9h Qc Tc] [5h]
599alex: checks
dimetruk: checks
*** SHOW DOWN ***
599alex: shows [7c Kh] (high card King)
dimetruk: shows [3d 3c] (a pair of Threes)
dimetruk collected 862 from pot
*** SUMMARY ***
Total pot 862 | Rake 0
Board [8d 9h Qc Tc 5h]
Seat 1: dimetruk showed [3d 3c] and won (862) with a pair of Threes
Seat 2: TaiyaL (button) folded before Flop (didn't bet)
Seat 4: suru2010 (small blind) folded before Flop
Seat 8: 599alex (big blind) showed [7c Kh] and lost with high card King
Seat 9: SD ANDRE folded before Flop (didn't bet)


PokerStars Hand #226513037114: Tournament #3188088059, $13.70+$1.30 USD Hold'em No Limit - Level V (60/120) - 2021/05/06 19:39:38 MSK [2021/05/06 12:39:38 ET]
Table '3188088059 1' 9-max Seat #8 is the button
Seat 1: dimetruk (2685 in chips)
Seat 2: TaiyaL (1957 in chips)
Seat 4: suru2010 (1730 in chips)
Seat 8: 599alex (4931 in chips)
Seat 9: SD ANDRE (2197 in chips)
dimetruk: posts the ante 15
TaiyaL: posts the ante 15
suru2010: posts the ante 15
599alex: posts the ante 15
SD ANDRE: posts the ante 15
SD ANDRE: posts small blind 60
dimetruk: posts big blind 120
*** HOLE CARDS ***
Dealt to dimetruk [5d 7d]
TaiyaL: folds
suru2010: folds
599alex: folds
SD ANDRE: raises 240 to 360
dimetruk: calls 240
*** FLOP *** [Qh 3c 4s]
SD ANDRE: checks
dimetruk: checks
*** TURN *** [Qh 3c 4s] [Jh]
SD ANDRE: checks
dimetruk: bets 358
SD ANDRE: folds
Uncalled bet (358) returned to dimetruk
dimetruk collected 795 from pot
dimetruk: doesn't show hand
*** SUMMARY ***
Total pot 795 | Rake 0
Board [Qh 3c 4s Jh]
Seat 1: dimetruk (big blind) collected (795)
Seat 2: TaiyaL folded before Flop (didn't bet)
Seat 4: suru2010 folded before Flop (didn't bet)
Seat 8: 599alex (button) folded before Flop (didn't bet)
Seat 9: SD ANDRE (small blind) folded on the Turn


PokerStars Hand #226513095234: Tournament #3188088059, $13.70+$1.30 USD Hold'em No Limit - Level V (60/120) - 2021/05/06 19:41:41 MSK [2021/05/06 12:41:41 ET]
Table '3188088059 1' 9-max Seat #9 is the button
Seat 1: dimetruk (3420 in chips)
Seat 2: TaiyaL (2302 in chips)
Seat 4: suru2010 (1715 in chips)
Seat 8: 599alex (4301 in chips)
Seat 9: SD ANDRE (1762 in chips)
dimetruk: posts the ante 15
TaiyaL: posts the ante 15
suru2010: posts the ante 15
599alex: posts the ante 15
SD ANDRE: posts the ante 15
dimetruk: posts small blind 60
TaiyaL: posts big blind 120
*** HOLE CARDS ***
Dealt to dimetruk [Qs 5s]
suru2010: folds
599alex: calls 120
SD ANDRE: folds
dimetruk: calls 60
TaiyaL: checks
*** FLOP *** [Qd 7s Js]
dimetruk: checks
TaiyaL: checks
599alex: checks
*** TURN *** [Qd 7s Js] [2d]
dimetruk: bets 239
TaiyaL: folds
599alex: calls 239
*** RIVER *** [Qd 7s Js 2d] [2s]
dimetruk: bets 502
599alex: calls 502
*** SHOW DOWN ***
dimetruk: shows [Qs 5s] (a flush, Queen high)
599alex: mucks hand
dimetruk collected 1917 from pot
*** SUMMARY ***
Total pot 1917 | Rake 0
Board [Qd 7s Js 2d 2s]
Seat 1: dimetruk (small blind) showed [Qs 5s] and won (1917) with a flush, Queen high
Seat 2: TaiyaL (big blind) folded on the Turn
Seat 4: suru2010 folded before Flop (didn't bet)
Seat 8: 599alex mucked [Jc 9h]
Seat 9: SD ANDRE (button) folded before Flop (didn't bet)


PokerStars Hand #226513154226: Tournament #3188088059, $13.70+$1.30 USD Hold'em No Limit - Level V (60/120) - 2021/05/06 19:43:46 MSK [2021/05/06 12:43:46 ET]
Table '3188088059 1' 9-max Seat #9 is the button
Seat 1: dimetruk (4791 in chips)
Seat 2: TaiyaL (2047 in chips)
Seat 8: 599alex (4900 in chips)
Seat 9: SD ANDRE (1762 in chips)
dimetruk: posts the ante 15
TaiyaL: posts the ante 15
599alex: posts the ante 15
SD ANDRE: posts the ante 15
dimetruk: posts small blind 60
TaiyaL: posts big blind 120
*** HOLE CARDS ***
Dealt to dimetruk [4c Kc]
599alex: calls 120
SD ANDRE: folds
dimetruk: calls 60
TaiyaL: checks
*** FLOP *** [3s 2s Qd]
dimetruk: checks
TaiyaL: bets 210
599alex: calls 210
dimetruk: folds
*** TURN *** [3s 2s Qd] [9h]
TaiyaL: bets 420
599alex: calls 420
*** RIVER *** [3s 2s Qd 9h] [4h]
TaiyaL: checks
599alex: bets 480
TaiyaL: calls 480
*** SHOW DOWN ***
599alex: shows [Qc 7c] (a pair of Queens)
TaiyaL: mucks hand
599alex collected 2640 from pot
*** SUMMARY ***
Total pot 2640 | Rake 0
Board [3s 2s Qd 9h 4h]
Seat 1: dimetruk (small blind) folded on the Flop
Seat 2: TaiyaL (big blind) mucked [5d Qh]
Seat 8: 599alex showed [Qc 7c] and won (2640) with a pair of Queens
Seat 9: SD ANDRE (button) folded before Flop (didn't bet)


PokerStars Hand #226513182308: Tournament #3188088059, $13.70+$1.30 USD Hold'em No Limit - Level V (60/120) - 2021/05/06 19:44:45 MSK [2021/05/06 12:44:45 ET]
Table '3188088059 1' 9-max Seat #1 is the button
Seat 1: dimetruk (4656 in chips)
Seat 2: TaiyaL (802 in chips)
Seat 8: 599alex (6295 in chips)
Seat 9: SD ANDRE (1747 in chips)
dimetruk: posts the ante 15
TaiyaL: posts the ante 15
599alex: posts the ante 15
SD ANDRE: posts the ante 15
TaiyaL: posts small blind 60
599alex: posts big blind 120
*** HOLE CARDS ***
Dealt to dimetruk [9d Tc]
SD ANDRE: folds
dimetruk: raises 120 to 240
TaiyaL: raises 547 to 787 and is all-in
599alex: folds
dimetruk: calls 547
*** FLOP *** [Qd 5s Qh]
*** TURN *** [Qd 5s Qh] [9h]
*** RIVER *** [Qd 5s Qh 9h] [3h]
*** SHOW DOWN ***
TaiyaL: shows [8h As] (a pair of Queens)
dimetruk: shows [9d Tc] (two pair, Queens and Nines)
dimetruk collected 1754 from pot
TaiyaL finished the tournament in 4th place
*** SUMMARY ***
Total pot 1754 | Rake 0
Board [Qd 5s Qh 9h 3h]
Seat 1: dimetruk (button) showed [9d Tc] and won (1754) with two pair, Queens and Nines
Seat 2: TaiyaL (small blind) showed [8h As] and lost with a pair of Queens
Seat 8: 599alex (big blind) folded before Flop
Seat 9: SD ANDRE folded before Flop (didn't bet)


PokerStars Hand #226513200199: Tournament #3188088059, $13.70+$1.30 USD Hold'em No Limit - Level V (60/120) - 2021/05/06 19:45:23 MSK [2021/05/06 12:45:23 ET]
Table '3188088059 1' 9-max Seat #9 is the button
Seat 1: dimetruk (5698 in chips)
Seat 8: 599alex (6145 in chips)
Seat 9: SD ANDRE (1657 in chips)
dimetruk: posts the ante 15
599alex: posts the ante 15
SD ANDRE: posts the ante 15
dimetruk: posts small blind 60
599alex: posts big blind 120
*** HOLE CARDS ***
Dealt to dimetruk [2d 7d]
SD ANDRE: folds
dimetruk: raises 120 to 240
599alex: calls 120
*** FLOP *** [8d 7h 2c]
dimetruk: bets 289
599alex: folds
Uncalled bet (289) returned to dimetruk
dimetruk collected 525 from pot
dimetruk: doesn't show hand
*** SUMMARY ***
Total pot 525 | Rake 0
Board [8d 7h 2c]
Seat 1: dimetruk (small blind) collected (525)
Seat 8: 599alex (big blind) folded on the Flop
Seat 9: SD ANDRE (button) folded before Flop (didn't bet)


PokerStars Hand #226513237113: Tournament #3188088059, $13.70+$1.30 USD Hold'em No Limit - Level V (60/120) - 2021/05/06 19:46:41 MSK [2021/05/06 12:46:41 ET]
Table '3188088059 1' 9-max Seat #9 is the button
Seat 1: dimetruk (6268 in chips)
Seat 8: 599alex (5395 in chips)
Seat 9: SD ANDRE (1837 in chips)
dimetruk: posts the ante 15
599alex: posts the ante 15
SD ANDRE: posts the ante 15
dimetruk: posts small blind 60
599alex: posts big blind 120
*** HOLE CARDS ***
Dealt to dimetruk [Qs 4s]
SD ANDRE: folds
dimetruk: raises 270 to 390
599alex: calls 270
*** FLOP *** [Qc 9s Td]
dimetruk: bets 371
599alex: calls 371
*** TURN *** [Qc 9s Td] [Tc]
dimetruk: bets 705
599alex: calls 705
*** RIVER *** [Qc 9s Td Tc] [9h]
dimetruk: checks
599alex: checks
*** SHOW DOWN ***
dimetruk: shows [Qs 4s] (two pair, Queens and Tens)
599alex: mucks hand
dimetruk collected 2977 from pot
*** SUMMARY ***
Total pot 2977 | Rake 0
Board [Qc 9s Td Tc 9h]
Seat 1: dimetruk (small blind) showed [Qs 4s] and won (2977) with two pair, Queens and Tens
Seat 8: 599alex (big blind) mucked [8d 7h]
Seat 9: SD ANDRE (button) folded before Flop (didn't bet)


PokerStars Hand #226513252906: Tournament #3188088059, $13.70+$1.30 USD Hold'em No Limit - Level V (60/120) - 2021/05/06 19:47:15 MSK [2021/05/06 12:47:15 ET]
Table '3188088059 1' 9-max Seat #8 is the button
Seat 1: dimetruk (7749 in chips)
Seat 8: 599alex (3839 in chips)
Seat 9: SD ANDRE (1912 in chips)
dimetruk: posts the ante 15
599alex: posts the ante 15
SD ANDRE: posts the ante 15
SD ANDRE: posts small blind 60
dimetruk: posts big blind 120
*** HOLE CARDS ***
Dealt to dimetruk [Th 5d]
599alex: calls 120
SD ANDRE: folds
dimetruk: checks
*** FLOP *** [Ad Kd 9d]
dimetruk: checks
599alex: checks
*** TURN *** [Ad Kd 9d] [Qh]
dimetruk: bets 155
599alex: calls 155
*** RIVER *** [Ad Kd 9d Qh] [Tc]
dimetruk: bets 491
599alex: calls 491
*** SHOW DOWN ***
dimetruk: shows [Th 5d] (a pair of Tens)
599alex: shows [Ks Ah] (two pair, Aces and Kings)
599alex collected 1637 from pot
*** SUMMARY ***
Total pot 1637 | Rake 0
Board [Ad Kd 9d Qh Tc]
Seat 1: dimetruk (big blind) showed [Th 5d] and lost with a pair of Tens
Seat 8: 599alex (button) showed [Ks Ah] and won (1637) with two pair, Aces and Kings
Seat 9: SD ANDRE (small blind) folded before Flop


PokerStars Hand #226513274760: Tournament #3188088059, $13.70+$1.30 USD Hold'em No Limit - Level VI (80/160) - 2021/05/06 19:48:01 MSK [2021/05/06 12:48:01 ET]
Table '3188088059 1' 9-max Seat #8 is the button
Seat 1: dimetruk (7098 in chips)
Seat 8: 599alex (4460 in chips)
Seat 9: SD ANDRE (1942 in chips)
dimetruk: posts the ante 20
599alex: posts the ante 20
SD ANDRE: posts the ante 20
SD ANDRE: posts small blind 80
dimetruk: posts big blind 160
*** HOLE CARDS ***
Dealt to dimetruk [4d 7h]
599alex: calls 160
SD ANDRE: folds
dimetruk: checks
*** FLOP *** [Th 2s 9c]
dimetruk: checks
599alex: checks
*** TURN *** [Th 2s 9c] [8h]
dimetruk: checks
599alex: checks
*** RIVER *** [Th 2s 9c 8h] [7s]
dimetruk: bets 400
599alex: folds
Uncalled bet (400) returned to dimetruk
dimetruk collected 460 from pot
dimetruk: doesn't show hand
*** SUMMARY ***
Total pot 460 | Rake 0
Board [Th 2s 9c 8h 7s]
Seat 1: dimetruk (big blind) collected (460)
Seat 8: 599alex (button) folded on the River
Seat 9: SD ANDRE (small blind) folded before Flop


PokerStars Hand #226513287883: Tournament #3188088059, $13.70+$1.30 USD Hold'em No Limit - Level VI (80/160) - 2021/05/06 19:48:29 MSK [2021/05/06 12:48:29 ET]
Table '3188088059 1' 9-max Seat #9 is the button
Seat 1: dimetruk (7378 in chips)
Seat 8: 599alex (4280 in chips)
Seat 9: SD ANDRE (1842 in chips)
dimetruk: posts the ante 20
599alex: posts the ante 20
SD ANDRE: posts the ante 20
dimetruk: posts small blind 80
599alex: posts big blind 160
*** HOLE CARDS ***
Dealt to dimetruk [6s 8s]
SD ANDRE: folds
dimetruk: raises 160 to 320
599alex: calls 160
*** FLOP *** [Jh 3h 9h]
dimetruk: checks
599alex: checks
*** TURN *** [Jh 3h 9h] [Kc]
dimetruk: checks
599alex: checks
*** RIVER *** [Jh 3h 9h Kc] [8d]
dimetruk: checks
599alex: bets 400
dimetruk: calls 400
*** SHOW DOWN ***
599alex: shows [Kd 5c] (a pair of Kings)
dimetruk: mucks hand
599alex collected 1500 from pot
*** SUMMARY ***
Total pot 1500 | Rake 0
Board [Jh 3h 9h Kc 8d]
Seat 1: dimetruk (small blind) mucked [6s 8s]
Seat 8: 599alex (big blind) showed [Kd 5c] and won (1500) with a pair of Kings
Seat 9: SD ANDRE (button) folded before Flop (didn't bet)


PokerStars Hand #226513310718: Tournament #3188088059, $13.70+$1.30 USD Hold'em No Limit - Level VI (80/160) - 2021/05/06 19:49:17 MSK [2021/05/06 12:49:17 ET]
Table '3188088059 1' 9-max Seat #8 is the button
Seat 1: dimetruk (6298 in chips)
Seat 8: 599alex (4940 in chips)
Seat 9: SD ANDRE (2262 in chips)
dimetruk: posts the ante 20
599alex: posts the ante 20
SD ANDRE: posts the ante 20
SD ANDRE: posts small blind 80
dimetruk: posts big blind 160
*** HOLE CARDS ***
Dealt to dimetruk [Kc Qh]
599alex: folds
SD ANDRE: calls 80
dimetruk: raises 6118 to 6278 and is all-in
SD ANDRE: calls 2082 and is all-in
Uncalled bet (4036) returned to dimetruk
*** FLOP *** [9h 7c 8s]
*** TURN *** [9h 7c 8s] [Th]
*** RIVER *** [9h 7c 8s Th] [2s]
*** SHOW DOWN ***
SD ANDRE: shows [Jh Jc] (a straight, Seven to Jack)
dimetruk: shows [Kc Qh] (high card King)
SD ANDRE collected 4544 from pot
*** SUMMARY ***
Total pot 4544 | Rake 0
Board [9h 7c 8s Th 2s]
Seat 1: dimetruk (big blind) showed [Kc Qh] and lost with high card King
Seat 8: 599alex (button) folded before Flop (didn't bet)
Seat 9: SD ANDRE (small blind) showed [Jh Jc] and won (4544) with a straight, Seven to Jack


PokerStars Hand #226513341127: Tournament #3188088059, $13.70+$1.30 USD Hold'em No Limit - Level VI (80/160) - 2021/05/06 19:50:22 MSK [2021/05/06 12:50:22 ET]
Table '3188088059 1' 9-max Seat #1 is the button
Seat 1: dimetruk (3936 in chips)
Seat 8: 599alex (4560 in chips)
Seat 9: SD ANDRE (5004 in chips)
dimetruk: posts the ante 20
599alex: posts the ante 20
SD ANDRE: posts the ante 20
599alex: posts small blind 80
SD ANDRE: posts big blind 160
*** HOLE CARDS ***
Dealt to dimetruk [7h 8s]
dimetruk: raises 160 to 320
599alex: calls 240
SD ANDRE: folds
*** FLOP *** [7c Th 4s]
599alex: checks
dimetruk: bets 387
599alex: calls 387
*** TURN *** [7c Th 4s] [4d]
599alex: checks
dimetruk: bets 735
599alex: calls 735
*** RIVER *** [7c Th 4s 4d] [Kh]
599alex: bets 3098 and is all-in
dimetruk: folds
Uncalled bet (3098) returned to 599alex
599alex collected 3104 from pot
599alex: doesn't show hand
*** SUMMARY ***
Total pot 3104 | Rake 0
Board [7c Th 4s 4d Kh]
Seat 1: dimetruk (button) folded on the River
Seat 8: 599alex (small blind) collected (3104)
Seat 9: SD ANDRE (big blind) folded before Flop


PokerStars Hand #226513374481: Tournament #3188088059, $13.70+$1.30 USD Hold'em No Limit - Level VI (80/160) - 2021/05/06 19:51:32 MSK [2021/05/06 12:51:32 ET]
Table '3188088059 1' 9-max Seat #8 is the button
Seat 1: dimetruk (2474 in chips)
Seat 8: 599alex (6662 in chips)
Seat 9: SD ANDRE (4364 in chips)
dimetruk: posts the ante 20
599alex: posts the ante 20
SD ANDRE: posts the ante 20
SD ANDRE: posts small blind 80
dimetruk: posts big blind 160
*** HOLE CARDS ***
Dealt to dimetruk [Kh 2d]
599alex: calls 160
SD ANDRE: folds
dimetruk: checks
*** FLOP *** [Ks 7d 9h]
dimetruk: checks
599alex: bets 160
dimetruk: raises 2134 to 2294 and is all-in
599alex: calls 2134
*** TURN *** [Ks 7d 9h] [3s]
*** RIVER *** [Ks 7d 9h 3s] [As]
*** SHOW DOWN ***
dimetruk: shows [Kh 2d] (a pair of Kings)
599alex: shows [Th 9d] (a pair of Nines)
dimetruk collected 5048 from pot
*** SUMMARY ***
Total pot 5048 | Rake 0
Board [Ks 7d 9h 3s As]
Seat 1: dimetruk (big blind) showed [Kh 2d] and won (5048) with a pair of Kings
Seat 8: 599alex (button) showed [Th 9d] and lost with a pair of Nines
Seat 9: SD ANDRE (small blind) folded before Flop


PokerStars Hand #226513386556: Tournament #3188088059, $13.70+$1.30 USD Hold'em No Limit - Level VI (80/160) - 2021/05/06 19:51:58 MSK [2021/05/06 12:51:58 ET]
Table '3188088059 1' 9-max Seat #9 is the button
Seat 1: dimetruk (5048 in chips)
Seat 8: 599alex (4188 in chips)
Seat 9: SD ANDRE (4264 in chips)
dimetruk: posts the ante 20
599alex: posts the ante 20
SD ANDRE: posts the ante 20
dimetruk: posts small blind 80
599alex: posts big blind 160
*** HOLE CARDS ***
Dealt to dimetruk [Th 8c]
SD ANDRE: folds
dimetruk: raises 160 to 320
599alex: calls 160
*** FLOP *** [2c Kh Kc]
dimetruk: bets 525
599alex: folds
Uncalled bet (525) returned to dimetruk
dimetruk collected 700 from pot
dimetruk: doesn't show hand
*** SUMMARY ***
Total pot 700 | Rake 0
Board [2c Kh Kc]
Seat 1: dimetruk (small blind) collected (700)
Seat 8: 599alex (big blind) folded on the Flop
Seat 9: SD ANDRE (button) folded before Flop (didn't bet)


PokerStars Hand #226513395861: Tournament #3188088059, $13.70+$1.30 USD Hold'em No Limit - Level VI (80/160) - 2021/05/06 19:52:17 MSK [2021/05/06 12:52:17 ET]
Table '3188088059 1' 9-max Seat #8 is the button
Seat 1: dimetruk (5688 in chips)
Seat 8: 599alex (3748 in chips)
Seat 9: SD ANDRE (4064 in chips)
dimetruk: posts the ante 20
599alex: posts the ante 20
SD ANDRE: posts the ante 20
SD ANDRE: posts small blind 80
dimetruk: posts big blind 160
*** HOLE CARDS ***
Dealt to dimetruk [Ac 2h]
599alex: folds
SD ANDRE: raises 400 to 560
dimetruk: calls 400
*** FLOP *** [2s Ks 3c]
SD ANDRE: checks
dimetruk: bets 531
SD ANDRE: raises 749 to 1280
dimetruk: folds
Uncalled bet (749) returned to SD ANDRE
SD ANDRE collected 2242 from pot
SD ANDRE: doesn't show hand
*** SUMMARY ***
Total pot 2242 | Rake 0
Board [2s Ks 3c]
Seat 1: dimetruk (big blind) folded on the Flop
Seat 8: 599alex (button) folded before Flop (didn't bet)
Seat 9: SD ANDRE (small blind) collected (2242)


PokerStars Hand #226513449774: Tournament #3188088059, $13.70+$1.30 USD Hold'em No Limit - Level VI (80/160) - 2021/05/06 19:54:11 MSK [2021/05/06 12:54:11 ET]
Table '3188088059 1' 9-max Seat #8 is the button
Seat 1: dimetruk (4757 in chips)
Seat 8: 599alex (3048 in chips)
Seat 9: SD ANDRE (5695 in chips)
dimetruk: posts the ante 20
599alex: posts the ante 20
SD ANDRE: posts the ante 20
SD ANDRE: posts small blind 80
dimetruk: posts big blind 160
*** HOLE CARDS ***
Dealt to dimetruk [3h Ad]
599alex: calls 160
SD ANDRE: folds
dimetruk: checks
*** FLOP *** [Ts 2h Jc]
dimetruk: checks
599alex: checks
*** TURN *** [Ts 2h Jc] [3c]
dimetruk: bets 160
599alex: calls 160
*** RIVER *** [Ts 2h Jc 3c] [Qc]
dimetruk: checks
599alex: bets 480
dimetruk: folds
Uncalled bet (480) returned to 599alex
599alex collected 780 from pot
599alex: doesn't show hand
*** SUMMARY ***
Total pot 780 | Rake 0
Board [Ts 2h Jc 3c Qc]
Seat 1: dimetruk (big blind) folded on the River
Seat 8: 599alex (button) collected (780)
Seat 9: SD ANDRE (small blind) folded before Flop


PokerStars Hand #226513476318: Tournament #3188088059, $13.70+$1.30 USD Hold'em No Limit - Level VI (80/160) - 2021/05/06 19:55:09 MSK [2021/05/06 12:55:09 ET]
Table '3188088059 1' 9-max Seat #8 is the button
Seat 1: dimetruk (4277 in chips)
Seat 8: 599alex (3208 in chips)
Seat 9: SD ANDRE (6015 in chips)
dimetruk: posts the ante 20
599alex: posts the ante 20
SD ANDRE: posts the ante 20
SD ANDRE: posts small blind 80
dimetruk: posts big blind 160
*** HOLE CARDS ***
Dealt to dimetruk [Jh Th]
599alex: calls 160
SD ANDRE: calls 80
dimetruk: checks
*** FLOP *** [4d As Tc]
SD ANDRE: checks
dimetruk: checks
599alex: checks
*** TURN *** [4d As Tc] [2h]
SD ANDRE: checks
dimetruk: bets 243
599alex: calls 243
SD ANDRE: folds
*** RIVER *** [4d As Tc 2h] [8c]
dimetruk: checks
599alex: bets 560
dimetruk: calls 560
*** SHOW DOWN ***
599alex: shows [9d Ac] (a pair of Aces)
dimetruk: mucks hand
599alex collected 2146 from pot
*** SUMMARY ***
Total pot 2146 | Rake 0
Board [4d As Tc 2h 8c]
Seat 1: dimetruk (big blind) mucked [Jh Th]
Seat 8: 599alex (button) showed [9d Ac] and won (2146) with a pair of Aces
Seat 9: SD ANDRE (small blind) folded on the Turn


PokerStars Hand #226513502503: Tournament #3188088059, $13.70+$1.30 USD Hold'em No Limit - Level VI (80/160) - 2021/05/06 19:56:23 MSK [2021/05/06 12:56:23 ET]
Table '3188088059 1' 9-max Seat #9 is the button
Seat 1: dimetruk (2994 in chips)
Seat 8: 599alex (3911 in chips)
Seat 9: SD ANDRE (6595 in chips)
dimetruk: posts the ante 20
599alex: posts the ante 20
SD ANDRE: posts the ante 20
dimetruk: posts small blind 80
599alex: posts big blind 160
*** HOLE CARDS ***
Dealt to dimetruk [Jc 2s]
SD ANDRE: folds
dimetruk: calls 80
599alex: checks
*** FLOP *** [Jd Qd 6s]
dimetruk: bets 160
599alex: calls 160
*** TURN *** [Jd Qd 6s] [Td]
dimetruk: bets 315
599alex: folds
Uncalled bet (315) returned to dimetruk
dimetruk collected 700 from pot
dimetruk: doesn't show hand
*** SUMMARY ***
Total pot 700 | Rake 0
Board [Jd Qd 6s Td]
Seat 1: dimetruk (small blind) collected (700)
Seat 8: 599alex (big blind) folded on the Turn
Seat 9: SD ANDRE (button) folded before Flop (didn't bet)


PokerStars Hand #226513515626: Tournament #3188088059, $13.70+$1.30 USD Hold'em No Limit - Level VI (80/160) - 2021/05/06 19:57:00 MSK [2021/05/06 12:57:00 ET]
Table '3188088059 1' 9-max Seat #8 is the button
Seat 1: dimetruk (3334 in chips)
Seat 8: 599alex (3771 in chips)
Seat 9: SD ANDRE (6395 in chips)
dimetruk: posts the ante 20
599alex: posts the ante 20
SD ANDRE: posts the ante 20
SD ANDRE: posts small blind 80
dimetruk: posts big blind 160
*** HOLE CARDS ***
Dealt to dimetruk [4c 2d]
599alex: folds
SD ANDRE: calls 80
dimetruk: checks
*** FLOP *** [2c Ks 4d]
SD ANDRE: checks
dimetruk: bets 240
SD ANDRE: calls 240
*** TURN *** [2c Ks 4d] [Ac]
SD ANDRE: checks
dimetruk: bets 645
SD ANDRE: raises 5330 to 5975 and is all-in
dimetruk: calls 2269 and is all-in
Uncalled bet (3061) returned to SD ANDRE
*** RIVER *** [2c Ks 4d Ac] [Jd]
*** SHOW DOWN ***
SD ANDRE: shows [Jc Tc] (a pair of Jacks)
dimetruk: shows [4c 2d] (two pair, Fours and Deuces)
dimetruk collected 6688 from pot
*** SUMMARY ***
Total pot 6688 | Rake 0
Board [2c Ks 4d Ac Jd]
Seat 1: dimetruk (big blind) showed [4c 2d] and won (6688) with two pair, Fours and Deuces
Seat 8: 599alex (button) folded before Flop (didn't bet)
Seat 9: SD ANDRE (small blind) showed [Jc Tc] and lost with a pair of Jacks


PokerStars Hand #226513551168: Tournament #3188088059, $13.70+$1.30 USD Hold'em No Limit - Level VII (100/200) - 2021/05/06 19:58:39 MSK [2021/05/06 12:58:39 ET]
Table '3188088059 1' 9-max Seat #9 is the button
Seat 1: dimetruk (6643 in chips)
Seat 8: 599alex (910 in chips)
Seat 9: SD ANDRE (5947 in chips)
dimetruk: posts the ante 25
599alex: posts the ante 25
SD ANDRE: posts the ante 25
dimetruk: posts small blind 100
599alex: posts big blind 200
*** HOLE CARDS ***
Dealt to dimetruk [5d 5h]
SD ANDRE: raises 300 to 500
dimetruk: calls 400
599alex: folds
*** FLOP *** [8d 3h Qh]
dimetruk: checks
SD ANDRE: checks
*** TURN *** [8d 3h Qh] [Qc]
dimetruk: bets 421
SD ANDRE: folds
Uncalled bet (421) returned to dimetruk
dimetruk collected 1275 from pot
dimetruk: doesn't show hand
*** SUMMARY ***
Total pot 1275 | Rake 0
Board [8d 3h Qh Qc]
Seat 1: dimetruk (small blind) collected (1275)
Seat 8: 599alex (big blind) folded before Flop
Seat 9: SD ANDRE (button) folded on the Turn


PokerStars Hand #226513569705: Tournament #3188088059, $13.70+$1.30 USD Hold'em No Limit - Level VII (100/200) - 2021/05/06 19:59:31 MSK [2021/05/06 12:59:31 ET]
Table '3188088059 1' 9-max Seat #9 is the button
Seat 1: dimetruk (7518 in chips)
Seat 8: 599alex (1370 in chips)
Seat 9: SD ANDRE (4612 in chips)
dimetruk: posts the ante 25
599alex: posts the ante 25
SD ANDRE: posts the ante 25
dimetruk: posts small blind 100
599alex: posts big blind 200
*** HOLE CARDS ***
Dealt to dimetruk [Qc Ad]
SD ANDRE: folds
dimetruk: raises 7293 to 7493 and is all-in
599alex: calls 1145 and is all-in
Uncalled bet (6148) returned to dimetruk
*** FLOP *** [7h Kd 2s]
*** TURN *** [7h Kd 2s] [3c]
*** RIVER *** [7h Kd 2s 3c] [6d]
*** SHOW DOWN ***
dimetruk: shows [Qc Ad] (high card Ace)
599alex: shows [5c Kc] (a pair of Kings)
599alex collected 2765 from pot
*** SUMMARY ***
Total pot 2765 | Rake 0
Board [7h Kd 2s 3c 6d]
Seat 1: dimetruk (small blind) showed [Qc Ad] and lost with high card Ace
Seat 8: 599alex (big blind) showed [5c Kc] and won (2765) with a pair of Kings
Seat 9: SD ANDRE (button) folded before Flop (didn't bet)


PokerStars Hand #226513588574: Tournament #3188088059, $13.70+$1.30 USD Hold'em No Limit - Level VII (100/200) - 2021/05/06 20:00:23 MSK [2021/05/06 13:00:23 ET]
Table '3188088059 1' 9-max Seat #1 is the button
Seat 1: dimetruk (5898 in chips)
Seat 9: SD ANDRE (7602 in chips)
dimetruk: posts the ante 25
SD ANDRE: posts the ante 25
dimetruk: posts small blind 100
SD ANDRE: posts big blind 200
*** HOLE CARDS ***
Dealt to dimetruk [5d 7h]
dimetruk: calls 100
SD ANDRE: checks
*** FLOP *** [4d Qs Ah]
SD ANDRE: checks
dimetruk: bets 200
SD ANDRE: folds
Uncalled bet (200) returned to dimetruk
dimetruk collected 450 from pot
dimetruk: doesn't show hand
*** SUMMARY ***
Total pot 450 | Rake 0
Board [4d Qs Ah]
Seat 1: dimetruk (button) (small blind) collected (450)
Seat 9: SD ANDRE (big blind) folded on the Flop


PokerStars Hand #226513614745: Tournament #3188088059, $13.70+$1.30 USD Hold'em No Limit - Level VII (100/200) - 2021/05/06 20:01:28 MSK [2021/05/06 13:01:28 ET]
Table '3188088059 1' 9-max Seat #9 is the button
Seat 1: dimetruk (6123 in chips)
Seat 9: SD ANDRE (7377 in chips)
dimetruk: posts the ante 25
SD ANDRE: posts the ante 25
SD ANDRE: posts small blind 100
dimetruk: posts big blind 200
*** HOLE CARDS ***
Dealt to dimetruk [2d Kc]
SD ANDRE: raises 200 to 400
dimetruk: calls 200
*** FLOP *** [Kd 4s 8h]
dimetruk: checks
SD ANDRE: bets 300
dimetruk: calls 300
*** TURN *** [Kd 4s 8h] [5s]
dimetruk: checks
SD ANDRE: bets 600
dimetruk: calls 600
*** RIVER *** [Kd 4s 8h 5s] [Qs]
dimetruk: checks
SD ANDRE: checks
*** SHOW DOWN ***
dimetruk: shows [2d Kc] (a pair of Kings)
SD ANDRE: shows [9h Ks] (a pair of Kings - Queen+Nine kicker)
SD ANDRE collected 2650 from pot
*** SUMMARY ***
Total pot 2650 | Rake 0
Board [Kd 4s 8h 5s Qs]
Seat 1: dimetruk (big blind) showed [2d Kc] and lost with a pair of Kings
Seat 9: SD ANDRE (button) (small blind) showed [9h Ks] and won (2650) with a pair of Kings


PokerStars Hand #226513634587: Tournament #3188088059, $13.70+$1.30 USD Hold'em No Limit - Level VII (100/200) - 2021/05/06 20:02:13 MSK [2021/05/06 13:02:13 ET]
Table '3188088059 1' 9-max Seat #1 is the button
Seat 1: dimetruk (4798 in chips)
Seat 9: SD ANDRE (8702 in chips)
dimetruk: posts the ante 25
SD ANDRE: posts the ante 25
dimetruk: posts small blind 100
SD ANDRE: posts big blind 200
*** HOLE CARDS ***
Dealt to dimetruk [6c 4d]
dimetruk: calls 100
SD ANDRE: checks
*** FLOP *** [Js 9h Ts]
SD ANDRE: checks
dimetruk: checks
*** TURN *** [Js 9h Ts] [Kd]
SD ANDRE: checks
dimetruk: bets 400
SD ANDRE: folds
Uncalled bet (400) returned to dimetruk
dimetruk collected 450 from pot
dimetruk: doesn't show hand
*** SUMMARY ***
Total pot 450 | Rake 0
Board [Js 9h Ts Kd]
Seat 1: dimetruk (button) (small blind) collected (450)
Seat 9: SD ANDRE (big blind) folded on the Turn


PokerStars Hand #226513648168: Tournament #3188088059, $13.70+$1.30 USD Hold'em No Limit - Level VII (100/200) - 2021/05/06 20:02:41 MSK [2021/05/06 13:02:41 ET]
Table '3188088059 1' 9-max Seat #9 is the button
Seat 1: dimetruk (5023 in chips)
Seat 9: SD ANDRE (8477 in chips)
dimetruk: posts the ante 25
SD ANDRE: posts the ante 25
SD ANDRE: posts small blind 100
dimetruk: posts big blind 200
*** HOLE CARDS ***
Dealt to dimetruk [5c 7h]
SD ANDRE: raises 200 to 400
dimetruk: calls 200
*** FLOP *** [2h 7c Qc]
dimetruk: checks
SD ANDRE: bets 300
dimetruk: calls 300
*** TURN *** [2h 7c Qc] [6d]
dimetruk: checks
SD ANDRE: bets 600
dimetruk: calls 600
*** RIVER *** [2h 7c Qc 6d] [5s]
dimetruk: bets 3698 and is all-in
SD ANDRE: folds
Uncalled bet (3698) returned to dimetruk
dimetruk collected 2650 from pot
dimetruk: doesn't show hand
*** SUMMARY ***
Total pot 2650 | Rake 0
Board [2h 7c Qc 6d 5s]
Seat 1: dimetruk (big blind) collected (2650)
Seat 9: SD ANDRE (button) (small blind) folded on the River


PokerStars Hand #226513696221: Tournament #3188088059, $13.70+$1.30 USD Hold'em No Limit - Level VII (100/200) - 2021/05/06 20:04:22 MSK [2021/05/06 13:04:22 ET]
Table '3188088059 1' 9-max Seat #9 is the button
Seat 1: dimetruk (6223 in chips)
Seat 9: SD ANDRE (7277 in chips)
dimetruk: posts the ante 25
SD ANDRE: posts the ante 25
SD ANDRE: posts small blind 100
dimetruk: posts big blind 200
*** HOLE CARDS ***
Dealt to dimetruk [8c 9h]
SD ANDRE: raises 200 to 400
dimetruk: calls 200
*** FLOP *** [3d Qd 8h]
dimetruk: checks
SD ANDRE: bets 300
dimetruk: calls 300
*** TURN *** [3d Qd 8h] [4c]
dimetruk: checks
SD ANDRE: bets 700
dimetruk: calls 700
*** RIVER *** [3d Qd 8h 4c] [6s]
dimetruk: checks
SD ANDRE: bets 2555
dimetruk: folds
Uncalled bet (2555) returned to SD ANDRE
SD ANDRE collected 2850 from pot
SD ANDRE: doesn't show hand
*** SUMMARY ***
Total pot 2850 | Rake 0
Board [3d Qd 8h 4c 6s]
Seat 1: dimetruk (big blind) folded on the River
Seat 9: SD ANDRE (button) (small blind) collected (2850)


PokerStars Hand #226513752069: Tournament #3188088059, $13.70+$1.30 USD Hold'em No Limit - Level VII (100/200) - 2021/05/06 20:06:07 MSK [2021/05/06 13:06:07 ET]
Table '3188088059 1' 9-max Seat #1 is the button
Seat 1: dimetruk (6248 in chips)
Seat 9: SD ANDRE (7252 in chips)
dimetruk: posts the ante 25
SD ANDRE: posts the ante 25
dimetruk: posts small blind 100
SD ANDRE: posts big blind 200
*** HOLE CARDS ***
Dealt to dimetruk [3h 7h]
dimetruk: raises 200 to 400
SD ANDRE: calls 200
*** FLOP *** [Th Qc Qh]
SD ANDRE: checks
dimetruk: bets 383
SD ANDRE: calls 383
*** TURN *** [Th Qc Qh] [Kh]
SD ANDRE: checks
dimetruk: bets 889
SD ANDRE: calls 889
*** RIVER *** [Th Qc Qh Kh] [8d]
SD ANDRE: checks
dimetruk: bets 4551 and is all-in
SD ANDRE: calls 4551
*** SHOW DOWN ***
dimetruk: shows [3h 7h] (a flush, King high)
SD ANDRE: shows [6h Ks] (two pair, Kings and Queens)
dimetruk collected 12496 from pot
*** SUMMARY ***
Total pot 12496 | Rake 0
Board [Th Qc Qh Kh 8d]
Seat 1: dimetruk (button) (small blind) showed [3h 7h] and won (12496) with a flush, King high
Seat 9: SD ANDRE (big blind) showed [6h Ks] and lost with two pair, Kings and Queens


PokerStars Hand #226513793761: Tournament #3188088059, $13.70+$1.30 USD Hold'em No Limit - Level VII (100/200) - 2021/05/06 20:07:16 MSK [2021/05/06 13:07:16 ET]
Table '3188088059 1' 9-max Seat #9 is the button
Seat 1: dimetruk (12496 in chips)
Seat 9: SD ANDRE (1004 in chips)
dimetruk: posts the ante 25
SD ANDRE: posts the ante 25
SD ANDRE: posts small blind 100
dimetruk: posts big blind 200
*** HOLE CARDS ***
Dealt to dimetruk [Ts 9h]
SD ANDRE: raises 779 to 979 and is all-in
dimetruk: calls 779
*** FLOP *** [Ah Kh Qh]
*** TURN *** [Ah Kh Qh] [9c]
*** RIVER *** [Ah Kh Qh 9c] [Kc]
*** SHOW DOWN ***
dimetruk: shows [Ts 9h] (two pair, Kings and Nines)
SD ANDRE: shows [6h 7c] (a pair of Kings)
dimetruk collected 2008 from pot
SD ANDRE finished the tournament in 2nd place and received $36.99.
dimetruk wins the tournament and receives $61.65 - congratulations!
*** SUMMARY ***
Total pot 2008 | Rake 0
Board [Ah Kh Qh 9c Kc]
Seat 1: dimetruk (big blind) showed [Ts 9h] and won (2008) with two pair, Kings and Nines
Seat 9: SD ANDRE (button) (small blind) showed [6h 7c] and lost with a pair of Kings


PokerStars Hand #226518846228: Tournament #3188224941, $13.70+$1.30 USD Hold'em No Limit - Level I (10/20) - 2021/05/06 22:41:35 MSK [2021/05/06 15:41:35 ET]
Table '3188224941 1' 9-max Seat #5 is the button
Seat 1: dimetruk (1488 in chips)
Seat 2: WinSummaThis (1478 in chips)
Seat 3: cascas73 (1458 in chips)
Seat 4: vasinlu21 (1458 in chips)
Seat 5: TUSUR FET (1732 in chips)
Seat 6: Wilq8309 (1582 in chips)
Seat 7: obhavee23 (1488 in chips)
Seat 8: tonibosi29 (1488 in chips)
Seat 9: Euforia99 (1328 in chips)
dimetruk: posts the ante 3
WinSummaThis: posts the ante 3
cascas73: posts the ante 3
vasinlu21: posts the ante 3
TUSUR FET: posts the ante 3
Wilq8309: posts the ante 3
obhavee23: posts the ante 3
tonibosi29: posts the ante 3
Euforia99: posts the ante 3
Wilq8309: posts small blind 10
obhavee23: posts big blind 20
*** HOLE CARDS ***
Dealt to dimetruk [Qs Js]
tonibosi29: folds
Euforia99: folds
dimetruk: raises 20 to 40
WinSummaThis: folds
cascas73: folds
vasinlu21: folds
TUSUR FET: folds
Wilq8309: folds
obhavee23: raises 20 to 60
dimetruk: raises 20 to 80
obhavee23: calls 20
*** FLOP *** [8d 7c 3c]
obhavee23: checks
dimetruk: bets 108
obhavee23: calls 108
*** TURN *** [8d 7c 3c] [Ts]
obhavee23: checks
dimetruk: checks
*** RIVER *** [8d 7c 3c Ts] [5c]
obhavee23: checks
dimetruk: checks
*** SHOW DOWN ***
obhavee23: shows [As Td] (a pair of Tens)
dimetruk: mucks hand
obhavee23 collected 413 from pot
*** SUMMARY ***
Total pot 413 | Rake 0
Board [8d 7c 3c Ts 5c]
Seat 1: dimetruk mucked [Qs Js]
Seat 2: WinSummaThis folded before Flop (didn't bet)
Seat 3: cascas73 folded before Flop (didn't bet)
Seat 4: vasinlu21 folded before Flop (didn't bet)
Seat 5: TUSUR FET (button) folded before Flop (didn't bet)
Seat 6: Wilq8309 (small blind) folded before Flop
Seat 7: obhavee23 (big blind) showed [As Td] and won (413) with a pair of Tens
Seat 8: tonibosi29 folded before Flop (didn't bet)
Seat 9: Euforia99 folded before Flop (didn't bet)


PokerStars Hand #226518995724: Tournament #3188224941, $13.70+$1.30 USD Hold'em No Limit - Level I (10/20) - 2021/05/06 22:45:16 MSK [2021/05/06 15:45:16 ET]
Table '3188224941 1' 9-max Seat #9 is the button
Seat 1: dimetruk (1268 in chips)
Seat 2: WinSummaThis (1466 in chips)
Seat 3: cascas73 (1149 in chips)
Seat 4: vasinlu21 (1446 in chips)
Seat 5: TUSUR FET (1591 in chips)
Seat 6: Wilq8309 (1560 in chips)
Seat 7: obhavee23 (1691 in chips)
Seat 8: tonibosi29 (2137 in chips)
Seat 9: Euforia99 (1192 in chips)
dimetruk: posts the ante 3
WinSummaThis: posts the ante 3
cascas73: posts the ante 3
vasinlu21: posts the ante 3
TUSUR FET: posts the ante 3
Wilq8309: posts the ante 3
obhavee23: posts the ante 3
tonibosi29: posts the ante 3
Euforia99: posts the ante 3
dimetruk: posts small blind 10
WinSummaThis: posts big blind 20
*** HOLE CARDS ***
Dealt to dimetruk [6s 3c]
cascas73: folds
vasinlu21: folds
TUSUR FET: folds
Wilq8309: folds
obhavee23: folds
tonibosi29: folds
Euforia99: folds
dimetruk: raises 20 to 40
WinSummaThis: calls 20
*** FLOP *** [6c 9s 9d]
dimetruk: bets 48
WinSummaThis: folds
Uncalled bet (48) returned to dimetruk
dimetruk collected 107 from pot
dimetruk: doesn't show hand
*** SUMMARY ***
Total pot 107 | Rake 0
Board [6c 9s 9d]
Seat 1: dimetruk (small blind) collected (107)
Seat 2: WinSummaThis (big blind) folded on the Flop
Seat 3: cascas73 folded before Flop (didn't bet)
Seat 4: vasinlu21 folded before Flop (didn't bet)
Seat 5: TUSUR FET folded before Flop (didn't bet)
Seat 6: Wilq8309 folded before Flop (didn't bet)
Seat 7: obhavee23 folded before Flop (didn't bet)
Seat 8: tonibosi29 folded before Flop (didn't bet)
Seat 9: Euforia99 (button) folded before Flop (didn't bet)


PokerStars Hand #226519729555: Tournament #3188224941, $13.70+$1.30 USD Hold'em No Limit - Level III (25/50) - 2021/05/06 23:05:15 MSK [2021/05/06 16:05:15 ET]
Table '3188224941 1' 9-max Seat #5 is the button
Seat 1: dimetruk (1557 in chips)
Seat 2: WinSummaThis (1858 in chips)
Seat 4: vasinlu21 (1777 in chips)
Seat 5: TUSUR FET (1590 in chips)
Seat 7: obhavee23 (3365 in chips)
Seat 8: tonibosi29 (2295 in chips)
Seat 9: Euforia99 (1058 in chips)
dimetruk: posts the ante 6
WinSummaThis: posts the ante 6
vasinlu21: posts the ante 6
TUSUR FET: posts the ante 6
obhavee23: posts the ante 6
tonibosi29: posts the ante 6
Euforia99: posts the ante 6
obhavee23: posts small blind 25
tonibosi29: posts big blind 50
*** HOLE CARDS ***
Dealt to dimetruk [Kc Kh]
Euforia99: raises 52 to 102
dimetruk: calls 102
WinSummaThis: folds
vasinlu21: folds
TUSUR FET: folds
obhavee23: folds
tonibosi29: calls 52
*** FLOP *** [As 8d Tc]
tonibosi29: bets 50
Euforia99: raises 132 to 182
dimetruk: calls 182
tonibosi29: calls 132
*** TURN *** [As 8d Tc] [7s]
tonibosi29: checks
Euforia99: checks
dimetruk: checks
*** RIVER *** [As 8d Tc 7s] [6s]
tonibosi29: checks
Euforia99: checks
dimetruk: checks
*** SHOW DOWN ***
tonibosi29: shows [8h Jc] (a pair of Eights)
Euforia99: shows [Ad 4d] (a pair of Aces)
dimetruk: mucks hand
Euforia99 collected 919 from pot
*** SUMMARY ***
Total pot 919 | Rake 0
Board [As 8d Tc 7s 6s]
Seat 1: dimetruk mucked [Kc Kh]
Seat 2: WinSummaThis folded before Flop (didn't bet)
Seat 4: vasinlu21 folded before Flop (didn't bet)
Seat 5: TUSUR FET (button) folded before Flop (didn't bet)
Seat 7: obhavee23 (small blind) folded before Flop
Seat 8: tonibosi29 (big blind) showed [8h Jc] and lost with a pair of Eights
Seat 9: Euforia99 showed [Ad 4d] and won (919) with a pair of Aces


PokerStars Hand #226519782933: Tournament #3188224941, $13.70+$1.30 USD Hold'em No Limit - Level III (25/50) - 2021/05/06 23:06:24 MSK [2021/05/06 16:06:24 ET]
Table '3188224941 1' 9-max Seat #7 is the button
Seat 1: dimetruk (1267 in chips)
Seat 2: WinSummaThis (1852 in chips)
Seat 4: vasinlu21 (1771 in chips)
Seat 5: TUSUR FET (1584 in chips)
Seat 7: obhavee23 (3334 in chips)
Seat 8: tonibosi29 (2005 in chips)
Seat 9: Euforia99 (1687 in chips)
dimetruk: posts the ante 6
WinSummaThis: posts the ante 6
vasinlu21: posts the ante 6
TUSUR FET: posts the ante 6
obhavee23: posts the ante 6
tonibosi29: posts the ante 6
Euforia99: posts the ante 6
tonibosi29: posts small blind 25
Euforia99: posts big blind 50
*** HOLE CARDS ***
Dealt to dimetruk [As Tc]
dimetruk: raises 50 to 100
WinSummaThis: folds
vasinlu21: folds
TUSUR FET: folds
obhavee23: folds
tonibosi29: folds
Euforia99: calls 50
*** FLOP *** [Ac 3c 7h]
Euforia99: checks
dimetruk: bets 120
Euforia99: folds
Uncalled bet (120) returned to dimetruk
dimetruk collected 267 from pot
dimetruk: doesn't show hand
*** SUMMARY ***
Total pot 267 | Rake 0
Board [Ac 3c 7h]
Seat 1: dimetruk collected (267)
Seat 2: WinSummaThis folded before Flop (didn't bet)
Seat 4: vasinlu21 folded before Flop (didn't bet)
Seat 5: TUSUR FET folded before Flop (didn't bet)
Seat 7: obhavee23 (button) folded before Flop (didn't bet)
Seat 8: tonibosi29 (small blind) folded before Flop
Seat 9: Euforia99 (big blind) folded on the Flop


PokerStars Hand #226519803755: Tournament #3188224941, $13.70+$1.30 USD Hold'em No Limit - Level III (25/50) - 2021/05/06 23:06:54 MSK [2021/05/06 16:06:54 ET]
Table '3188224941 1' 9-max Seat #8 is the button
Seat 1: dimetruk (1428 in chips)
Seat 2: WinSummaThis (1846 in chips)
Seat 4: vasinlu21 (1765 in chips)
Seat 5: TUSUR FET (1578 in chips)
Seat 7: obhavee23 (3328 in chips)
Seat 8: tonibosi29 (1974 in chips)
Seat 9: Euforia99 (1581 in chips)
dimetruk: posts the ante 6
WinSummaThis: posts the ante 6
vasinlu21: posts the ante 6
TUSUR FET: posts the ante 6
obhavee23: posts the ante 6
tonibosi29: posts the ante 6
Euforia99: posts the ante 6
Euforia99: posts small blind 25
dimetruk: posts big blind 50
*** HOLE CARDS ***
Dealt to dimetruk [9d Ac]
WinSummaThis: folds
vasinlu21: raises 50 to 100
TUSUR FET: folds
obhavee23: folds
tonibosi29: calls 100
Euforia99: folds
dimetruk: calls 50
*** FLOP *** [7s 4d 2d]
dimetruk: checks
vasinlu21: checks
tonibosi29: bets 184
dimetruk: folds
vasinlu21: calls 184
*** TURN *** [7s 4d 2d] [5d]
vasinlu21: bets 400
tonibosi29: folds
Uncalled bet (400) returned to vasinlu21
vasinlu21 collected 735 from pot
vasinlu21: doesn't show hand
*** SUMMARY ***
Total pot 735 | Rake 0
Board [7s 4d 2d 5d]
Seat 1: dimetruk (big blind) folded on the Flop
Seat 2: WinSummaThis folded before Flop (didn't bet)
Seat 4: vasinlu21 collected (735)
Seat 5: TUSUR FET folded before Flop (didn't bet)
Seat 7: obhavee23 folded before Flop (didn't bet)
Seat 8: tonibosi29 (button) folded on the Turn
Seat 9: Euforia99 (small blind) folded before Flop


PokerStars Hand #226519837519: Tournament #3188224941, $13.70+$1.30 USD Hold'em No Limit - Level III (25/50) - 2021/05/06 23:07:42 MSK [2021/05/06 16:07:42 ET]
Table '3188224941 1' 9-max Seat #9 is the button
Seat 1: dimetruk (1322 in chips)
Seat 2: WinSummaThis (1840 in chips)
Seat 4: vasinlu21 (2210 in chips)
Seat 5: TUSUR FET (1572 in chips)
Seat 7: obhavee23 (3322 in chips)
Seat 8: tonibosi29 (1684 in chips)
Seat 9: Euforia99 (1550 in chips)
dimetruk: posts the ante 6
WinSummaThis: posts the ante 6
vasinlu21: posts the ante 6
TUSUR FET: posts the ante 6
obhavee23: posts the ante 6
tonibosi29: posts the ante 6
Euforia99: posts the ante 6
dimetruk: posts small blind 25
WinSummaThis: posts big blind 50
*** HOLE CARDS ***
Dealt to dimetruk [5c 7c]
vasinlu21: folds
TUSUR FET: folds
obhavee23: folds
tonibosi29: folds
Euforia99: folds
dimetruk: raises 50 to 100
WinSummaThis: calls 50
*** FLOP *** [Ts 3c Ah]
dimetruk: bets 80
WinSummaThis: folds
Uncalled bet (80) returned to dimetruk
dimetruk collected 242 from pot
dimetruk: doesn't show hand
*** SUMMARY ***
Total pot 242 | Rake 0
Board [Ts 3c Ah]
Seat 1: dimetruk (small blind) collected (242)
Seat 2: WinSummaThis (big blind) folded on the Flop
Seat 4: vasinlu21 folded before Flop (didn't bet)
Seat 5: TUSUR FET folded before Flop (didn't bet)
Seat 7: obhavee23 folded before Flop (didn't bet)
Seat 8: tonibosi29 folded before Flop (didn't bet)
Seat 9: Euforia99 (button) folded before Flop (didn't bet)


PokerStars Hand #226519855966: Tournament #3188224941, $13.70+$1.30 USD Hold'em No Limit - Level III (25/50) - 2021/05/06 23:08:09 MSK [2021/05/06 16:08:09 ET]
Table '3188224941 1' 9-max Seat #1 is the button
Seat 1: dimetruk (1458 in chips)
Seat 2: WinSummaThis (1734 in chips)
Seat 4: vasinlu21 (2204 in chips)
Seat 5: TUSUR FET (1566 in chips)
Seat 7: obhavee23 (3316 in chips)
Seat 8: tonibosi29 (1678 in chips)
Seat 9: Euforia99 (1544 in chips)
dimetruk: posts the ante 6
WinSummaThis: posts the ante 6
vasinlu21: posts the ante 6
TUSUR FET: posts the ante 6
obhavee23: posts the ante 6
tonibosi29: posts the ante 6
Euforia99: posts the ante 6
WinSummaThis: posts small blind 25
vasinlu21: posts big blind 50
*** HOLE CARDS ***
Dealt to dimetruk [Kc Tc]
TUSUR FET: folds
obhavee23: folds
tonibosi29: folds
Euforia99: folds
dimetruk: raises 50 to 100
WinSummaThis: calls 75
vasinlu21: folds
*** FLOP *** [Kh Jh Qd]
WinSummaThis: checks
dimetruk: bets 96
WinSummaThis: folds
Uncalled bet (96) returned to dimetruk
dimetruk collected 292 from pot
dimetruk: doesn't show hand
*** SUMMARY ***
Total pot 292 | Rake 0
Board [Kh Jh Qd]
Seat 1: dimetruk (button) collected (292)
Seat 2: WinSummaThis (small blind) folded on the Flop
Seat 4: vasinlu21 (big blind) folded before Flop
Seat 5: TUSUR FET folded before Flop (didn't bet)
Seat 7: obhavee23 folded before Flop (didn't bet)
Seat 8: tonibosi29 folded before Flop (didn't bet)
Seat 9: Euforia99 folded before Flop (didn't bet)


PokerStars Hand #226520622531: Tournament #3188224941, $13.70+$1.30 USD Hold'em No Limit - Level V (60/120) - 2021/05/06 23:25:54 MSK [2021/05/06 16:25:54 ET]
Table '3188224941 2' 9-max Seat #6 is the button
Seat 1: hansbolle (906 in chips)
Seat 2: vasinlu21 (4285 in chips)
Seat 3: dimetruk (1548 in chips)
Seat 4: RaulG777 (1533 in chips)
Seat 5: WinSummaThis (2177 in chips)
Seat 6: TUSUR FET (2050 in chips)
Seat 7: Parky66 (2332 in chips)
Seat 8: tonibosi29 (3399 in chips)
Seat 9: kurtaro (8770 in chips)
hansbolle: posts the ante 15
vasinlu21: posts the ante 15
dimetruk: posts the ante 15
RaulG777: posts the ante 15
WinSummaThis: posts the ante 15
TUSUR FET: posts the ante 15
Parky66: posts the ante 15
tonibosi29: posts the ante 15
kurtaro: posts the ante 15
Parky66: posts small blind 60
tonibosi29: posts big blind 120
*** HOLE CARDS ***
Dealt to dimetruk [As 8d]
kurtaro: folds
hansbolle: folds
vasinlu21: folds
dimetruk: raises 120 to 240
RaulG777: folds
WinSummaThis: folds
TUSUR FET: folds
Parky66: folds
tonibosi29: calls 120
*** FLOP *** [7s 4s Td]
tonibosi29: checks
dimetruk: bets 223
tonibosi29: folds
Uncalled bet (223) returned to dimetruk
dimetruk collected 675 from pot
dimetruk: doesn't show hand
*** SUMMARY ***
Total pot 675 | Rake 0
Board [7s 4s Td]
Seat 1: hansbolle folded before Flop (didn't bet)
Seat 2: vasinlu21 folded before Flop (didn't bet)
Seat 3: dimetruk collected (675)
Seat 4: RaulG777 folded before Flop (didn't bet)
Seat 5: WinSummaThis folded before Flop (didn't bet)
Seat 6: TUSUR FET (button) folded before Flop (didn't bet)
Seat 7: Parky66 (small blind) folded before Flop
Seat 8: tonibosi29 (big blind) folded on the Flop
Seat 9: kurtaro folded before Flop (didn't bet)


PokerStars Hand #226520732852: Tournament #3188224941, $13.70+$1.30 USD Hold'em No Limit - Level V (60/120) - 2021/05/06 23:28:31 MSK [2021/05/06 16:28:31 ET]
Table '3188224941 2' 9-max Seat #1 is the button
Seat 1: hansbolle (666 in chips)
Seat 2: vasinlu21 (4105 in chips)
Seat 3: dimetruk (2238 in chips)
Seat 4: RaulG777 (1473 in chips)
Seat 5: WinSummaThis (3370 in chips)
Seat 6: TUSUR FET (2425 in chips)
Seat 7: Parky66 (2212 in chips)
Seat 8: tonibosi29 (3039 in chips)
Seat 9: kurtaro (7472 in chips)
hansbolle: posts the ante 15
vasinlu21: posts the ante 15
dimetruk: posts the ante 15
RaulG777: posts the ante 15
WinSummaThis: posts the ante 15
TUSUR FET: posts the ante 15
Parky66: posts the ante 15
tonibosi29: posts the ante 15
kurtaro: posts the ante 15
vasinlu21: posts small blind 60
dimetruk: posts big blind 120
*** HOLE CARDS ***
Dealt to dimetruk [4c Qs]
RaulG777: folds
WinSummaThis: raises 120 to 240
TUSUR FET: folds
Parky66: folds
tonibosi29: folds
kurtaro: calls 240
hansbolle: folds
vasinlu21: folds
dimetruk: calls 120
*** FLOP *** [Th 3h 4s]
dimetruk: checks
WinSummaThis: checks
kurtaro: bets 610
dimetruk: folds
WinSummaThis: folds
Uncalled bet (610) returned to kurtaro
kurtaro collected 915 from pot
kurtaro: doesn't show hand
*** SUMMARY ***
Total pot 915 | Rake 0
Board [Th 3h 4s]
Seat 1: hansbolle (button) folded before Flop (didn't bet)
Seat 2: vasinlu21 (small blind) folded before Flop
Seat 3: dimetruk (big blind) folded on the Flop
Seat 4: RaulG777 folded before Flop (didn't bet)
Seat 5: WinSummaThis folded on the Flop
Seat 6: TUSUR FET folded before Flop (didn't bet)
Seat 7: Parky66 folded before Flop (didn't bet)
Seat 8: tonibosi29 folded before Flop (didn't bet)
Seat 9: kurtaro collected (915)


PokerStars Hand #226520802172: Tournament #3188224941, $13.70+$1.30 USD Hold'em No Limit - Level V (60/120) - 2021/05/06 23:30:09 MSK [2021/05/06 16:30:09 ET]
Table '3188224941 2' 9-max Seat #3 is the button
Seat 1: hansbolle (636 in chips)
Seat 2: vasinlu21 (4015 in chips)
Seat 3: dimetruk (1908 in chips)
Seat 4: RaulG777 (1323 in chips)
Seat 5: WinSummaThis (3100 in chips)
Seat 6: TUSUR FET (2395 in chips)
Seat 7: Parky66 (4679 in chips)
Seat 8: tonibosi29 (3009 in chips)
Seat 9: kurtaro (5935 in chips)
hansbolle: posts the ante 15
vasinlu21: posts the ante 15
dimetruk: posts the ante 15
RaulG777: posts the ante 15
WinSummaThis: posts the ante 15
TUSUR FET: posts the ante 15
Parky66: posts the ante 15
tonibosi29: posts the ante 15
kurtaro: posts the ante 15
RaulG777: posts small blind 60
WinSummaThis: posts big blind 120
*** HOLE CARDS ***
Dealt to dimetruk [As Ad]
TUSUR FET: folds
Parky66: folds
tonibosi29: folds
kurtaro: folds
hansbolle: raises 501 to 621 and is all-in
vasinlu21: folds
dimetruk: calls 621
RaulG777: folds
WinSummaThis: folds
*** FLOP *** [6d 6c Ac]
*** TURN *** [6d 6c Ac] [7s]
*** RIVER *** [6d 6c Ac 7s] [Qd]
*** SHOW DOWN ***
hansbolle: shows [Jc Kc] (a pair of Sixes)
dimetruk: shows [As Ad] (a full house, Aces full of Sixes)
dimetruk collected 1557 from pot
hansbolle finished the tournament in 9th place
*** SUMMARY ***
Total pot 1557 | Rake 0
Board [6d 6c Ac 7s Qd]
Seat 1: hansbolle showed [Jc Kc] and lost with a pair of Sixes
Seat 2: vasinlu21 folded before Flop (didn't bet)
Seat 3: dimetruk (button) showed [As Ad] and won (1557) with a full house, Aces full of Sixes
Seat 4: RaulG777 (small blind) folded before Flop
Seat 5: WinSummaThis (big blind) folded before Flop
Seat 6: TUSUR FET folded before Flop (didn't bet)
Seat 7: Parky66 folded before Flop (didn't bet)
Seat 8: tonibosi29 folded before Flop (didn't bet)
Seat 9: kurtaro folded before Flop (didn't bet)


PokerStars Hand #226520928027: Tournament #3188224941, $13.70+$1.30 USD Hold'em No Limit - Level V (60/120) - 2021/05/06 23:32:59 MSK [2021/05/06 16:32:59 ET]
Table '3188224941 2' 9-max Seat #7 is the button
Seat 2: vasinlu21 (4255 in chips)
Seat 3: dimetruk (3084 in chips)
Seat 4: RaulG777 (1203 in chips)
Seat 5: WinSummaThis (3280 in chips)
Seat 6: TUSUR FET (2155 in chips)
Seat 7: Parky66 (4319 in chips)
Seat 8: tonibosi29 (2829 in chips)
Seat 9: kurtaro (5875 in chips)
vasinlu21: posts the ante 15
dimetruk: posts the ante 15
RaulG777: posts the ante 15
WinSummaThis: posts the ante 15
TUSUR FET: posts the ante 15
Parky66: posts the ante 15
tonibosi29: posts the ante 15
kurtaro: posts the ante 15
tonibosi29: posts small blind 60
kurtaro: posts big blind 120
*** HOLE CARDS ***
Dealt to dimetruk [Jc Ac]
vasinlu21: raises 138 to 258
dimetruk: raises 402 to 660
RaulG777: folds
WinSummaThis: folds
TUSUR FET: folds
Parky66: folds
tonibosi29: folds
kurtaro: folds
vasinlu21: calls 402
*** FLOP *** [5h 2s 6s]
vasinlu21: checks
dimetruk: bets 480
vasinlu21: folds
Uncalled bet (480) returned to dimetruk
dimetruk collected 1620 from pot
dimetruk: doesn't show hand
*** SUMMARY ***
Total pot 1620 | Rake 0
Board [5h 2s 6s]
Seat 2: vasinlu21 folded on the Flop
Seat 3: dimetruk collected (1620)
Seat 4: RaulG777 folded before Flop (didn't bet)
Seat 5: WinSummaThis folded before Flop (didn't bet)
Seat 6: TUSUR FET folded before Flop (didn't bet)
Seat 7: Parky66 (button) folded before Flop (didn't bet)
Seat 8: tonibosi29 (small blind) folded before Flop
Seat 9: kurtaro (big blind) folded before Flop


PokerStars Hand #226521016695: Tournament #3188224941, $13.70+$1.30 USD Hold'em No Limit - Level VI (80/160) - 2021/05/06 23:35:07 MSK [2021/05/06 16:35:07 ET]
Table '3188224941 2' 9-max Seat #9 is the button
Seat 2: vasinlu21 (3240 in chips)
Seat 3: dimetruk (4009 in chips)
Seat 4: RaulG777 (1168 in chips)
Seat 5: WinSummaThis (3805 in chips)
Seat 6: TUSUR FET (2120 in chips)
Seat 7: Parky66 (4284 in chips)
Seat 8: tonibosi29 (2734 in chips)
Seat 9: kurtaro (5640 in chips)
vasinlu21: posts the ante 20
dimetruk: posts the ante 20
RaulG777: posts the ante 20
WinSummaThis: posts the ante 20
TUSUR FET: posts the ante 20
Parky66: posts the ante 20
tonibosi29: posts the ante 20
kurtaro: posts the ante 20
vasinlu21: posts small blind 80
dimetruk: posts big blind 160
*** HOLE CARDS ***
Dealt to dimetruk [Kd Kc]
RaulG777: folds
WinSummaThis: folds
TUSUR FET: folds
Parky66: folds
tonibosi29: folds
kurtaro: raises 176 to 336
vasinlu21: raises 2884 to 3220 and is all-in
dimetruk: raises 769 to 3989 and is all-in
kurtaro: folds
Uncalled bet (769) returned to dimetruk
*** FLOP *** [Kh 9s 8c]
*** TURN *** [Kh 9s 8c] [6d]
*** RIVER *** [Kh 9s 8c 6d] [4h]
*** SHOW DOWN ***
vasinlu21: shows [Ac Td] (high card Ace)
dimetruk: shows [Kd Kc] (three of a kind, Kings)
dimetruk collected 6936 from pot
vasinlu21 finished the tournament in 8th place
*** SUMMARY ***
Total pot 6936 | Rake 0
Board [Kh 9s 8c 6d 4h]
Seat 2: vasinlu21 (small blind) showed [Ac Td] and lost with high card Ace
Seat 3: dimetruk (big blind) showed [Kd Kc] and won (6936) with three of a kind, Kings
Seat 4: RaulG777 folded before Flop (didn't bet)
Seat 5: WinSummaThis folded before Flop (didn't bet)
Seat 6: TUSUR FET folded before Flop (didn't bet)
Seat 7: Parky66 folded before Flop (didn't bet)
Seat 8: tonibosi29 folded before Flop (didn't bet)
Seat 9: kurtaro (button) folded before Flop


PokerStars Hand #226521047336: Tournament #3188224941, $13.70+$1.30 USD Hold'em No Limit - Level VI (80/160) - 2021/05/06 23:35:51 MSK [2021/05/06 16:35:51 ET]
Table '3188224941 2' 9-max Seat #3 is the button
Seat 3: dimetruk (7705 in chips)
Seat 4: RaulG777 (1148 in chips)
Seat 5: WinSummaThis (3785 in chips)
Seat 6: TUSUR FET (2100 in chips)
Seat 7: Parky66 (4264 in chips)
Seat 8: tonibosi29 (2714 in chips)
Seat 9: kurtaro (5284 in chips)
dimetruk: posts the ante 20
RaulG777: posts the ante 20
WinSummaThis: posts the ante 20
TUSUR FET: posts the ante 20
Parky66: posts the ante 20
tonibosi29: posts the ante 20
kurtaro: posts the ante 20
RaulG777: posts small blind 80
WinSummaThis: posts big blind 160
*** HOLE CARDS ***
Dealt to dimetruk [Qd Qc]
TUSUR FET: folds
Parky66: calls 160
tonibosi29: folds
kurtaro: folds
dimetruk: raises 360 to 520
RaulG777: folds
WinSummaThis: folds
Parky66: calls 360
*** FLOP *** [7h 9c 4s]
Parky66: checks
dimetruk: bets 1065
Parky66: folds
Uncalled bet (1065) returned to dimetruk
dimetruk collected 1420 from pot
dimetruk: doesn't show hand
*** SUMMARY ***
Total pot 1420 | Rake 0
Board [7h 9c 4s]
Seat 3: dimetruk (button) collected (1420)
Seat 4: RaulG777 (small blind) folded before Flop
Seat 5: WinSummaThis (big blind) folded before Flop
Seat 6: TUSUR FET folded before Flop (didn't bet)
Seat 7: Parky66 folded on the Flop
Seat 8: tonibosi29 folded before Flop (didn't bet)
Seat 9: kurtaro folded before Flop (didn't bet)


PokerStars Hand #226521148384: Tournament #3188224941, $13.70+$1.30 USD Hold'em No Limit - Level VI (80/160) - 2021/05/06 23:38:18 MSK [2021/05/06 16:38:18 ET]
Table '3188224941 2' 9-max Seat #8 is the button
Seat 3: dimetruk (8185 in chips)
Seat 4: RaulG777 (2676 in chips)
Seat 5: WinSummaThis (2437 in chips)
Seat 6: TUSUR FET (2520 in chips)
Seat 7: Parky66 (3784 in chips)
Seat 8: tonibosi29 (2374 in chips)
Seat 9: kurtaro (5024 in chips)
dimetruk: posts the ante 20
RaulG777: posts the ante 20
WinSummaThis: posts the ante 20
TUSUR FET: posts the ante 20
Parky66: posts the ante 20
tonibosi29: posts the ante 20
kurtaro: posts the ante 20
kurtaro: posts small blind 80
dimetruk: posts big blind 160
*** HOLE CARDS ***
Dealt to dimetruk [Td 8s]
RaulG777: folds
WinSummaThis: folds
TUSUR FET: folds
Parky66: raises 160 to 320
tonibosi29: folds
kurtaro: calls 240
dimetruk: calls 160
*** FLOP *** [4h Qh Qc]
kurtaro: checks
dimetruk: checks
Parky66: bets 160
kurtaro: calls 160
dimetruk: folds
*** TURN *** [4h Qh Qc] [9d]
kurtaro: checks
Parky66: checks
*** RIVER *** [4h Qh Qc 9d] [Ah]
kurtaro: checks
Parky66: checks
*** SHOW DOWN ***
kurtaro: shows [Kd Jc] (a pair of Queens)
Parky66: shows [6d 6h] (two pair, Queens and Sixes)
Parky66 collected 1420 from pot
*** SUMMARY ***
Total pot 1420 | Rake 0
Board [4h Qh Qc 9d Ah]
Seat 3: dimetruk (big blind) folded on the Flop
Seat 4: RaulG777 folded before Flop (didn't bet)
Seat 5: WinSummaThis folded before Flop (didn't bet)
Seat 6: TUSUR FET folded before Flop (didn't bet)
Seat 7: Parky66 showed [6d 6h] and won (1420) with two pair, Queens and Sixes
Seat 8: tonibosi29 (button) folded before Flop (didn't bet)
Seat 9: kurtaro (small blind) showed [Kd Jc] and lost with a pair of Queens


PokerStars Hand #226521263185: Tournament #3188224941, $13.70+$1.30 USD Hold'em No Limit - Level VI (80/160) - 2021/05/06 23:40:57 MSK [2021/05/06 16:40:57 ET]
Table '3188224941 2' 9-max Seat #7 is the button
Seat 3: dimetruk (7665 in chips)
Seat 4: RaulG777 (2316 in chips)
Seat 5: WinSummaThis (2837 in chips)
Seat 6: TUSUR FET (2540 in chips)
Seat 7: Parky66 (4124 in chips)
Seat 8: tonibosi29 (2714 in chips)
Seat 9: kurtaro (4804 in chips)
dimetruk: posts the ante 20
RaulG777: posts the ante 20
WinSummaThis: posts the ante 20
TUSUR FET: posts the ante 20
Parky66: posts the ante 20
tonibosi29: posts the ante 20
kurtaro: posts the ante 20
tonibosi29: posts small blind 80
kurtaro: posts big blind 160
*** HOLE CARDS ***
Dealt to dimetruk [3d 3s]
dimetruk: raises 160 to 320
RaulG777: folds
WinSummaThis: folds
TUSUR FET: folds
Parky66: folds
tonibosi29: folds
kurtaro: calls 160
*** FLOP *** [5d 2d 8h]
kurtaro: checks
dimetruk: checks
*** TURN *** [5d 2d 8h] [5c]
kurtaro: bets 240
dimetruk: calls 240
*** RIVER *** [5d 2d 8h 5c] [Jc]
kurtaro: checks
dimetruk: checks
*** SHOW DOWN ***
kurtaro: shows [Ah 9d] (a pair of Fives)
dimetruk: shows [3d 3s] (two pair, Fives and Threes)
dimetruk collected 1340 from pot
*** SUMMARY ***
Total pot 1340 | Rake 0
Board [5d 2d 8h 5c Jc]
Seat 3: dimetruk showed [3d 3s] and won (1340) with two pair, Fives and Threes
Seat 4: RaulG777 folded before Flop (didn't bet)
Seat 5: WinSummaThis folded before Flop (didn't bet)
Seat 6: TUSUR FET folded before Flop (didn't bet)
Seat 7: Parky66 (button) folded before Flop (didn't bet)
Seat 8: tonibosi29 (small blind) folded before Flop
Seat 9: kurtaro (big blind) showed [Ah 9d] and lost with a pair of Fives


PokerStars Hand #226521292250: Tournament #3188224941, $13.70+$1.30 USD Hold'em No Limit - Level VI (80/160) - 2021/05/06 23:41:40 MSK [2021/05/06 16:41:40 ET]
Table '3188224941 2' 9-max Seat #9 is the button
Seat 3: dimetruk (8705 in chips)
Seat 4: RaulG777 (2276 in chips)
Seat 5: WinSummaThis (2797 in chips)
Seat 6: TUSUR FET (2500 in chips)
Seat 7: Parky66 (4084 in chips)
Seat 8: tonibosi29 (2594 in chips)
Seat 9: kurtaro (4044 in chips)
dimetruk: posts the ante 20
RaulG777: posts the ante 20
WinSummaThis: posts the ante 20
TUSUR FET: posts the ante 20
Parky66: posts the ante 20
tonibosi29: posts the ante 20
kurtaro: posts the ante 20
dimetruk: posts small blind 80
RaulG777: posts big blind 160
*** HOLE CARDS ***
Dealt to dimetruk [Js Qs]
WinSummaThis: folds
TUSUR FET: folds
Parky66: folds
tonibosi29: folds
kurtaro: raises 176 to 336
dimetruk: raises 384 to 720
RaulG777: folds
kurtaro: calls 384
*** FLOP *** [8d 3c 2c]
dimetruk: checks
kurtaro: checks
*** TURN *** [8d 3c 2c] [9c]
dimetruk: bets 783
kurtaro: raises 2521 to 3304 and is all-in
dimetruk: folds
Uncalled bet (2521) returned to kurtaro
kurtaro collected 3306 from pot
kurtaro: doesn't show hand
*** SUMMARY ***
Total pot 3306 | Rake 0
Board [8d 3c 2c 9c]
Seat 3: dimetruk (small blind) folded on the Turn
Seat 4: RaulG777 (big blind) folded before Flop
Seat 5: WinSummaThis folded before Flop (didn't bet)
Seat 6: TUSUR FET folded before Flop (didn't bet)
Seat 7: Parky66 folded before Flop (didn't bet)
Seat 8: tonibosi29 folded before Flop (didn't bet)
Seat 9: kurtaro (button) collected (3306)


PokerStars Hand #226521443361: Tournament #3188224941, $13.70+$1.30 USD Hold'em No Limit - Level VII (100/200) - 2021/05/06 23:45:24 MSK [2021/05/06 16:45:24 ET]
Table '3188224941 2' 9-max Seat #8 is the button
Seat 3: dimetruk (7072 in chips)
Seat 4: RaulG777 (3862 in chips)
Seat 5: WinSummaThis (531 in chips)
Seat 6: TUSUR FET (2830 in chips)
Seat 7: Parky66 (3594 in chips)
Seat 8: tonibosi29 (3214 in chips)
Seat 9: kurtaro (5897 in chips)
dimetruk: posts the ante 25
RaulG777: posts the ante 25
WinSummaThis: posts the ante 25
TUSUR FET: posts the ante 25
Parky66: posts the ante 25
tonibosi29: posts the ante 25
kurtaro: posts the ante 25
kurtaro: posts small blind 100
dimetruk: posts big blind 200
*** HOLE CARDS ***
Dealt to dimetruk [Kc Ac]
RaulG777: folds
WinSummaThis: raises 306 to 506 and is all-in
TUSUR FET: folds
Parky66: folds
tonibosi29: folds
kurtaro: folds
dimetruk: calls 306
*** FLOP *** [9s 8d Kd]
*** TURN *** [9s 8d Kd] [Qd]
*** RIVER *** [9s 8d Kd Qd] [3s]
WinSummaThis said, "sure"
*** SHOW DOWN ***
dimetruk: shows [Kc Ac] (a pair of Kings)
WinSummaThis: shows [2c Qc] (a pair of Queens)
dimetruk collected 1287 from pot
WinSummaThis finished the tournament in 7th place
*** SUMMARY ***
Total pot 1287 | Rake 0
Board [9s 8d Kd Qd 3s]
Seat 3: dimetruk (big blind) showed [Kc Ac] and won (1287) with a pair of Kings
Seat 4: RaulG777 folded before Flop (didn't bet)
Seat 5: WinSummaThis showed [2c Qc] and lost with a pair of Queens
Seat 6: TUSUR FET folded before Flop (didn't bet)
Seat 7: Parky66 folded before Flop (didn't bet)
Seat 8: tonibosi29 (button) folded before Flop (didn't bet)
Seat 9: kurtaro (small blind) folded before Flop


PokerStars Hand #226521625242: Tournament #3188224941, $13.70+$1.30 USD Hold'em No Limit - Level VII (100/200) - 2021/05/06 23:49:55 MSK [2021/05/06 16:49:55 ET]
Table '3188224941 2' 9-max Seat #6 is the button
Seat 3: dimetruk (7203 in chips)
Seat 4: RaulG777 (3012 in chips)
Seat 6: TUSUR FET (2880 in chips)
Seat 7: Parky66 (2444 in chips)
Seat 8: tonibosi29 (3814 in chips)
Seat 9: kurtaro (7647 in chips)
dimetruk: posts the ante 25
RaulG777: posts the ante 25
TUSUR FET: posts the ante 25
Parky66: posts the ante 25
tonibosi29: posts the ante 25
kurtaro: posts the ante 25
Parky66: posts small blind 100
tonibosi29: posts big blind 200
*** HOLE CARDS ***
Dealt to dimetruk [Tc Js]
kurtaro: folds
dimetruk: raises 200 to 400
RaulG777: folds
TUSUR FET: folds
Parky66: calls 300
tonibosi29: folds
*** FLOP *** [2d 2h 7d]
Parky66: bets 200
dimetruk: calls 200
*** TURN *** [2d 2h 7d] [5s]
Parky66: bets 200
dimetruk: calls 200
*** RIVER *** [2d 2h 7d 5s] [Ts]
Parky66: bets 200
dimetruk: calls 200
*** SHOW DOWN ***
Parky66: shows [Jc Kh] (a pair of Deuces)
dimetruk: shows [Tc Js] (two pair, Tens and Deuces)
dimetruk collected 2350 from pot
*** SUMMARY ***
Total pot 2350 | Rake 0
Board [2d 2h 7d 5s Ts]
Seat 3: dimetruk showed [Tc Js] and won (2350) with two pair, Tens and Deuces
Seat 4: RaulG777 folded before Flop (didn't bet)
Seat 6: TUSUR FET (button) folded before Flop (didn't bet)
Seat 7: Parky66 (small blind) showed [Jc Kh] and lost with a pair of Deuces
Seat 8: tonibosi29 (big blind) folded before Flop
Seat 9: kurtaro folded before Flop (didn't bet)


PokerStars Hand #226521783524: Tournament #3188224941, $13.70+$1.30 USD Hold'em No Limit - Level VII (100/200) - 2021/05/06 23:53:55 MSK [2021/05/06 16:53:55 ET]
Table '3188224941 2' 9-max Seat #8 is the button
Seat 3: dimetruk (8078 in chips)
Seat 4: RaulG777 (3387 in chips)
Seat 7: Parky66 (1757 in chips)
Seat 8: tonibosi29 (2595 in chips)
Seat 9: kurtaro (11183 in chips)
dimetruk: posts the ante 25
RaulG777: posts the ante 25
Parky66: posts the ante 25
tonibosi29: posts the ante 25
kurtaro: posts the ante 25
kurtaro: posts small blind 100
dimetruk: posts big blind 200
*** HOLE CARDS ***
Dealt to dimetruk [Ad 4d]
RaulG777: folds
Parky66: folds
tonibosi29: folds
kurtaro: calls 100
dimetruk: checks
*** FLOP *** [8d Td Jc]
kurtaro: bets 200
dimetruk: calls 200
*** TURN *** [8d Td Jc] [3s]
kurtaro: bets 600
dimetruk: calls 600
*** RIVER *** [8d Td Jc 3s] [6h]
kurtaro: bets 1000
dimetruk: folds
Uncalled bet (1000) returned to kurtaro
kurtaro collected 2125 from pot
kurtaro: doesn't show hand
*** SUMMARY ***
Total pot 2125 | Rake 0
Board [8d Td Jc 3s 6h]
Seat 3: dimetruk (big blind) folded on the River
Seat 4: RaulG777 folded before Flop (didn't bet)
Seat 7: Parky66 folded before Flop (didn't bet)
Seat 8: tonibosi29 (button) folded before Flop (didn't bet)
Seat 9: kurtaro (small blind) collected (2125)


PokerStars Hand #226521853554: Tournament #3188224941, $13.70+$1.30 USD Hold'em No Limit - Level VIII (150/300) - 2021/05/06 23:56:21 MSK [2021/05/06 16:56:21 ET]
Table '3188224941 2' 9-max Seat #9 is the button
Seat 3: dimetruk (8203 in chips)
Seat 4: RaulG777 (3962 in chips)
Seat 7: Parky66 (1157 in chips)
Seat 8: tonibosi29 (1395 in chips)
Seat 9: kurtaro (12283 in chips)
dimetruk: posts the ante 25
RaulG777: posts the ante 25
Parky66: posts the ante 25
tonibosi29: posts the ante 25
kurtaro: posts the ante 25
dimetruk: posts small blind 150
RaulG777: posts big blind 300
*** HOLE CARDS ***
Dealt to dimetruk [5c 5s]
Parky66: folds
tonibosi29: folds
kurtaro: raises 330 to 630
dimetruk: calls 480
RaulG777: folds
*** FLOP *** [5h Kc 7c]
dimetruk: checks
kurtaro: bets 540
dimetruk: calls 540
*** TURN *** [5h Kc 7c] [Ad]
dimetruk: checks
kurtaro: bets 1710
dimetruk: raises 5298 to 7008 and is all-in
kurtaro: calls 5298
*** RIVER *** [5h Kc 7c Ad] [Jh]
*** SHOW DOWN ***
dimetruk: shows [5c 5s] (three of a kind, Fives)
kurtaro: shows [Jd As] (two pair, Aces and Jacks)
dimetruk collected 16781 from pot
*** SUMMARY ***
Total pot 16781 | Rake 0
Board [5h Kc 7c Ad Jh]
Seat 3: dimetruk (small blind) showed [5c 5s] and won (16781) with three of a kind, Fives
Seat 4: RaulG777 (big blind) folded before Flop
Seat 7: Parky66 folded before Flop (didn't bet)
Seat 8: tonibosi29 folded before Flop (didn't bet)
Seat 9: kurtaro (button) showed [Jd As] and lost with two pair, Aces and Jacks


PokerStars Hand #226521875804: Tournament #3188224941, $13.70+$1.30 USD Hold'em No Limit - Level VIII (150/300) - 2021/05/06 23:57:14 MSK [2021/05/06 16:57:14 ET]
Table '3188224941 2' 9-max Seat #4 is the button
Seat 3: dimetruk (16756 in chips)
Seat 4: RaulG777 (3462 in chips)
Seat 7: Parky66 (807 in chips)
Seat 8: tonibosi29 (1920 in chips)
Seat 9: kurtaro (4055 in chips)
dimetruk: posts the ante 25
RaulG777: posts the ante 25
Parky66: posts the ante 25
tonibosi29: posts the ante 25
kurtaro: posts the ante 25
Parky66: posts small blind 150
tonibosi29: posts big blind 300
*** HOLE CARDS ***
Dealt to dimetruk [Qc 9d]
kurtaro: folds
dimetruk: raises 300 to 600
RaulG777: folds
Parky66: raises 182 to 782 and is all-in
tonibosi29: folds
dimetruk: calls 182
*** FLOP *** [As 2c 9s]
*** TURN *** [As 2c 9s] [Ad]
*** RIVER *** [As 2c 9s Ad] [4d]
*** SHOW DOWN ***
Parky66: shows [Js Qd] (a pair of Aces)
dimetruk: shows [Qc 9d] (two pair, Aces and Nines)
dimetruk collected 1989 from pot
Parky66 finished the tournament in 5th place
*** SUMMARY ***
Total pot 1989 | Rake 0
Board [As 2c 9s Ad 4d]
Seat 3: dimetruk showed [Qc 9d] and won (1989) with two pair, Aces and Nines
Seat 4: RaulG777 (button) folded before Flop (didn't bet)
Seat 7: Parky66 (small blind) showed [Js Qd] and lost with a pair of Aces
Seat 8: tonibosi29 (big blind) folded before Flop
Seat 9: kurtaro folded before Flop (didn't bet)


PokerStars Hand #226521979324: Tournament #3188224941, $13.70+$1.30 USD Hold'em No Limit - Level VIII (150/300) - 2021/05/07 0:01:13 MSK [2021/05/06 17:01:13 ET]
Table '3188224941 2' 9-max Seat #9 is the button
Seat 3: dimetruk (21063 in chips)
Seat 8: tonibosi29 (1415 in chips)
Seat 9: kurtaro (4522 in chips)
dimetruk: posts the ante 25
tonibosi29: posts the ante 25
kurtaro: posts the ante 25
dimetruk: posts small blind 150
tonibosi29: posts big blind 300
*** HOLE CARDS ***
Dealt to dimetruk [Th Ts]
kurtaro: raises 330 to 630
dimetruk: raises 20408 to 21038 and is all-in
tonibosi29: folds
kurtaro: calls 3867 and is all-in
Uncalled bet (16541) returned to dimetruk
*** FLOP *** [2c Ad 4h]
*** TURN *** [2c Ad 4h] [8h]
*** RIVER *** [2c Ad 4h 8h] [8s]
*** SHOW DOWN ***
dimetruk: shows [Th Ts] (two pair, Tens and Eights)
kurtaro: shows [8c 8d] (four of a kind, Eights)
kurtaro collected 9369 from pot
*** SUMMARY ***
Total pot 9369 | Rake 0
Board [2c Ad 4h 8h 8s]
Seat 3: dimetruk (small blind) showed [Th Ts] and lost with two pair, Tens and Eights
Seat 8: tonibosi29 (big blind) folded before Flop
Seat 9: kurtaro (button) showed [8c 8d] and won (9369) with four of a kind, Eights


PokerStars Hand #226521991585: Tournament #3188224941, $13.70+$1.30 USD Hold'em No Limit - Level VIII (150/300) - 2021/05/07 0:01:33 MSK [2021/05/06 17:01:33 ET]
Table '3188224941 2' 9-max Seat #3 is the button
Seat 3: dimetruk (16541 in chips)
Seat 8: tonibosi29 (1090 in chips)
Seat 9: kurtaro (9369 in chips)
dimetruk: posts the ante 25
tonibosi29: posts the ante 25
kurtaro: posts the ante 25
tonibosi29: posts small blind 150
kurtaro: posts big blind 300
*** HOLE CARDS ***
Dealt to dimetruk [Jc Ts]
dimetruk: raises 300 to 600
tonibosi29: folds
kurtaro: calls 300
*** FLOP *** [5c 5h Ks]
kurtaro: checks
dimetruk: bets 470
kurtaro: calls 470
*** TURN *** [5c 5h Ks] [8c]
kurtaro: checks
dimetruk: checks
*** RIVER *** [5c 5h Ks 8c] [Ah]
kurtaro: bets 300
dimetruk: raises 900 to 1200
kurtaro: calls 900
*** SHOW DOWN ***
dimetruk: shows [Jc Ts] (a pair of Fives)
kurtaro: shows [7h Ac] (two pair, Aces and Fives)
kurtaro collected 4765 from pot
*** SUMMARY ***
Total pot 4765 | Rake 0
Board [5c 5h Ks 8c Ah]
Seat 3: dimetruk (button) showed [Jc Ts] and lost with a pair of Fives
Seat 8: tonibosi29 (small blind) folded before Flop
Seat 9: kurtaro (big blind) showed [7h Ac] and won (4765) with two pair, Aces and Fives


PokerStars Hand #226522009396: Tournament #3188224941, $13.70+$1.30 USD Hold'em No Limit - Level VIII (150/300) - 2021/05/07 0:02:02 MSK [2021/05/06 17:02:02 ET]
Table '3188224941 2' 9-max Seat #8 is the button
Seat 3: dimetruk (14246 in chips)
Seat 8: tonibosi29 (915 in chips)
Seat 9: kurtaro (11839 in chips)
dimetruk: posts the ante 25
tonibosi29: posts the ante 25
kurtaro: posts the ante 25
kurtaro: posts small blind 150
dimetruk: posts big blind 300
*** HOLE CARDS ***
Dealt to dimetruk [7d Qs]
tonibosi29: raises 300 to 600
kurtaro: folds
dimetruk: raises 300 to 900
tonibosi29: calls 290 and is all-in
Uncalled bet (10) returned to dimetruk
*** FLOP *** [8c 5s Td]
*** TURN *** [8c 5s Td] [Ad]
*** RIVER *** [8c 5s Td Ad] [Tc]
*** SHOW DOWN ***
dimetruk: shows [7d Qs] (a pair of Tens)
tonibosi29: shows [Ks Qh] (a pair of Tens - Ace+King kicker)
tonibosi29 collected 2005 from pot
*** SUMMARY ***
Total pot 2005 | Rake 0
Board [8c 5s Td Ad Tc]
Seat 3: dimetruk (big blind) showed [7d Qs] and lost with a pair of Tens
Seat 8: tonibosi29 (button) showed [Ks Qh] and won (2005) with a pair of Tens
Seat 9: kurtaro (small blind) folded before Flop


PokerStars Hand #226522018656: Tournament #3188224941, $13.70+$1.30 USD Hold'em No Limit - Level VIII (150/300) - 2021/05/07 0:02:17 MSK [2021/05/06 17:02:17 ET]
Table '3188224941 2' 9-max Seat #9 is the button
Seat 3: dimetruk (13331 in chips)
Seat 8: tonibosi29 (2005 in chips)
Seat 9: kurtaro (11664 in chips)
dimetruk: posts the ante 25
tonibosi29: posts the ante 25
kurtaro: posts the ante 25
dimetruk: posts small blind 150
tonibosi29: posts big blind 300
*** HOLE CARDS ***
Dealt to dimetruk [Qs Jh]
kurtaro: folds
dimetruk: raises 13006 to 13306 and is all-in
tonibosi29: calls 1680 and is all-in
Uncalled bet (11326) returned to dimetruk
*** FLOP *** [4h 4c 6c]
*** TURN *** [4h 4c 6c] [9h]
*** RIVER *** [4h 4c 6c 9h] [5s]
*** SHOW DOWN ***
dimetruk: shows [Qs Jh] (a pair of Fours)
tonibosi29: shows [Kc Kh] (two pair, Kings and Fours)
tonibosi29 collected 4035 from pot
*** SUMMARY ***
Total pot 4035 | Rake 0
Board [4h 4c 6c 9h 5s]
Seat 3: dimetruk (small blind) showed [Qs Jh] and lost with a pair of Fours
Seat 8: tonibosi29 (big blind) showed [Kc Kh] and won (4035) with two pair, Kings and Fours
Seat 9: kurtaro (button) folded before Flop (didn't bet)


PokerStars Hand #226522031450: Tournament #3188224941, $13.70+$1.30 USD Hold'em No Limit - Level VIII (150/300) - 2021/05/07 0:02:37 MSK [2021/05/06 17:02:37 ET]
Table '3188224941 2' 9-max Seat #8 is the button
Seat 3: dimetruk (11826 in chips)
Seat 8: tonibosi29 (3860 in chips)
Seat 9: kurtaro (11314 in chips)
dimetruk: posts the ante 25
tonibosi29: posts the ante 25
kurtaro: posts the ante 25
kurtaro: posts small blind 150
dimetruk: posts big blind 300
*** HOLE CARDS ***
Dealt to dimetruk [6d Qh]
tonibosi29: folds
kurtaro: calls 150
dimetruk: checks
*** FLOP *** [4h 2d 8h]
kurtaro: checks
dimetruk: checks
*** TURN *** [4h 2d 8h] [3h]
kurtaro: checks
dimetruk: bets 450
kurtaro: calls 450
*** RIVER *** [4h 2d 8h 3h] [9h]
kurtaro: checks
dimetruk: bets 866
kurtaro: folds
Uncalled bet (866) returned to dimetruk
dimetruk collected 1575 from pot
dimetruk: doesn't show hand
*** SUMMARY ***
Total pot 1575 | Rake 0
Board [4h 2d 8h 3h 9h]
Seat 3: dimetruk (big blind) collected (1575)
Seat 8: tonibosi29 (button) folded before Flop (didn't bet)
Seat 9: kurtaro (small blind) folded on the River


PokerStars Hand #226522061967: Tournament #3188224941, $13.70+$1.30 USD Hold'em No Limit - Level VIII (150/300) - 2021/05/07 0:03:24 MSK [2021/05/06 17:03:24 ET]
Table '3188224941 2' 9-max Seat #8 is the button
Seat 3: dimetruk (12426 in chips)
Seat 8: tonibosi29 (4310 in chips)
Seat 9: kurtaro (10264 in chips)
dimetruk: posts the ante 25
tonibosi29: posts the ante 25
kurtaro: posts the ante 25
kurtaro: posts small blind 150
dimetruk: posts big blind 300
*** HOLE CARDS ***
Dealt to dimetruk [Qh Js]
tonibosi29: calls 300
kurtaro: calls 150
dimetruk: checks
*** FLOP *** [3h Ad 6d]
kurtaro: checks
dimetruk: checks
tonibosi29: bets 488
kurtaro: folds
dimetruk: folds
Uncalled bet (488) returned to tonibosi29
tonibosi29 collected 975 from pot
*** SUMMARY ***
Total pot 975 | Rake 0
Board [3h Ad 6d]
Seat 3: dimetruk (big blind) folded on the Flop
Seat 8: tonibosi29 (button) collected (975)
Seat 9: kurtaro (small blind) folded on the Flop


PokerStars Hand #226522105526: Tournament #3188224941, $13.70+$1.30 USD Hold'em No Limit - Level IX (200/400) - 2021/05/07 0:04:19 MSK [2021/05/06 17:04:19 ET]
Table '3188224941 2' 9-max Seat #3 is the button
Seat 3: dimetruk (12551 in chips)
Seat 8: tonibosi29 (3860 in chips)
Seat 9: kurtaro (10589 in chips)
dimetruk: posts the ante 25
tonibosi29: posts the ante 25
kurtaro: posts the ante 25
tonibosi29: posts small blind 200
kurtaro: posts big blind 400
*** HOLE CARDS ***
Dealt to dimetruk [Ad Jh]
dimetruk: raises 400 to 800
tonibosi29: folds
kurtaro: calls 400
*** FLOP *** [7c Qc As]
kurtaro: checks
dimetruk: bets 844
kurtaro: calls 844
*** TURN *** [7c Qc As] [Th]
kurtaro: checks
dimetruk: bets 1603
kurtaro: folds
Uncalled bet (1603) returned to dimetruk
dimetruk collected 3563 from pot
dimetruk: doesn't show hand
*** SUMMARY ***
Total pot 3563 | Rake 0
Board [7c Qc As Th]
Seat 3: dimetruk (button) collected (3563)
Seat 8: tonibosi29 (small blind) folded before Flop
Seat 9: kurtaro (big blind) folded on the Turn


PokerStars Hand #226522161666: Tournament #3188224941, $13.70+$1.30 USD Hold'em No Limit - Level IX (200/400) - 2021/05/07 0:05:45 MSK [2021/05/06 17:05:45 ET]
Table '3188224941 2' 9-max Seat #8 is the button
Seat 3: dimetruk (13770 in chips)
Seat 8: tonibosi29 (3195 in chips)
Seat 9: kurtaro (10035 in chips)
dimetruk: posts the ante 25
tonibosi29: posts the ante 25
kurtaro: posts the ante 25
kurtaro: posts small blind 200
dimetruk: posts big blind 400
*** HOLE CARDS ***
Dealt to dimetruk [6c 8d]
tonibosi29: folds
kurtaro: calls 200
dimetruk: checks
*** FLOP *** [5c 2d 5s]
kurtaro: checks
dimetruk: checks
*** TURN *** [5c 2d 5s] [Qd]
kurtaro: bets 400
dimetruk: folds
Uncalled bet (400) returned to kurtaro
kurtaro collected 875 from pot
kurtaro: doesn't show hand
*** SUMMARY ***
Total pot 875 | Rake 0
Board [5c 2d 5s Qd]
Seat 3: dimetruk (big blind) folded on the Turn
Seat 8: tonibosi29 (button) folded before Flop (didn't bet)
Seat 9: kurtaro (small blind) collected (875)


PokerStars Hand #226522170478: Tournament #3188224941, $13.70+$1.30 USD Hold'em No Limit - Level IX (200/400) - 2021/05/07 0:05:58 MSK [2021/05/06 17:05:58 ET]
Table '3188224941 2' 9-max Seat #9 is the button
Seat 3: dimetruk (13345 in chips)
Seat 8: tonibosi29 (3170 in chips)
Seat 9: kurtaro (10485 in chips)
dimetruk: posts the ante 25
tonibosi29: posts the ante 25
kurtaro: posts the ante 25
dimetruk: posts small blind 200
tonibosi29: posts big blind 400
*** HOLE CARDS ***
Dealt to dimetruk [As Th]
kurtaro: raises 440 to 840
dimetruk: raises 1560 to 2400
tonibosi29: folds
kurtaro: calls 1560
*** FLOP *** [9s 2s 6s]
dimetruk: checks
kurtaro: checks
*** TURN *** [9s 2s 6s] [5s]
dimetruk: checks
kurtaro: bets 1240
dimetruk: calls 1240
*** RIVER *** [9s 2s 6s 5s] [Tc]
dimetruk: checks
kurtaro: checks
*** SHOW DOWN ***
dimetruk: shows [As Th] (a flush, Ace high)
kurtaro: mucks hand
dimetruk collected 7755 from pot
*** SUMMARY ***
Total pot 7755 | Rake 0
Board [9s 2s 6s 5s Tc]
Seat 3: dimetruk (small blind) showed [As Th] and won (7755) with a flush, Ace high
Seat 8: tonibosi29 (big blind) folded before Flop
Seat 9: kurtaro (button) mucked [Ac 5c]


PokerStars Hand #226522192282: Tournament #3188224941, $13.70+$1.30 USD Hold'em No Limit - Level IX (200/400) - 2021/05/07 0:06:32 MSK [2021/05/06 17:06:32 ET]
Table '3188224941 2' 9-max Seat #3 is the button
Seat 3: dimetruk (17435 in chips)
Seat 8: tonibosi29 (2745 in chips)
Seat 9: kurtaro (6820 in chips)
dimetruk: posts the ante 25
tonibosi29: posts the ante 25
kurtaro: posts the ante 25
tonibosi29: posts small blind 200
kurtaro: posts big blind 400
*** HOLE CARDS ***
Dealt to dimetruk [6s 8s]
dimetruk: raises 400 to 800
tonibosi29: folds
kurtaro: calls 400
*** FLOP *** [Jd 9d 2c]
kurtaro: checks
dimetruk: checks
*** TURN *** [Jd 9d 2c] [Qh]
kurtaro: checks
dimetruk: bets 619
kurtaro: calls 619
*** RIVER *** [Jd 9d 2c Qh] [Tc]
kurtaro: checks
dimetruk: checks
*** SHOW DOWN ***
kurtaro: shows [8d 8h] (a straight, Eight to Queen)
dimetruk: shows [6s 8s] (a straight, Eight to Queen)
kurtaro collected 1557 from pot
dimetruk collected 1556 from pot
*** SUMMARY ***
Total pot 3113 | Rake 0
Board [Jd 9d 2c Qh Tc]
Seat 3: dimetruk (button) showed [6s 8s] and won (1556) with a straight, Eight to Queen
Seat 8: tonibosi29 (small blind) folded before Flop
Seat 9: kurtaro (big blind) showed [8d 8h] and won (1557) with a straight, Eight to Queen


PokerStars Hand #226522231598: Tournament #3188224941, $13.70+$1.30 USD Hold'em No Limit - Level IX (200/400) - 2021/05/07 0:07:32 MSK [2021/05/06 17:07:32 ET]
Table '3188224941 2' 9-max Seat #9 is the button
Seat 3: dimetruk (16722 in chips)
Seat 8: tonibosi29 (3033 in chips)
Seat 9: kurtaro (7245 in chips)
dimetruk: posts the ante 25
tonibosi29: posts the ante 25
kurtaro: posts the ante 25
dimetruk: posts small blind 200
tonibosi29: posts big blind 400
*** HOLE CARDS ***
Dealt to dimetruk [5c 4d]
kurtaro: folds
dimetruk: calls 200
tonibosi29: checks
*** FLOP *** [Ts Ac 5d]
dimetruk: bets 400
tonibosi29: raises 400 to 800
dimetruk: calls 400
*** TURN *** [Ts Ac 5d] [3c]
dimetruk: bets 1856
tonibosi29: folds
Uncalled bet (1856) returned to dimetruk
dimetruk collected 2475 from pot
dimetruk: doesn't show hand
*** SUMMARY ***
Total pot 2475 | Rake 0
Board [Ts Ac 5d 3c]
Seat 3: dimetruk (small blind) collected (2475)
Seat 8: tonibosi29 (big blind) folded on the Turn
Seat 9: kurtaro (button) folded before Flop (didn't bet)


PokerStars Hand #226522247744: Tournament #3188224941, $13.70+$1.30 USD Hold'em No Limit - Level IX (200/400) - 2021/05/07 0:07:57 MSK [2021/05/06 17:07:57 ET]
Table '3188224941 2' 9-max Seat #8 is the button
Seat 3: dimetruk (17947 in chips)
Seat 8: tonibosi29 (1583 in chips)
Seat 9: kurtaro (7470 in chips)
dimetruk: posts the ante 25
tonibosi29: posts the ante 25
kurtaro: posts the ante 25
kurtaro: posts small blind 200
dimetruk: posts big blind 400
*** HOLE CARDS ***
Dealt to dimetruk [4h 8s]
tonibosi29: folds
kurtaro: calls 200
dimetruk: checks
*** FLOP *** [3h Th 4s]
kurtaro: checks
dimetruk: bets 400
kurtaro: calls 400
*** TURN *** [3h Th 4s] [5c]
kurtaro: checks
dimetruk: bets 800
kurtaro: folds
Uncalled bet (800) returned to dimetruk
dimetruk collected 1675 from pot
dimetruk: doesn't show hand
*** SUMMARY ***
Total pot 1675 | Rake 0
Board [3h Th 4s 5c]
Seat 3: dimetruk (big blind) collected (1675)
Seat 8: tonibosi29 (button) folded before Flop (didn't bet)
Seat 9: kurtaro (small blind) folded on the Turn


PokerStars Hand #226522321389: Tournament #3188224941, $13.70+$1.30 USD Hold'em No Limit - Level IX (200/400) - 2021/05/07 0:09:43 MSK [2021/05/06 17:09:43 ET]
Table '3188224941 2' 9-max Seat #8 is the button
Seat 3: dimetruk (19222 in chips)
Seat 8: tonibosi29 (2258 in chips)
Seat 9: kurtaro (5520 in chips)
dimetruk: posts the ante 25
tonibosi29: posts the ante 25
kurtaro: posts the ante 25
kurtaro: posts small blind 200
dimetruk: posts big blind 400
*** HOLE CARDS ***
Dealt to dimetruk [Ks 9c]
tonibosi29: folds
kurtaro: calls 200
dimetruk: checks
*** FLOP *** [Jd Ac 6h]
kurtaro: checks
dimetruk: checks
*** TURN *** [Jd Ac 6h] [Qd]
kurtaro: bets 400
dimetruk: calls 400
*** RIVER *** [Jd Ac 6h Qd] [As]
kurtaro: checks
dimetruk: bets 800
kurtaro: calls 800
*** SHOW DOWN ***
dimetruk: shows [Ks 9c] (a pair of Aces)
kurtaro: shows [Th Qh] (two pair, Aces and Queens)
kurtaro collected 3275 from pot
*** SUMMARY ***
Total pot 3275 | Rake 0
Board [Jd Ac 6h Qd As]
Seat 3: dimetruk (big blind) showed [Ks 9c] and lost with a pair of Aces
Seat 8: tonibosi29 (button) folded before Flop (didn't bet)
Seat 9: kurtaro (small blind) showed [Th Qh] and won (3275) with two pair, Aces and Queens


PokerStars Hand #226522361284: Tournament #3188224941, $13.70+$1.30 USD Hold'em No Limit - Level IX (200/400) - 2021/05/07 0:10:46 MSK [2021/05/06 17:10:46 ET]
Table '3188224941 2' 9-max Seat #9 is the button
Seat 3: dimetruk (18947 in chips)
Seat 8: tonibosi29 (1558 in chips)
Seat 9: kurtaro (6495 in chips)
dimetruk: posts the ante 25
tonibosi29: posts the ante 25
kurtaro: posts the ante 25
dimetruk: posts small blind 200
tonibosi29: posts big blind 400
*** HOLE CARDS ***
Dealt to dimetruk [7s 8s]
kurtaro: folds
dimetruk: raises 18522 to 18922 and is all-in
tonibosi29: calls 1133 and is all-in
Uncalled bet (17389) returned to dimetruk
*** FLOP *** [Jd 3c As]
*** TURN *** [Jd 3c As] [9c]
*** RIVER *** [Jd 3c As 9c] [Jh]
*** SHOW DOWN ***
dimetruk: shows [7s 8s] (a pair of Jacks)
tonibosi29: shows [7c 6s] (a pair of Jacks - lower kicker)
dimetruk collected 3141 from pot
tonibosi29 finished the tournament in 3rd place and received $49.32.
*** SUMMARY ***
Total pot 3141 | Rake 0
Board [Jd 3c As 9c Jh]
Seat 3: dimetruk (small blind) showed [7s 8s] and won (3141) with a pair of Jacks
Seat 8: tonibosi29 (big blind) showed [7c 6s] and lost with a pair of Jacks
Seat 9: kurtaro (button) folded before Flop (didn't bet)


PokerStars Hand #226522381520: Tournament #3188224941, $13.70+$1.30 USD Hold'em No Limit - Level IX (200/400) - 2021/05/07 0:11:17 MSK [2021/05/06 17:11:17 ET]
Table '3188224941 2' 9-max Seat #3 is the button
Seat 3: dimetruk (20330 in chips)
Seat 9: kurtaro (6670 in chips)
dimetruk: posts the ante 25
kurtaro: posts the ante 25
dimetruk: posts small blind 200
kurtaro: posts big blind 400
*** HOLE CARDS ***
Dealt to dimetruk [4s 2h]
dimetruk: raises 400 to 800
kurtaro: calls 400
*** FLOP *** [Kc 8h Kd]
kurtaro: checks
dimetruk: bets 545
kurtaro: folds
Uncalled bet (545) returned to dimetruk
dimetruk collected 1650 from pot
dimetruk: doesn't show hand
*** SUMMARY ***
Total pot 1650 | Rake 0
Board [Kc 8h Kd]
Seat 3: dimetruk (button) (small blind) collected (1650)
Seat 9: kurtaro (big blind) folded on the Flop


PokerStars Hand #226522387560: Tournament #3188224941, $13.70+$1.30 USD Hold'em No Limit - Level IX (200/400) - 2021/05/07 0:11:27 MSK [2021/05/06 17:11:27 ET]
Table '3188224941 2' 9-max Seat #9 is the button
Seat 3: dimetruk (21155 in chips)
Seat 9: kurtaro (5845 in chips)
dimetruk: posts the ante 25
kurtaro: posts the ante 25
kurtaro: posts small blind 200
dimetruk: posts big blind 400
*** HOLE CARDS ***
Dealt to dimetruk [Kd 7s]
kurtaro: calls 200
dimetruk: checks
*** FLOP *** [3h 4c Th]
dimetruk: checks
kurtaro: checks
*** TURN *** [3h 4c Th] [2c]
dimetruk: checks
kurtaro: checks
*** RIVER *** [3h 4c Th 2c] [As]
dimetruk: bets 600
kurtaro: folds
Uncalled bet (600) returned to dimetruk
dimetruk collected 850 from pot
dimetruk: doesn't show hand
*** SUMMARY ***
Total pot 850 | Rake 0
Board [3h 4c Th 2c As]
Seat 3: dimetruk (big blind) collected (850)
Seat 9: kurtaro (button) (small blind) folded on the River


PokerStars Hand #226522402637: Tournament #3188224941, $13.70+$1.30 USD Hold'em No Limit - Level IX (200/400) - 2021/05/07 0:11:50 MSK [2021/05/06 17:11:50 ET]
Table '3188224941 2' 9-max Seat #3 is the button
Seat 3: dimetruk (21580 in chips)
Seat 9: kurtaro (5420 in chips)
dimetruk: posts the ante 25
kurtaro: posts the ante 25
dimetruk: posts small blind 200
kurtaro: posts big blind 400
*** HOLE CARDS ***
Dealt to dimetruk [Qs 6c]
dimetruk: raises 400 to 800
kurtaro: calls 400
*** FLOP *** [Jh 4s Kd]
kurtaro: checks
dimetruk: bets 545
kurtaro: folds
Uncalled bet (545) returned to dimetruk
dimetruk collected 1650 from pot
dimetruk: doesn't show hand
*** SUMMARY ***
Total pot 1650 | Rake 0
Board [Jh 4s Kd]
Seat 3: dimetruk (button) (small blind) collected (1650)
Seat 9: kurtaro (big blind) folded on the Flop


PokerStars Hand #226522423121: Tournament #3188224941, $13.70+$1.30 USD Hold'em No Limit - Level IX (200/400) - 2021/05/07 0:12:23 MSK [2021/05/06 17:12:23 ET]
Table '3188224941 2' 9-max Seat #9 is the button
Seat 3: dimetruk (22405 in chips)
Seat 9: kurtaro (4595 in chips)
dimetruk: posts the ante 25
kurtaro: posts the ante 25
kurtaro: posts small blind 200
dimetruk: posts big blind 400
*** HOLE CARDS ***
Dealt to dimetruk [Th 6h]
kurtaro: calls 200
dimetruk: checks
*** FLOP *** [Ts 5h 6d]
dimetruk: checks
kurtaro: bets 400
dimetruk: raises 400 to 800
kurtaro: calls 400
*** TURN *** [Ts 5h 6d] [Ah]
dimetruk: bets 1838
kurtaro: calls 1838
*** RIVER *** [Ts 5h 6d Ah] [8s]
dimetruk: bets 3369
kurtaro: calls 1532 and is all-in
Uncalled bet (1837) returned to dimetruk
*** SHOW DOWN ***
dimetruk: shows [Th 6h] (two pair, Tens and Sixes)
kurtaro: shows [7h 9h] (a straight, Six to Ten)
kurtaro collected 9190 from pot
*** SUMMARY ***
Total pot 9190 | Rake 0
Board [Ts 5h 6d Ah 8s]
Seat 3: dimetruk (big blind) showed [Th 6h] and lost with two pair, Tens and Sixes
Seat 9: kurtaro (button) (small blind) showed [7h 9h] and won (9190) with a straight, Six to Ten


PokerStars Hand #226522442060: Tournament #3188224941, $13.70+$1.30 USD Hold'em No Limit - Level IX (200/400) - 2021/05/07 0:12:53 MSK [2021/05/06 17:12:53 ET]
Table '3188224941 2' 9-max Seat #3 is the button
Seat 3: dimetruk (17810 in chips)
Seat 9: kurtaro (9190 in chips)
dimetruk: posts the ante 25
kurtaro: posts the ante 25
dimetruk: posts small blind 200
kurtaro: posts big blind 400
*** HOLE CARDS ***
Dealt to dimetruk [Kh 4c]
dimetruk: raises 400 to 800
kurtaro: calls 400
*** FLOP *** [2c 5h Qh]
kurtaro: checks
dimetruk: checks
*** TURN *** [2c 5h Qh] [9d]
kurtaro: bets 400
dimetruk: folds
Uncalled bet (400) returned to kurtaro
kurtaro collected 1650 from pot
kurtaro: doesn't show hand
*** SUMMARY ***
Total pot 1650 | Rake 0
Board [2c 5h Qh 9d]
Seat 3: dimetruk (button) (small blind) folded on the Turn
Seat 9: kurtaro (big blind) collected (1650)


PokerStars Hand #226522449500: Tournament #3188224941, $13.70+$1.30 USD Hold'em No Limit - Level IX (200/400) - 2021/05/07 0:13:04 MSK [2021/05/06 17:13:04 ET]
Table '3188224941 2' 9-max Seat #9 is the button
Seat 3: dimetruk (16985 in chips)
Seat 9: kurtaro (10015 in chips)
dimetruk: posts the ante 25
kurtaro: posts the ante 25
kurtaro: posts small blind 200
dimetruk: posts big blind 400
*** HOLE CARDS ***
Dealt to dimetruk [7s 7d]
kurtaro: calls 200
dimetruk: checks
*** FLOP *** [Ac 2d Kh]
dimetruk: checks
kurtaro: checks
*** TURN *** [Ac 2d Kh] [8h]
dimetruk: bets 400
kurtaro: raises 400 to 800
dimetruk: calls 400
*** RIVER *** [Ac 2d Kh 8h] [6c]
dimetruk: checks
kurtaro: bets 800
dimetruk: calls 800
*** SHOW DOWN ***
kurtaro: shows [As Ad] (three of a kind, Aces)
dimetruk: mucks hand
kurtaro collected 4050 from pot
*** SUMMARY ***
Total pot 4050 | Rake 0
Board [Ac 2d Kh 8h 6c]
Seat 3: dimetruk (big blind) mucked [7s 7d]
Seat 9: kurtaro (button) (small blind) showed [As Ad] and won (4050) with three of a kind, Aces


PokerStars Hand #226522477577: Tournament #3188224941, $13.70+$1.30 USD Hold'em No Limit - Level IX (200/400) - 2021/05/07 0:13:48 MSK [2021/05/06 17:13:48 ET]
Table '3188224941 2' 9-max Seat #9 is the button
Seat 3: dimetruk (15135 in chips)
Seat 9: kurtaro (11865 in chips)
dimetruk: posts the ante 25
kurtaro: posts the ante 25
kurtaro: posts small blind 200
dimetruk: posts big blind 400
*** HOLE CARDS ***
Dealt to dimetruk [Td Ks]
kurtaro: raises 400 to 800
dimetruk: calls 400
*** FLOP *** [2h 9c 9s]
dimetruk: checks
kurtaro: checks
*** TURN *** [2h 9c 9s] [4c]
dimetruk: bets 545
kurtaro: calls 545
*** RIVER *** [2h 9c 9s 4c] [7c]
dimetruk: bets 1507
kurtaro: calls 1507
*** SHOW DOWN ***
dimetruk: shows [Td Ks] (a pair of Nines)
kurtaro: shows [Jd 9d] (three of a kind, Nines)
kurtaro collected 5754 from pot
*** SUMMARY ***
Total pot 5754 | Rake 0
Board [2h 9c 9s 4c 7c]
Seat 3: dimetruk (big blind) showed [Td Ks] and lost with a pair of Nines
Seat 9: kurtaro (button) (small blind) showed [Jd 9d] and won (5754) with three of a kind, Nines


PokerStars Hand #226522494456: Tournament #3188224941, $13.70+$1.30 USD Hold'em No Limit - Level X (300/600) - 2021/05/07 0:14:15 MSK [2021/05/06 17:14:15 ET]
Table '3188224941 2' 9-max Seat #3 is the button
Seat 3: dimetruk (13258 in chips)
Seat 9: kurtaro (13742 in chips)
dimetruk: posts the ante 50
kurtaro: posts the ante 50
dimetruk: posts small blind 300
kurtaro: posts big blind 600
*** HOLE CARDS ***
Dealt to dimetruk [Th 3s]
dimetruk: raises 600 to 1200
kurtaro: calls 600
*** FLOP *** [5h Ts 3c]
kurtaro: checks
dimetruk: bets 825
kurtaro: raises 1395 to 2220
dimetruk: raises 9788 to 12008 and is all-in
kurtaro: folds
Uncalled bet (9788) returned to dimetruk
dimetruk collected 6940 from pot
dimetruk: doesn't show hand
*** SUMMARY ***
Total pot 6940 | Rake 0
Board [5h Ts 3c]
Seat 3: dimetruk (button) (small blind) collected (6940)
Seat 9: kurtaro (big blind) folded on the Flop


PokerStars Hand #226522510079: Tournament #3188224941, $13.70+$1.30 USD Hold'em No Limit - Level X (300/600) - 2021/05/07 0:14:40 MSK [2021/05/06 17:14:40 ET]
Table '3188224941 2' 9-max Seat #9 is the button
Seat 3: dimetruk (17728 in chips)
Seat 9: kurtaro (9272 in chips)
dimetruk: posts the ante 50
kurtaro: posts the ante 50
kurtaro: posts small blind 300
dimetruk: posts big blind 600
*** HOLE CARDS ***
Dealt to dimetruk [9d Kc]
kurtaro: calls 300
dimetruk: checks
*** FLOP *** [4d 3h 4c]
dimetruk: checks
kurtaro: bets 600
dimetruk: folds
Uncalled bet (600) returned to kurtaro
kurtaro collected 1300 from pot
kurtaro: doesn't show hand
*** SUMMARY ***
Total pot 1300 | Rake 0
Board [4d 3h 4c]
Seat 3: dimetruk (big blind) folded on the Flop
Seat 9: kurtaro (button) (small blind) collected (1300)


PokerStars Hand #226522516353: Tournament #3188224941, $13.70+$1.30 USD Hold'em No Limit - Level X (300/600) - 2021/05/07 0:14:50 MSK [2021/05/06 17:14:50 ET]
Table '3188224941 2' 9-max Seat #3 is the button
Seat 3: dimetruk (17078 in chips)
Seat 9: kurtaro (9922 in chips)
dimetruk: posts the ante 50
kurtaro: posts the ante 50
dimetruk: posts small blind 300
kurtaro: posts big blind 600
*** HOLE CARDS ***
Dealt to dimetruk [3c Js]
dimetruk: raises 600 to 1200
kurtaro: calls 600
*** FLOP *** [Ah 3h Tc]
kurtaro: checks
dimetruk: checks
*** TURN *** [Ah 3h Tc] [4d]
kurtaro: checks
dimetruk: bets 825
kurtaro: calls 825
*** RIVER *** [Ah 3h Tc 4d] [7d]
kurtaro: checks
dimetruk: checks
*** SHOW DOWN ***
kurtaro: shows [Jc 8h] (high card Ace)
dimetruk: shows [3c Js] (a pair of Threes)
dimetruk collected 4150 from pot
*** SUMMARY ***
Total pot 4150 | Rake 0
Board [Ah 3h Tc 4d 7d]
Seat 3: dimetruk (button) (small blind) showed [3c Js] and won (4150) with a pair of Threes
Seat 9: kurtaro (big blind) showed [Jc 8h] and lost with high card Ace


PokerStars Hand #226522533206: Tournament #3188224941, $13.70+$1.30 USD Hold'em No Limit - Level X (300/600) - 2021/05/07 0:15:16 MSK [2021/05/06 17:15:16 ET]
Table '3188224941 2' 9-max Seat #9 is the button
Seat 3: dimetruk (18553 in chips)
Seat 9: kurtaro (8447 in chips)
dimetruk: posts the ante 50
kurtaro: posts the ante 50
kurtaro: posts small blind 300
dimetruk: posts big blind 600
*** HOLE CARDS ***
Dealt to dimetruk [5s 4c]
kurtaro: calls 300
dimetruk: checks
*** FLOP *** [8c 2d Ad]
dimetruk: checks
kurtaro: bets 600
dimetruk: calls 600
*** TURN *** [8c 2d Ad] [As]
dimetruk: checks
kurtaro: bets 1200
dimetruk: folds
Uncalled bet (1200) returned to kurtaro
kurtaro collected 2500 from pot
kurtaro: doesn't show hand
*** SUMMARY ***
Total pot 2500 | Rake 0
Board [8c 2d Ad As]
Seat 3: dimetruk (big blind) folded on the Turn
Seat 9: kurtaro (button) (small blind) collected (2500)


PokerStars Hand #226522550849: Tournament #3188224941, $13.70+$1.30 USD Hold'em No Limit - Level X (300/600) - 2021/05/07 0:15:44 MSK [2021/05/06 17:15:44 ET]
Table '3188224941 2' 9-max Seat #9 is the button
Seat 3: dimetruk (17053 in chips)
Seat 9: kurtaro (9947 in chips)
dimetruk: posts the ante 50
kurtaro: posts the ante 50
kurtaro: posts small blind 300
dimetruk: posts big blind 600
*** HOLE CARDS ***
Dealt to dimetruk [Qd 8d]
kurtaro: raises 600 to 1200
dimetruk: calls 600
*** FLOP *** [Ah Jh 7d]
dimetruk: checks
kurtaro: bets 600
dimetruk: folds
Uncalled bet (600) returned to kurtaro
kurtaro collected 2500 from pot
kurtaro: doesn't show hand
*** SUMMARY ***
Total pot 2500 | Rake 0
Board [Ah Jh 7d]
Seat 3: dimetruk (big blind) folded on the Flop
Seat 9: kurtaro (button) (small blind) collected (2500)


PokerStars Hand #226522560483: Tournament #3188224941, $13.70+$1.30 USD Hold'em No Limit - Level X (300/600) - 2021/05/07 0:16:00 MSK [2021/05/06 17:16:00 ET]
Table '3188224941 2' 9-max Seat #9 is the button
Seat 3: dimetruk (16453 in chips)
Seat 9: kurtaro (10547 in chips)
dimetruk: posts the ante 50
kurtaro: posts the ante 50
kurtaro: posts small blind 300
dimetruk: posts big blind 600
*** HOLE CARDS ***
Dealt to dimetruk [Ad Ac]
kurtaro: raises 600 to 1200
dimetruk: calls 600
*** FLOP *** [4d 8s Ks]
dimetruk: checks
kurtaro: checks
*** TURN *** [4d 8s Ks] [6s]
dimetruk: bets 1200
kurtaro: folds
Uncalled bet (1200) returned to dimetruk
dimetruk collected 2500 from pot
dimetruk: doesn't show hand
*** SUMMARY ***
Total pot 2500 | Rake 0
Board [4d 8s Ks 6s]
Seat 3: dimetruk (big blind) collected (2500)
Seat 9: kurtaro (button) (small blind) folded on the Turn


PokerStars Hand #226522574057: Tournament #3188224941, $13.70+$1.30 USD Hold'em No Limit - Level X (300/600) - 2021/05/07 0:16:21 MSK [2021/05/06 17:16:21 ET]
Table '3188224941 2' 9-max Seat #3 is the button
Seat 3: dimetruk (16803 in chips)
Seat 9: kurtaro (10197 in chips)
dimetruk: posts the ante 50
kurtaro: posts the ante 50
dimetruk: posts small blind 300
kurtaro: posts big blind 600
*** HOLE CARDS ***
Dealt to dimetruk [Th Tc]
dimetruk: raises 600 to 1200
kurtaro: calls 600
*** FLOP *** [8c 6s 2c]
kurtaro: checks
dimetruk: bets 1125
kurtaro: folds
Uncalled bet (1125) returned to dimetruk
dimetruk collected 2500 from pot
dimetruk: doesn't show hand
*** SUMMARY ***
Total pot 2500 | Rake 0
Board [8c 6s 2c]
Seat 3: dimetruk (button) (small blind) collected (2500)
Seat 9: kurtaro (big blind) folded on the Flop


PokerStars Hand #226522579815: Tournament #3188224941, $13.70+$1.30 USD Hold'em No Limit - Level X (300/600) - 2021/05/07 0:16:30 MSK [2021/05/06 17:16:30 ET]
Table '3188224941 2' 9-max Seat #9 is the button
Seat 3: dimetruk (18053 in chips)
Seat 9: kurtaro (8947 in chips)
dimetruk: posts the ante 50
kurtaro: posts the ante 50
kurtaro: posts small blind 300
dimetruk: posts big blind 600
*** HOLE CARDS ***
Dealt to dimetruk [2d 5s]
kurtaro: calls 300
dimetruk: checks
*** FLOP *** [As 3h 2c]
dimetruk: checks
kurtaro: bets 1200
dimetruk: calls 1200
*** TURN *** [As 3h 2c] [7c]
dimetruk: checks
kurtaro: checks
*** RIVER *** [As 3h 2c 7c] [Qh]
dimetruk: checks
kurtaro: checks
*** SHOW DOWN ***
dimetruk: shows [2d 5s] (a pair of Deuces)
kurtaro: shows [3s 4s] (a pair of Threes)
kurtaro collected 3700 from pot
*** SUMMARY ***
Total pot 3700 | Rake 0
Board [As 3h 2c 7c Qh]
Seat 3: dimetruk (big blind) showed [2d 5s] and lost with a pair of Deuces
Seat 9: kurtaro (button) (small blind) showed [3s 4s] and won (3700) with a pair of Threes


PokerStars Hand #226522594632: Tournament #3188224941, $13.70+$1.30 USD Hold'em No Limit - Level X (300/600) - 2021/05/07 0:16:54 MSK [2021/05/06 17:16:54 ET]
Table '3188224941 2' 9-max Seat #9 is the button
Seat 3: dimetruk (14953 in chips)
Seat 9: kurtaro (12047 in chips)
dimetruk: posts the ante 50
kurtaro: posts the ante 50
kurtaro: posts small blind 300
dimetruk: posts big blind 600
*** HOLE CARDS ***
Dealt to dimetruk [7d 8c]
kurtaro: calls 300
dimetruk: checks
*** FLOP *** [Ah Qh 3d]
dimetruk: checks
kurtaro: bets 600
dimetruk: folds
Uncalled bet (600) returned to kurtaro
kurtaro collected 1300 from pot
kurtaro: doesn't show hand
*** SUMMARY ***
Total pot 1300 | Rake 0
Board [Ah Qh 3d]
Seat 3: dimetruk (big blind) folded on the Flop
Seat 9: kurtaro (button) (small blind) collected (1300)


PokerStars Hand #226522602238: Tournament #3188224941, $13.70+$1.30 USD Hold'em No Limit - Level X (300/600) - 2021/05/07 0:17:06 MSK [2021/05/06 17:17:06 ET]
Table '3188224941 2' 9-max Seat #3 is the button
Seat 3: dimetruk (14303 in chips)
Seat 9: kurtaro (12697 in chips)
dimetruk: posts the ante 50
kurtaro: posts the ante 50
dimetruk: posts small blind 300
kurtaro: posts big blind 600
*** HOLE CARDS ***
Dealt to dimetruk [As 4c]
dimetruk: raises 600 to 1200
kurtaro: raises 1200 to 2400
dimetruk: calls 1200
*** FLOP *** [2h 3h Qs]
kurtaro: bets 1800
dimetruk: calls 1800
*** TURN *** [2h 3h Qs] [8d]
kurtaro: checks
dimetruk: bets 2400
kurtaro: folds
Uncalled bet (2400) returned to dimetruk
dimetruk collected 8500 from pot
dimetruk: doesn't show hand
*** SUMMARY ***
Total pot 8500 | Rake 0
Board [2h 3h Qs 8d]
Seat 3: dimetruk (button) (small blind) collected (8500)
Seat 9: kurtaro (big blind) folded on the Turn


PokerStars Hand #226522624568: Tournament #3188224941, $13.70+$1.30 USD Hold'em No Limit - Level X (300/600) - 2021/05/07 0:17:42 MSK [2021/05/06 17:17:42 ET]
Table '3188224941 2' 9-max Seat #9 is the button
Seat 3: dimetruk (18553 in chips)
Seat 9: kurtaro (8447 in chips)
dimetruk: posts the ante 50
kurtaro: posts the ante 50
kurtaro: posts small blind 300
dimetruk: posts big blind 600
*** HOLE CARDS ***
Dealt to dimetruk [Ah 6c]
kurtaro: raises 600 to 1200
dimetruk: calls 600
*** FLOP *** [9d 2c Ts]
dimetruk: checks
kurtaro: bets 600
dimetruk: folds
Uncalled bet (600) returned to kurtaro
kurtaro collected 2500 from pot
kurtaro: doesn't show hand
*** SUMMARY ***
Total pot 2500 | Rake 0
Board [9d 2c Ts]
Seat 3: dimetruk (big blind) folded on the Flop
Seat 9: kurtaro (button) (small blind) collected (2500)


PokerStars Hand #226522632972: Tournament #3188224941, $13.70+$1.30 USD Hold'em No Limit - Level X (300/600) - 2021/05/07 0:17:56 MSK [2021/05/06 17:17:56 ET]
Table '3188224941 2' 9-max Seat #3 is the button
Seat 3: dimetruk (17303 in chips)
Seat 9: kurtaro (9697 in chips)
dimetruk: posts the ante 50
kurtaro: posts the ante 50
dimetruk: posts small blind 300
kurtaro: posts big blind 600
*** HOLE CARDS ***
Dealt to dimetruk [3c 6c]
dimetruk: calls 300
kurtaro: checks
*** FLOP *** [Kc Ks 7h]
kurtaro: checks
dimetruk: bets 600
kurtaro: calls 600
*** TURN *** [Kc Ks 7h] [9s]
kurtaro: checks
dimetruk: checks
*** RIVER *** [Kc Ks 7h 9s] [8s]
kurtaro: checks
dimetruk: checks
*** SHOW DOWN ***
kurtaro: shows [Ts Qd] (a pair of Kings)
dimetruk: mucks hand
kurtaro collected 2500 from pot
*** SUMMARY ***
Total pot 2500 | Rake 0
Board [Kc Ks 7h 9s 8s]
Seat 3: dimetruk (button) (small blind) mucked [3c 6c]
Seat 9: kurtaro (big blind) showed [Ts Qd] and won (2500) with a pair of Kings


PokerStars Hand #226522645074: Tournament #3188224941, $13.70+$1.30 USD Hold'em No Limit - Level X (300/600) - 2021/05/07 0:18:15 MSK [2021/05/06 17:18:15 ET]
Table '3188224941 2' 9-max Seat #9 is the button
Seat 3: dimetruk (16053 in chips)
Seat 9: kurtaro (10947 in chips)
dimetruk: posts the ante 50
kurtaro: posts the ante 50
kurtaro: posts small blind 300
dimetruk: posts big blind 600
*** HOLE CARDS ***
Dealt to dimetruk [2d 4d]
kurtaro: raises 600 to 1200
dimetruk: calls 600
*** FLOP *** [7h Ks Tc]
dimetruk: checks
kurtaro: bets 600
dimetruk: folds
Uncalled bet (600) returned to kurtaro
kurtaro collected 2500 from pot
kurtaro: doesn't show hand
*** SUMMARY ***
Total pot 2500 | Rake 0
Board [7h Ks Tc]
Seat 3: dimetruk (big blind) folded on the Flop
Seat 9: kurtaro (button) (small blind) collected (2500)


PokerStars Hand #226522656919: Tournament #3188224941, $13.70+$1.30 USD Hold'em No Limit - Level X (300/600) - 2021/05/07 0:18:34 MSK [2021/05/06 17:18:34 ET]
Table '3188224941 2' 9-max Seat #3 is the button
Seat 3: dimetruk (14803 in chips)
Seat 9: kurtaro (12197 in chips)
dimetruk: posts the ante 50
kurtaro: posts the ante 50
dimetruk: posts small blind 300
kurtaro: posts big blind 600
*** HOLE CARDS ***
Dealt to dimetruk [Kh Ad]
dimetruk: raises 600 to 1200
kurtaro: calls 600
*** FLOP *** [4h Ac 6s]
kurtaro: checks
dimetruk: bets 825
kurtaro: calls 825
*** TURN *** [4h Ac 6s] [Ah]
kurtaro: bets 1500
dimetruk: calls 1500
*** RIVER *** [4h Ac 6s Ah] [4d]
kurtaro: checks
dimetruk: bets 2360
kurtaro: folds
Uncalled bet (2360) returned to dimetruk
dimetruk collected 7150 from pot
dimetruk: doesn't show hand
*** SUMMARY ***
Total pot 7150 | Rake 0
Board [4h Ac 6s Ah 4d]
Seat 3: dimetruk (button) (small blind) collected (7150)
Seat 9: kurtaro (big blind) folded on the River


PokerStars Hand #226522676035: Tournament #3188224941, $13.70+$1.30 USD Hold'em No Limit - Level X (300/600) - 2021/05/07 0:19:05 MSK [2021/05/06 17:19:05 ET]
Table '3188224941 2' 9-max Seat #3 is the button
Seat 3: dimetruk (18728 in chips)
Seat 9: kurtaro (8272 in chips)
dimetruk: posts the ante 50
kurtaro: posts the ante 50
dimetruk: posts small blind 300
kurtaro: posts big blind 600
*** HOLE CARDS ***
Dealt to dimetruk [Ts 9c]
dimetruk: raises 600 to 1200
kurtaro: calls 600
*** FLOP *** [3c Qc 6s]
kurtaro: checks
dimetruk: checks
*** TURN *** [3c Qc 6s] [7s]
kurtaro: bets 600
dimetruk: calls 600
*** RIVER *** [3c Qc 6s 7s] [2s]
kurtaro: checks
dimetruk: checks
*** SHOW DOWN ***
kurtaro: shows [6d 9h] (a pair of Sixes)
dimetruk: mucks hand
kurtaro collected 3700 from pot
*** SUMMARY ***
Total pot 3700 | Rake 0
Board [3c Qc 6s 7s 2s]
Seat 3: dimetruk (button) (small blind) mucked [Ts 9c]
Seat 9: kurtaro (big blind) showed [6d 9h] and won (3700) with a pair of Sixes


PokerStars Hand #226522686181: Tournament #3188224941, $13.70+$1.30 USD Hold'em No Limit - Level X (300/600) - 2021/05/07 0:19:21 MSK [2021/05/06 17:19:21 ET]
Table '3188224941 2' 9-max Seat #3 is the button
Seat 3: dimetruk (17228 in chips)
Seat 9: kurtaro (9772 in chips)
dimetruk: posts the ante 50
kurtaro: posts the ante 50
dimetruk: posts small blind 300
kurtaro: posts big blind 600
*** HOLE CARDS ***
Dealt to dimetruk [4c 4h]
dimetruk: raises 16578 to 17178 and is all-in
kurtaro: calls 9122 and is all-in
Uncalled bet (7456) returned to dimetruk
*** FLOP *** [Ac As Qh]
*** TURN *** [Ac As Qh] [9d]
*** RIVER *** [Ac As Qh 9d] [8s]
*** SHOW DOWN ***
kurtaro: shows [Td Th] (two pair, Aces and Tens)
dimetruk: shows [4c 4h] (two pair, Aces and Fours)
kurtaro collected 19544 from pot
*** SUMMARY ***
Total pot 19544 | Rake 0
Board [Ac As Qh 9d 8s]
Seat 3: dimetruk (button) (small blind) showed [4c 4h] and lost with two pair, Aces and Fours
Seat 9: kurtaro (big blind) showed [Td Th] and won (19544) with two pair, Aces and Tens


PokerStars Hand #226522709027: Tournament #3188224941, $13.70+$1.30 USD Hold'em No Limit - Level X (300/600) - 2021/05/07 0:19:59 MSK [2021/05/06 17:19:59 ET]
Table '3188224941 2' 9-max Seat #9 is the button
Seat 3: dimetruk (7356 in chips)
Seat 9: kurtaro (19644 in chips)
dimetruk: posts the ante 50
kurtaro: posts the ante 50
kurtaro: posts small blind 300
dimetruk: posts big blind 600
*** HOLE CARDS ***
Dealt to dimetruk [7h 4h]
kurtaro: raises 600 to 1200
dimetruk: calls 600
*** FLOP *** [3d Jh 8d]
dimetruk: checks
kurtaro: bets 840
dimetruk: folds
Uncalled bet (840) returned to kurtaro
kurtaro collected 2500 from pot
kurtaro: doesn't show hand
*** SUMMARY ***
Total pot 2500 | Rake 0
Board [3d Jh 8d]
Seat 3: dimetruk (big blind) folded on the Flop
Seat 9: kurtaro (button) (small blind) collected (2500)


PokerStars Hand #226522718036: Tournament #3188224941, $13.70+$1.30 USD Hold'em No Limit - Level X (300/600) - 2021/05/07 0:20:13 MSK [2021/05/06 17:20:13 ET]
Table '3188224941 2' 9-max Seat #9 is the button
Seat 3: dimetruk (6756 in chips)
Seat 9: kurtaro (20244 in chips)
dimetruk: posts the ante 50
kurtaro: posts the ante 50
kurtaro: posts small blind 300
dimetruk: posts big blind 600
*** HOLE CARDS ***
Dealt to dimetruk [9c 5d]
kurtaro: calls 300
dimetruk: checks
*** FLOP *** [5h 9h 5s]
dimetruk: checks
kurtaro: bets 600
dimetruk: calls 600
*** TURN *** [5h 9h 5s] [8c]
dimetruk: checks
kurtaro: bets 1200
dimetruk: calls 1200
*** RIVER *** [5h 9h 5s 8c] [Qh]
dimetruk: bets 4306 and is all-in
kurtaro: folds
Uncalled bet (4306) returned to dimetruk
dimetruk collected 4900 from pot
dimetruk: doesn't show hand
*** SUMMARY ***
Total pot 4900 | Rake 0
Board [5h 9h 5s 8c Qh]
Seat 3: dimetruk (big blind) collected (4900)
Seat 9: kurtaro (button) (small blind) folded on the River


PokerStars Hand #226522731034: Tournament #3188224941, $13.70+$1.30 USD Hold'em No Limit - Level X (300/600) - 2021/05/07 0:20:35 MSK [2021/05/06 17:20:35 ET]
Table '3188224941 2' 9-max Seat #3 is the button
Seat 3: dimetruk (9206 in chips)
Seat 9: kurtaro (17794 in chips)
dimetruk: posts the ante 50
kurtaro: posts the ante 50
dimetruk: posts small blind 300
kurtaro: posts big blind 600
*** HOLE CARDS ***
Dealt to dimetruk [7s 8h]
dimetruk: calls 300
kurtaro: checks
*** FLOP *** [9d 3s 2s]
kurtaro: checks
dimetruk: bets 600
kurtaro: folds
Uncalled bet (600) returned to dimetruk
dimetruk collected 1300 from pot
dimetruk: doesn't show hand
*** SUMMARY ***
Total pot 1300 | Rake 0
Board [9d 3s 2s]
Seat 3: dimetruk (button) (small blind) collected (1300)
Seat 9: kurtaro (big blind) folded on the Flop


PokerStars Hand #226522748669: Tournament #3188224941, $13.70+$1.30 USD Hold'em No Limit - Level X (300/600) - 2021/05/07 0:21:04 MSK [2021/05/06 17:21:04 ET]
Table '3188224941 2' 9-max Seat #9 is the button
Seat 3: dimetruk (7556 in chips)
Seat 9: kurtaro (19444 in chips)
dimetruk: posts the ante 50
kurtaro: posts the ante 50
kurtaro: posts small blind 300
dimetruk: posts big blind 600
*** HOLE CARDS ***
Dealt to dimetruk [Td Ts]
kurtaro: raises 600 to 1200
dimetruk: raises 6306 to 7506 and is all-in
kurtaro: calls 6306
*** FLOP *** [Tc Jc Ad]
*** TURN *** [Tc Jc Ad] [9c]
*** RIVER *** [Tc Jc Ad 9c] [Kc]
*** SHOW DOWN ***
dimetruk: shows [Td Ts] (three of a kind, Tens)
kurtaro: shows [8h Ah] (a pair of Aces)
dimetruk collected 15112 from pot
*** SUMMARY ***
Total pot 15112 | Rake 0
Board [Tc Jc Ad 9c Kc]
Seat 3: dimetruk (big blind) showed [Td Ts] and won (15112) with three of a kind, Tens
Seat 9: kurtaro (button) (small blind) showed [8h Ah] and lost with a pair of Aces


PokerStars Hand #226522756119: Tournament #3188224941, $13.70+$1.30 USD Hold'em No Limit - Level X (300/600) - 2021/05/07 0:21:16 MSK [2021/05/06 17:21:16 ET]
Table '3188224941 2' 9-max Seat #3 is the button
Seat 3: dimetruk (15112 in chips)
Seat 9: kurtaro (11888 in chips)
dimetruk: posts the ante 50
kurtaro: posts the ante 50
dimetruk: posts small blind 300
kurtaro: posts big blind 600
*** HOLE CARDS ***
Dealt to dimetruk [Js 7c]
dimetruk: calls 300
kurtaro: checks
*** FLOP *** [7h Ks Qs]
kurtaro: checks
dimetruk: checks
*** TURN *** [7h Ks Qs] [Jd]
kurtaro: checks
dimetruk: bets 900
kurtaro: folds
Uncalled bet (900) returned to dimetruk
dimetruk collected 1300 from pot
dimetruk: doesn't show hand
*** SUMMARY ***
Total pot 1300 | Rake 0
Board [7h Ks Qs Jd]
Seat 3: dimetruk (button) (small blind) collected (1300)
Seat 9: kurtaro (big blind) folded on the Turn


PokerStars Hand #226522765993: Tournament #3188224941, $13.70+$1.30 USD Hold'em No Limit - Level X (300/600) - 2021/05/07 0:21:32 MSK [2021/05/06 17:21:32 ET]
Table '3188224941 2' 9-max Seat #3 is the button
Seat 3: dimetruk (15112 in chips)
Seat 9: kurtaro (11888 in chips)
dimetruk: posts the ante 50
kurtaro: posts the ante 50
dimetruk: posts small blind 300
kurtaro: posts big blind 600
*** HOLE CARDS ***
Dealt to dimetruk [3s 9h]
dimetruk: raises 600 to 1200
kurtaro: calls 600
*** FLOP *** [Qc 3c 5d]
kurtaro: checks
dimetruk: bets 825
kurtaro: raises 1575 to 2400
dimetruk: folds
Uncalled bet (1575) returned to kurtaro
kurtaro collected 4150 from pot
kurtaro: doesn't show hand
*** SUMMARY ***
Total pot 4150 | Rake 0
Board [Qc 3c 5d]
Seat 3: dimetruk (button) (small blind) folded on the Flop
Seat 9: kurtaro (big blind) collected (4150)


PokerStars Hand #226522777208: Tournament #3188224941, $13.70+$1.30 USD Hold'em No Limit - Level X (300/600) - 2021/05/07 0:21:51 MSK [2021/05/06 17:21:51 ET]
Table '3188224941 2' 9-max Seat #3 is the button
Seat 3: dimetruk (13387 in chips)
Seat 9: kurtaro (13613 in chips)
dimetruk: posts the ante 50
kurtaro: posts the ante 50
dimetruk: posts small blind 300
kurtaro: posts big blind 600
*** HOLE CARDS ***
Dealt to dimetruk [5s 4h]
dimetruk: calls 300
kurtaro: checks
*** FLOP *** [2h Ah Td]
kurtaro: bets 600
dimetruk: calls 600
*** TURN *** [2h Ah Td] [9d]
kurtaro: bets 1200
dimetruk: calls 1200
*** RIVER *** [2h Ah Td 9d] [3h]
kurtaro: checks
dimetruk: bets 2695
kurtaro: calls 2695
*** SHOW DOWN ***
dimetruk: shows [5s 4h] (a straight, Ace to Five)
kurtaro: mucks hand
dimetruk collected 10290 from pot
*** SUMMARY ***
Total pot 10290 | Rake 0
Board [2h Ah Td 9d 3h]
Seat 3: dimetruk (button) (small blind) showed [5s 4h] and won (10290) with a straight, Ace to Five
Seat 9: kurtaro (big blind) mucked [Tc 6c]


PokerStars Hand #226522797707: Tournament #3188224941, $13.70+$1.30 USD Hold'em No Limit - Level X (300/600) - 2021/05/07 0:22:24 MSK [2021/05/06 17:22:24 ET]
Table '3188224941 2' 9-max Seat #3 is the button
Seat 3: dimetruk (19882 in chips)
Seat 9: kurtaro (7118 in chips)
dimetruk: posts the ante 50
kurtaro: posts the ante 50
dimetruk: posts small blind 300
kurtaro: posts big blind 600
*** HOLE CARDS ***
Dealt to dimetruk [7c 9s]
dimetruk: calls 300
kurtaro: checks
*** FLOP *** [2c 5d 5c]
kurtaro: checks
dimetruk: checks
*** TURN *** [2c 5d 5c] [4h]
kurtaro: bets 600
dimetruk: folds
Uncalled bet (600) returned to kurtaro
kurtaro collected 1300 from pot
kurtaro: doesn't show hand
*** SUMMARY ***
Total pot 1300 | Rake 0
Board [2c 5d 5c 4h]
Seat 3: dimetruk (button) (small blind) folded on the Turn
Seat 9: kurtaro (big blind) collected (1300)


PokerStars Hand #226522813409: Tournament #3188224941, $13.70+$1.30 USD Hold'em No Limit - Level X (300/600) - 2021/05/07 0:22:51 MSK [2021/05/06 17:22:51 ET]
Table '3188224941 2' 9-max Seat #3 is the button
Seat 3: dimetruk (19282 in chips)
Seat 9: kurtaro (7718 in chips)
dimetruk: posts the ante 50
kurtaro: posts the ante 50
dimetruk: posts small blind 300
kurtaro: posts big blind 600
*** HOLE CARDS ***
Dealt to dimetruk [3s Ah]
dimetruk: raises 600 to 1200
kurtaro: calls 600
*** FLOP *** [Qh 5d Ad]
kurtaro: checks
dimetruk: bets 825
kurtaro: folds
Uncalled bet (825) returned to dimetruk
dimetruk collected 2500 from pot
dimetruk: doesn't show hand
*** SUMMARY ***
Total pot 2500 | Rake 0
Board [Qh 5d Ad]
Seat 3: dimetruk (button) (small blind) collected (2500)
Seat 9: kurtaro (big blind) folded on the Flop


PokerStars Hand #226522819029: Tournament #3188224941, $13.70+$1.30 USD Hold'em No Limit - Level X (300/600) - 2021/05/07 0:23:00 MSK [2021/05/06 17:23:00 ET]
Table '3188224941 2' 9-max Seat #9 is the button
Seat 3: dimetruk (20532 in chips)
Seat 9: kurtaro (6468 in chips)
dimetruk: posts the ante 50
kurtaro: posts the ante 50
kurtaro: posts small blind 300
dimetruk: posts big blind 600
*** HOLE CARDS ***
Dealt to dimetruk [Ah Ad]
kurtaro: raises 600 to 1200
dimetruk: calls 600
*** FLOP *** [7s 3h 4d]
dimetruk: checks
kurtaro: checks
*** TURN *** [7s 3h 4d] [Jc]
dimetruk: bets 19282 and is all-in
kurtaro: folds
Uncalled bet (19282) returned to dimetruk
dimetruk collected 2500 from pot
dimetruk: doesn't show hand
*** SUMMARY ***
Total pot 2500 | Rake 0
Board [7s 3h 4d Jc]
Seat 3: dimetruk (big blind) collected (2500)
Seat 9: kurtaro (button) (small blind) folded on the Turn


PokerStars Hand #226522826534: Tournament #3188224941, $13.70+$1.30 USD Hold'em No Limit - Level X (300/600) - 2021/05/07 0:23:12 MSK [2021/05/06 17:23:12 ET]
Table '3188224941 2' 9-max Seat #3 is the button
Seat 3: dimetruk (21782 in chips)
Seat 9: kurtaro (5218 in chips)
dimetruk: posts the ante 50
kurtaro: posts the ante 50
dimetruk: posts small blind 300
kurtaro: posts big blind 600
*** HOLE CARDS ***
Dealt to dimetruk [4c Qh]
dimetruk: calls 300
kurtaro: checks
*** FLOP *** [Jh 2s Tc]
kurtaro: checks
dimetruk: checks
*** TURN *** [Jh 2s Tc] [8s]
kurtaro: bets 600
dimetruk: calls 600
*** RIVER *** [Jh 2s Tc 8s] [6d]
kurtaro: checks
dimetruk: bets 20532 and is all-in
kurtaro: calls 3968 and is all-in
Uncalled bet (16564) returned to dimetruk
*** SHOW DOWN ***
dimetruk: shows [4c Qh] (high card Queen)
kurtaro: shows [Ks 8c] (a pair of Eights)
kurtaro collected 10436 from pot
*** SUMMARY ***
Total pot 10436 | Rake 0
Board [Jh 2s Tc 8s 6d]
Seat 3: dimetruk (button) (small blind) showed [4c Qh] and lost with high card Queen
Seat 9: kurtaro (big blind) showed [Ks 8c] and won (10436) with a pair of Eights


PokerStars Hand #226522840483: Tournament #3188224941, $13.70+$1.30 USD Hold'em No Limit - Level X (300/600) - 2021/05/07 0:23:35 MSK [2021/05/06 17:23:35 ET]
Table '3188224941 2' 9-max Seat #9 is the button
Seat 3: dimetruk (16564 in chips)
Seat 9: kurtaro (10436 in chips)
dimetruk: posts the ante 50
kurtaro: posts the ante 50
kurtaro: posts small blind 300
dimetruk: posts big blind 600
*** HOLE CARDS ***
Dealt to dimetruk [Jd 7h]
kurtaro: calls 300
dimetruk: checks
*** FLOP *** [7s 4d 4s]
dimetruk: checks
kurtaro: bets 600
dimetruk: calls 600
*** TURN *** [7s 4d 4s] [4c]
dimetruk: checks
kurtaro: checks
*** RIVER *** [7s 4d 4s 4c] [Td]
dimetruk: bets 1125
kurtaro: calls 1125
*** SHOW DOWN ***
dimetruk: shows [Jd 7h] (a full house, Fours full of Sevens)
kurtaro: mucks hand
dimetruk collected 4750 from pot
*** SUMMARY ***
Total pot 4750 | Rake 0
Board [7s 4d 4s 4c Td]
Seat 3: dimetruk (big blind) showed [Jd 7h] and won (4750) with a full house, Fours full of Sevens
Seat 9: kurtaro (button) (small blind) mucked [Ac 8c]


PokerStars Hand #226522851715: Tournament #3188224941, $13.70+$1.30 USD Hold'em No Limit - Level X (300/600) - 2021/05/07 0:23:54 MSK [2021/05/06 17:23:54 ET]
Table '3188224941 2' 9-max Seat #9 is the button
Seat 3: dimetruk (19589 in chips)
Seat 9: kurtaro (7411 in chips)
dimetruk: posts the ante 50
kurtaro: posts the ante 50
kurtaro: posts small blind 300
dimetruk: posts big blind 600
*** HOLE CARDS ***
Dealt to dimetruk [8s Qc]
kurtaro: calls 300
dimetruk: checks
*** FLOP *** [8d 9d Qh]
dimetruk: checks
kurtaro: bets 600
dimetruk: raises 1200 to 1800
kurtaro: raises 4900 to 6700
dimetruk: raises 11025 to 17725
kurtaro: calls 61 and is all-in
Uncalled bet (10964) returned to dimetruk
*** TURN *** [8d 9d Qh] [Td]
*** RIVER *** [8d 9d Qh Td] [4d]
*** SHOW DOWN ***
dimetruk: shows [8s Qc] (two pair, Queens and Eights)
kurtaro: shows [Ks Kd] (a flush, King high)
kurtaro collected 14822 from pot
*** SUMMARY ***
Total pot 14822 | Rake 0
Board [8d 9d Qh Td 4d]
Seat 3: dimetruk (big blind) showed [8s Qc] and lost with two pair, Queens and Eights
Seat 9: kurtaro (button) (small blind) showed [Ks Kd] and won (14822) with a flush, King high


PokerStars Hand #226522866331: Tournament #3188224941, $13.70+$1.30 USD Hold'em No Limit - Level XI (400/800) - 2021/05/07 0:24:19 MSK [2021/05/06 17:24:19 ET]
Table '3188224941 2' 9-max Seat #3 is the button
Seat 3: dimetruk (12178 in chips)
Seat 9: kurtaro (14822 in chips)
dimetruk: posts the ante 50
kurtaro: posts the ante 50
dimetruk: posts small blind 400
kurtaro: posts big blind 800
*** HOLE CARDS ***
Dealt to dimetruk [Qh 5c]
dimetruk: raises 800 to 1600
kurtaro: calls 800
*** FLOP *** [9h Kh Td]
kurtaro: checks
dimetruk: bets 1089
kurtaro: calls 1089
*** TURN *** [9h Kh Td] [5d]
kurtaro: checks
dimetruk: checks
*** RIVER *** [9h Kh Td 5d] [Ah]
kurtaro: checks
dimetruk: checks
*** SHOW DOWN ***
kurtaro: shows [8c Ts] (a pair of Tens)
dimetruk: mucks hand
kurtaro collected 5478 from pot
*** SUMMARY ***
Total pot 5478 | Rake 0
Board [9h Kh Td 5d Ah]
Seat 3: dimetruk (button) (small blind) mucked [Qh 5c]
Seat 9: kurtaro (big blind) showed [8c Ts] and won (5478) with a pair of Tens


PokerStars Hand #226522877921: Tournament #3188224941, $13.70+$1.30 USD Hold'em No Limit - Level XI (400/800) - 2021/05/07 0:24:38 MSK [2021/05/06 17:24:38 ET]
Table '3188224941 2' 9-max Seat #9 is the button
Seat 3: dimetruk (9439 in chips)
Seat 9: kurtaro (17561 in chips)
dimetruk: posts the ante 50
kurtaro: posts the ante 50
kurtaro: posts small blind 400
dimetruk: posts big blind 800
*** HOLE CARDS ***
Dealt to dimetruk [Th 4d]
kurtaro: calls 400
dimetruk: checks
*** FLOP *** [Jh Ks 9d]
dimetruk: checks
kurtaro: bets 800
dimetruk: folds
Uncalled bet (800) returned to kurtaro
kurtaro collected 1700 from pot
kurtaro: doesn't show hand
*** SUMMARY ***
Total pot 1700 | Rake 0
Board [Jh Ks 9d]
Seat 3: dimetruk (big blind) folded on the Flop
Seat 9: kurtaro (button) (small blind) collected (1700)


PokerStars Hand #226522886058: Tournament #3188224941, $13.70+$1.30 USD Hold'em No Limit - Level XI (400/800) - 2021/05/07 0:24:51 MSK [2021/05/06 17:24:51 ET]
Table '3188224941 2' 9-max Seat #9 is the button
Seat 3: dimetruk (8139 in chips)
Seat 9: kurtaro (18861 in chips)
dimetruk: posts the ante 50
kurtaro: posts the ante 50
kurtaro: posts small blind 400
dimetruk: posts big blind 800
*** HOLE CARDS ***
Dealt to dimetruk [6h Th]
kurtaro: raises 800 to 1600
dimetruk: calls 800
*** FLOP *** [9d 2d 9c]
dimetruk: checks
kurtaro: bets 17211 and is all-in
dimetruk: folds
Uncalled bet (17211) returned to kurtaro
kurtaro collected 3300 from pot
kurtaro: doesn't show hand
*** SUMMARY ***
Total pot 3300 | Rake 0
Board [9d 2d 9c]
Seat 3: dimetruk (big blind) folded on the Flop
Seat 9: kurtaro (button) (small blind) collected (3300)


PokerStars Hand #226522903522: Tournament #3188224941, $13.70+$1.30 USD Hold'em No Limit - Level XI (400/800) - 2021/05/07 0:25:21 MSK [2021/05/06 17:25:21 ET]
Table '3188224941 2' 9-max Seat #3 is the button
Seat 3: dimetruk (6489 in chips)
Seat 9: kurtaro (20511 in chips)
dimetruk: posts the ante 50
kurtaro: posts the ante 50
dimetruk: posts small blind 400
kurtaro: posts big blind 800
*** HOLE CARDS ***
Dealt to dimetruk [3d 6d]
dimetruk: calls 400
kurtaro: checks
*** FLOP *** [Ah 9c Kd]
kurtaro: checks
dimetruk: bets 800
kurtaro: folds
Uncalled bet (800) returned to dimetruk
dimetruk collected 1700 from pot
dimetruk: doesn't show hand
*** SUMMARY ***
Total pot 1700 | Rake 0
Board [Ah 9c Kd]
Seat 3: dimetruk (button) (small blind) collected (1700)
Seat 9: kurtaro (big blind) folded on the Flop


PokerStars Hand #226522914898: Tournament #3188224941, $13.70+$1.30 USD Hold'em No Limit - Level XI (400/800) - 2021/05/07 0:25:40 MSK [2021/05/06 17:25:40 ET]
Table '3188224941 2' 9-max Seat #9 is the button
Seat 3: dimetruk (7339 in chips)
Seat 9: kurtaro (19661 in chips)
dimetruk: posts the ante 50
kurtaro: posts the ante 50
kurtaro: posts small blind 400
dimetruk: posts big blind 800
*** HOLE CARDS ***
Dealt to dimetruk [8h Jh]
kurtaro: raises 800 to 1600
dimetruk: raises 5689 to 7289 and is all-in
kurtaro: calls 5689
*** FLOP *** [7d 3c 2c]
*** TURN *** [7d 3c 2c] [2d]
*** RIVER *** [7d 3c 2c 2d] [7c]
*** SHOW DOWN ***
dimetruk: shows [8h Jh] (two pair, Sevens and Deuces)
kurtaro: shows [6s Ah] (two pair, Sevens and Deuces - Ace kicker)
kurtaro collected 14678 from pot
dimetruk finished the tournament in 2nd place and received $73.98.
kurtaro wins the tournament and receives $98.64 - congratulations!
*** SUMMARY ***
Total pot 14678 | Rake 0
Board [7d 3c 2c 2d 7c]
Seat 3: dimetruk (big blind) showed [8h Jh] and lost with two pair, Sevens and Deuces
Seat 9: kurtaro (button) (small blind) showed [6s Ah] and won (14678) with two pair, Sevens and Deuces


PokerStars Hand #226549977720: Tournament #3188715462, $27.58+$2.42 USD Hold'em No Limit - Level I (10/20) - 2021/05/07 23:14:27 MSK [2021/05/07 16:14:27 ET]
Table '3188715462 1' 6-max Seat #3 is the button
Seat 1: Noogaii (1494 in chips)
Seat 2: Fago66 (1732 in chips)
Seat 3: Nikola92975 (1532 in chips)
Seat 4: AKsEffekt (1474 in chips)
Seat 5: dimetruk (1494 in chips)
Seat 6: JohnLuc J (1274 in chips)
Noogaii: posts the ante 3
Fago66: posts the ante 3
Nikola92975: posts the ante 3
AKsEffekt: posts the ante 3
dimetruk: posts the ante 3
JohnLuc J: posts the ante 3
AKsEffekt: posts small blind 10
dimetruk: posts big blind 20
*** HOLE CARDS ***
Dealt to dimetruk [Ad 7d]
JohnLuc J: folds
Noogaii: folds
Fago66: folds
Nikola92975: raises 24 to 44
AKsEffekt: folds
dimetruk: calls 24
*** FLOP *** [Ts 4h 8h]
dimetruk: checks
Nikola92975: bets 78
dimetruk: folds
Uncalled bet (78) returned to Nikola92975
Nikola92975 collected 116 from pot
Nikola92975: doesn't show hand
*** SUMMARY ***
Total pot 116 | Rake 0
Board [Ts 4h 8h]
Seat 1: Noogaii folded before Flop (didn't bet)
Seat 2: Fago66 folded before Flop (didn't bet)
Seat 3: Nikola92975 (button) collected (116)
Seat 4: AKsEffekt (small blind) folded before Flop
Seat 5: dimetruk (big blind) folded on the Flop
Seat 6: JohnLuc J folded before Flop (didn't bet)


PokerStars Hand #226550112927: Tournament #3188715462, $27.58+$2.42 USD Hold'em No Limit - Level I (10/20) - 2021/05/07 23:17:44 MSK [2021/05/07 16:17:44 ET]
Table '3188715462 1' 6-max Seat #6 is the button
Seat 1: Noogaii (1465 in chips)
Seat 2: Fago66 (1794 in chips)
Seat 3: Nikola92975 (1435 in chips)
Seat 4: AKsEffekt (1455 in chips)
Seat 5: dimetruk (1431 in chips)
Seat 6: JohnLuc J (1420 in chips)
Noogaii: posts the ante 3
Fago66: posts the ante 3
Nikola92975: posts the ante 3
AKsEffekt: posts the ante 3
dimetruk: posts the ante 3
JohnLuc J: posts the ante 3
Noogaii: posts small blind 10
Fago66: posts big blind 20
*** HOLE CARDS ***
Dealt to dimetruk [8s 8d]
Nikola92975: folds
AKsEffekt: folds
dimetruk: raises 20 to 40
JohnLuc J: calls 40
Noogaii: folds
Fago66: calls 20
*** FLOP *** [Ah 7c Ad]
Fago66: checks
dimetruk: bets 49
JohnLuc J: folds
Fago66: folds
Uncalled bet (49) returned to dimetruk
dimetruk collected 148 from pot
dimetruk: doesn't show hand
*** SUMMARY ***
Total pot 148 | Rake 0
Board [Ah 7c Ad]
Seat 1: Noogaii (small blind) folded before Flop
Seat 2: Fago66 (big blind) folded on the Flop
Seat 3: Nikola92975 folded before Flop (didn't bet)
Seat 4: AKsEffekt folded before Flop (didn't bet)
Seat 5: dimetruk collected (148)
Seat 6: JohnLuc J (button) folded on the Flop


PokerStars Hand #226550233862: Tournament #3188715462, $27.58+$2.42 USD Hold'em No Limit - Level I (10/20) - 2021/05/07 23:20:41 MSK [2021/05/07 16:20:41 ET]
Table '3188715462 1' 6-max Seat #3 is the button
Seat 1: Noogaii (1446 in chips)
Seat 2: Fago66 (1525 in chips)
Seat 3: Nikola92975 (1704 in chips)
Seat 4: AKsEffekt (1474 in chips)
Seat 5: dimetruk (1530 in chips)
Seat 6: JohnLuc J (1321 in chips)
Noogaii: posts the ante 3
Fago66: posts the ante 3
Nikola92975: posts the ante 3
AKsEffekt: posts the ante 3
dimetruk: posts the ante 3
JohnLuc J: posts the ante 3
AKsEffekt: posts small blind 10
dimetruk: posts big blind 20
*** HOLE CARDS ***
Dealt to dimetruk [Qc 3h]
JohnLuc J: folds
Noogaii: folds
Fago66: raises 40 to 60
Nikola92975: folds
AKsEffekt: folds
dimetruk: calls 40
*** FLOP *** [4s Js Qs]
dimetruk: checks
Fago66: bets 120
dimetruk: folds
Uncalled bet (120) returned to Fago66
Fago66 collected 148 from pot
Fago66: doesn't show hand
*** SUMMARY ***
Total pot 148 | Rake 0
Board [4s Js Qs]
Seat 1: Noogaii folded before Flop (didn't bet)
Seat 2: Fago66 collected (148)
Seat 3: Nikola92975 (button) folded before Flop (didn't bet)
Seat 4: AKsEffekt (small blind) folded before Flop
Seat 5: dimetruk (big blind) folded on the Flop
Seat 6: JohnLuc J folded before Flop (didn't bet)


PokerStars Hand #226550470274: Tournament #3188715462, $27.58+$2.42 USD Hold'em No Limit - Level II (15/30) - 2021/05/07 23:26:17 MSK [2021/05/07 16:26:17 ET]
Table '3188715462 1' 6-max Seat #4 is the button
Seat 1: Noogaii (1440 in chips)
Seat 2: Fago66 (2386 in chips)
Seat 3: Nikola92975 (1429 in chips)
Seat 4: AKsEffekt (716 in chips)
Seat 5: dimetruk (1406 in chips)
Seat 6: JohnLuc J (1623 in chips)
Noogaii: posts the ante 4
Fago66: posts the ante 4
Nikola92975: posts the ante 4
AKsEffekt: posts the ante 4
dimetruk: posts the ante 4
JohnLuc J: posts the ante 4
dimetruk: posts small blind 15
JohnLuc J: posts big blind 30
*** HOLE CARDS ***
Dealt to dimetruk [3d 3c]
Noogaii: folds
Fago66: calls 30
Nikola92975: raises 75 to 105
AKsEffekt: folds
dimetruk: calls 90
JohnLuc J: calls 75
Fago66: calls 75
*** FLOP *** [Js 7s 2s]
dimetruk: checks
JohnLuc J: bets 172
Fago66: folds
Nikola92975: folds
dimetruk: folds
Uncalled bet (172) returned to JohnLuc J
JohnLuc J collected 444 from pot
JohnLuc J: doesn't show hand
*** SUMMARY ***
Total pot 444 | Rake 0
Board [Js 7s 2s]
Seat 1: Noogaii folded before Flop (didn't bet)
Seat 2: Fago66 folded on the Flop
Seat 3: Nikola92975 folded on the Flop
Seat 4: AKsEffekt (button) folded before Flop (didn't bet)
Seat 5: dimetruk (small blind) folded on the Flop
Seat 6: JohnLuc J (big blind) collected (444)


PokerStars Hand #226550606203: Tournament #3188715462, $27.58+$2.42 USD Hold'em No Limit - Level II (15/30) - 2021/05/07 23:29:35 MSK [2021/05/07 16:29:35 ET]
Table '3188715462 1' 6-max Seat #3 is the button
Seat 1: Noogaii (1564 in chips)
Seat 2: Fago66 (2474 in chips)
Seat 3: Nikola92975 (1328 in chips)
Seat 4: AKsEffekt (516 in chips)
Seat 5: dimetruk (1191 in chips)
Seat 6: JohnLuc J (1927 in chips)
Noogaii: posts the ante 4
Fago66: posts the ante 4
Nikola92975: posts the ante 4
AKsEffekt: posts the ante 4
dimetruk: posts the ante 4
JohnLuc J: posts the ante 4
AKsEffekt: posts small blind 15
dimetruk: posts big blind 30
*** HOLE CARDS ***
Dealt to dimetruk [2h Ks]
JohnLuc J: raises 36 to 66
Noogaii: folds
Fago66: folds
Nikola92975: folds
AKsEffekt: folds
dimetruk: calls 36
*** FLOP *** [Jd Qh Qc]
dimetruk: checks
JohnLuc J: bets 59
dimetruk: folds
Uncalled bet (59) returned to JohnLuc J
JohnLuc J collected 171 from pot
JohnLuc J: doesn't show hand
*** SUMMARY ***
Total pot 171 | Rake 0
Board [Jd Qh Qc]
Seat 1: Noogaii folded before Flop (didn't bet)
Seat 2: Fago66 folded before Flop (didn't bet)
Seat 3: Nikola92975 (button) folded before Flop (didn't bet)
Seat 4: AKsEffekt (small blind) folded before Flop
Seat 5: dimetruk (big blind) folded on the Flop
Seat 6: JohnLuc J collected (171)


PokerStars Hand #226550673031: Tournament #3188715462, $27.58+$2.42 USD Hold'em No Limit - Level II (15/30) - 2021/05/07 23:31:11 MSK [2021/05/07 16:31:11 ET]
Table '3188715462 1' 6-max Seat #5 is the button
Seat 1: Noogaii (1556 in chips)
Seat 2: Fago66 (2436 in chips)
Seat 3: Nikola92975 (1320 in chips)
Seat 4: AKsEffekt (493 in chips)
Seat 5: dimetruk (1102 in chips)
Seat 6: JohnLuc J (2093 in chips)
Noogaii: posts the ante 4
Fago66: posts the ante 4
Nikola92975: posts the ante 4
AKsEffekt: posts the ante 4
dimetruk: posts the ante 4
JohnLuc J: posts the ante 4
JohnLuc J: posts small blind 15
Noogaii: posts big blind 30
*** HOLE CARDS ***
Dealt to dimetruk [Jc 5c]
Fago66: folds
Nikola92975: folds
AKsEffekt: folds
dimetruk: raises 30 to 60
JohnLuc J: calls 45
Noogaii: folds
*** FLOP *** [9d 9s As]
JohnLuc J: checks
dimetruk: bets 57
JohnLuc J: calls 57
*** TURN *** [9d 9s As] [Ah]
JohnLuc J: checks
dimetruk: checks
*** RIVER *** [9d 9s As Ah] [Ts]
JohnLuc J: bets 96
dimetruk: folds
Uncalled bet (96) returned to JohnLuc J
JohnLuc J collected 288 from pot
JohnLuc J: doesn't show hand
*** SUMMARY ***
Total pot 288 | Rake 0
Board [9d 9s As Ah Ts]
Seat 1: Noogaii (big blind) folded before Flop
Seat 2: Fago66 folded before Flop (didn't bet)
Seat 3: Nikola92975 folded before Flop (didn't bet)
Seat 4: AKsEffekt folded before Flop (didn't bet)
Seat 5: dimetruk (button) folded on the River
Seat 6: JohnLuc J (small blind) collected (288)


PokerStars Hand #226550937247: Tournament #3188715462, $27.58+$2.42 USD Hold'em No Limit - Level III (25/50) - 2021/05/07 23:37:28 MSK [2021/05/07 16:37:28 ET]
Table '3188715462 1' 6-max Seat #3 is the button
Seat 1: Noogaii (1374 in chips)
Seat 2: Fago66 (3007 in chips)
Seat 3: Nikola92975 (551 in chips)
Seat 5: dimetruk (1179 in chips)
Seat 6: JohnLuc J (2889 in chips)
Noogaii: posts the ante 6
Fago66: posts the ante 6
Nikola92975: posts the ante 6
dimetruk: posts the ante 6
JohnLuc J: posts the ante 6
dimetruk: posts small blind 25
JohnLuc J: posts big blind 50
*** HOLE CARDS ***
Dealt to dimetruk [Jc Td]
Noogaii: folds
Fago66: folds
Nikola92975: folds
dimetruk: raises 50 to 100
JohnLuc J: calls 50
*** FLOP *** [7s 3s 8s]
dimetruk: bets 115
JohnLuc J: calls 115
*** TURN *** [7s 3s 8s] [4h]
dimetruk: bets 230
JohnLuc J: calls 230
*** RIVER *** [7s 3s 8s 4h] [7d]
dimetruk: checks
JohnLuc J: checks
*** SHOW DOWN ***
dimetruk: shows [Jc Td] (a pair of Sevens)
JohnLuc J: shows [4d Ah] (two pair, Sevens and Fours)
JohnLuc J collected 920 from pot
*** SUMMARY ***
Total pot 920 | Rake 0
Board [7s 3s 8s 4h 7d]
Seat 1: Noogaii folded before Flop (didn't bet)
Seat 2: Fago66 folded before Flop (didn't bet)
Seat 3: Nikola92975 (button) folded before Flop (didn't bet)
Seat 5: dimetruk (small blind) showed [Jc Td] and lost with a pair of Sevens
Seat 6: JohnLuc J (big blind) showed [4d Ah] and won (920) with two pair, Sevens and Fours


PokerStars Hand #226551030980: Tournament #3188715462, $27.58+$2.42 USD Hold'em No Limit - Level III (25/50) - 2021/05/07 23:39:47 MSK [2021/05/07 16:39:47 ET]
Table '3188715462 1' 6-max Seat #1 is the button
Seat 1: Noogaii (1281 in chips)
Seat 2: Fago66 (2939 in chips)
Seat 3: Nikola92975 (533 in chips)
Seat 5: dimetruk (616 in chips)
Seat 6: JohnLuc J (3631 in chips)
Noogaii: posts the ante 6
Fago66: posts the ante 6
Nikola92975: posts the ante 6
dimetruk: posts the ante 6
JohnLuc J: posts the ante 6
Fago66: posts small blind 25
Nikola92975: posts big blind 50
*** HOLE CARDS ***
Dealt to dimetruk [7s 7h]
dimetruk: raises 560 to 610 and is all-in
JohnLuc J: calls 610
Noogaii: folds
Fago66: folds
Nikola92975: folds
*** FLOP *** [5h Jc 3d]
*** TURN *** [5h Jc 3d] [6c]
*** RIVER *** [5h Jc 3d 6c] [Th]
*** SHOW DOWN ***
dimetruk: shows [7s 7h] (a pair of Sevens)
JohnLuc J: shows [Kc As] (high card Ace)
dimetruk collected 1325 from pot
*** SUMMARY ***
Total pot 1325 | Rake 0
Board [5h Jc 3d 6c Th]
Seat 1: Noogaii (button) folded before Flop (didn't bet)
Seat 2: Fago66 (small blind) folded before Flop
Seat 3: Nikola92975 (big blind) folded before Flop
Seat 5: dimetruk showed [7s 7h] and won (1325) with a pair of Sevens
Seat 6: JohnLuc J showed [Kc As] and lost with high card Ace


PokerStars Hand #226551214152: Tournament #3188715462, $27.58+$2.42 USD Hold'em No Limit - Level IV (40/80) - 2021/05/07 23:44:21 MSK [2021/05/07 16:44:21 ET]
Table '3188715462 1' 6-max Seat #1 is the button
Seat 1: Noogaii (1681 in chips)
Seat 2: Fago66 (3391 in chips) is sitting out
Seat 5: dimetruk (1356 in chips)
Seat 6: JohnLuc J (2572 in chips)
Noogaii: posts the ante 10
Fago66: posts the ante 10
dimetruk: posts the ante 10
JohnLuc J: posts the ante 10
Fago66: posts small blind 40
dimetruk: posts big blind 80
*** HOLE CARDS ***
Dealt to dimetruk [Jh Js]
JohnLuc J: folds
Noogaii: raises 1591 to 1671 and is all-in
Fago66: folds
dimetruk: calls 1266 and is all-in
Uncalled bet (325) returned to Noogaii
*** FLOP *** [2c 3d 4h]
*** TURN *** [2c 3d 4h] [5h]
*** RIVER *** [2c 3d 4h 5h] [Kc]
*** SHOW DOWN ***
dimetruk: shows [Jh Js] (a pair of Jacks)
Noogaii: shows [6s 7s] (a straight, Three to Seven)
Noogaii collected 2772 from pot
dimetruk finished the tournament in 4th place
*** SUMMARY ***
Total pot 2772 | Rake 0
Board [2c 3d 4h 5h Kc]
Seat 1: Noogaii (button) showed [6s 7s] and won (2772) with a straight, Three to Seven
Seat 2: Fago66 (small blind) folded before Flop
Seat 5: dimetruk (big blind) showed [Jh Js] and lost with a pair of Jacks
Seat 6: JohnLuc J folded before Flop (didn't bet)


PokerStars Hand #226549340030: Tournament #3188920119, $27.40+$2.60 USD Hold'em No Limit - Level I (10/20) - 2021/05/07 22:56:39 MSK [2021/05/07 15:56:39 ET]
Table '3188920119 1' 9-max Seat #4 is the button
Seat 1: Maus219 (1491 in chips)
Seat 2: rumred14 (1411 in chips)
Seat 3: Gimbel 2 (1498 in chips)
Seat 4: Strannaya (1391 in chips)
Seat 5: AKsEffekt (1471 in chips)
Seat 6: dimetruk (1491 in chips)
Seat 7: exjd111 (1805 in chips)
Seat 8: DODGE.WINS (1451 in chips)
Seat 9: jwebow (1491 in chips)
Maus219: posts the ante 3
rumred14: posts the ante 3
Gimbel 2: posts the ante 3
Strannaya: posts the ante 3
AKsEffekt: posts the ante 3
dimetruk: posts the ante 3
exjd111: posts the ante 3
DODGE.WINS: posts the ante 3
jwebow: posts the ante 3
AKsEffekt: posts small blind 10
dimetruk: posts big blind 20
*** HOLE CARDS ***
Dealt to dimetruk [6c Qh]
exjd111: raises 20 to 40
DODGE.WINS: folds
jwebow: folds
Maus219: folds
rumred14: folds
Gimbel 2: folds
Strannaya: folds
AKsEffekt: folds
dimetruk: calls 20
*** FLOP *** [2h 9d 3h]
dimetruk: checks
exjd111: checks
*** TURN *** [2h 9d 3h] [Th]
dimetruk: bets 59
exjd111: folds
Uncalled bet (59) returned to dimetruk
dimetruk collected 117 from pot
dimetruk: doesn't show hand
*** SUMMARY ***
Total pot 117 | Rake 0
Board [2h 9d 3h Th]
Seat 1: Maus219 folded before Flop (didn't bet)
Seat 2: rumred14 folded before Flop (didn't bet)
Seat 3: Gimbel 2 folded before Flop (didn't bet)
Seat 4: Strannaya (button) folded before Flop (didn't bet)
Seat 5: AKsEffekt (small blind) folded before Flop
Seat 6: dimetruk (big blind) collected (117)
Seat 7: exjd111 folded on the Turn
Seat 8: DODGE.WINS folded before Flop (didn't bet)
Seat 9: jwebow folded before Flop (didn't bet)


PokerStars Hand #226549397363: Tournament #3188920119, $27.40+$2.60 USD Hold'em No Limit - Level I (10/20) - 2021/05/07 22:58:42 MSK [2021/05/07 15:58:42 ET]
Table '3188920119 1' 9-max Seat #7 is the button
Seat 1: Maus219 (1482 in chips)
Seat 2: rumred14 (1402 in chips)
Seat 3: Gimbel 2 (1606 in chips)
Seat 4: Strannaya (1382 in chips)
Seat 5: AKsEffekt (1452 in chips)
Seat 6: dimetruk (1549 in chips)
Seat 7: exjd111 (1723 in chips)
Seat 8: DODGE.WINS (1422 in chips)
Seat 9: jwebow (1482 in chips)
Maus219: posts the ante 3
rumred14: posts the ante 3
Gimbel 2: posts the ante 3
Strannaya: posts the ante 3
AKsEffekt: posts the ante 3
dimetruk: posts the ante 3
exjd111: posts the ante 3
DODGE.WINS: posts the ante 3
jwebow: posts the ante 3
DODGE.WINS: posts small blind 10
jwebow: posts big blind 20
*** HOLE CARDS ***
Dealt to dimetruk [Ac Jc]
Maus219: folds
rumred14: folds
Gimbel 2: calls 20
Strannaya: raises 50 to 70
AKsEffekt: folds
dimetruk: calls 70
exjd111: folds
DODGE.WINS: folds
jwebow has timed out
jwebow: folds
jwebow is sitting out
Gimbel 2: calls 50
*** FLOP *** [8d 2d Kd]
Gimbel 2: checks
Strannaya: checks
jwebow has returned
dimetruk: bets 88
Gimbel 2: calls 88
Strannaya: folds
*** TURN *** [8d 2d Kd] [3c]
Gimbel 2: bets 443
dimetruk: folds
Uncalled bet (443) returned to Gimbel 2
Gimbel 2 collected 443 from pot
Gimbel 2: doesn't show hand
*** SUMMARY ***
Total pot 443 | Rake 0
Board [8d 2d Kd 3c]
Seat 1: Maus219 folded before Flop (didn't bet)
Seat 2: rumred14 folded before Flop (didn't bet)
Seat 3: Gimbel 2 collected (443)
Seat 4: Strannaya folded on the Flop
Seat 5: AKsEffekt folded before Flop (didn't bet)
Seat 6: dimetruk folded on the Turn
Seat 7: exjd111 (button) folded before Flop (didn't bet)
Seat 8: DODGE.WINS (small blind) folded before Flop
Seat 9: jwebow (big blind) folded before Flop


PokerStars Hand #226549468392: Tournament #3188920119, $27.40+$2.60 USD Hold'em No Limit - Level I (10/20) - 2021/05/07 23:01:17 MSK [2021/05/07 16:01:17 ET]
Table '3188920119 1' 9-max Seat #9 is the button
Seat 1: Maus219 (1456 in chips)
Seat 2: rumred14 (1396 in chips)
Seat 3: Gimbel 2 (1865 in chips)
Seat 4: Strannaya (1306 in chips)
Seat 5: AKsEffekt (1446 in chips)
Seat 6: dimetruk (1385 in chips)
Seat 7: exjd111 (1697 in chips)
Seat 8: DODGE.WINS (1503 in chips)
Seat 9: jwebow (1446 in chips)
Maus219: posts the ante 3
rumred14: posts the ante 3
Gimbel 2: posts the ante 3
Strannaya: posts the ante 3
AKsEffekt: posts the ante 3
dimetruk: posts the ante 3
exjd111: posts the ante 3
DODGE.WINS: posts the ante 3
jwebow: posts the ante 3
Maus219: posts small blind 10
rumred14: posts big blind 20
*** HOLE CARDS ***
Dealt to dimetruk [2h 2c]
Gimbel 2: calls 20
Strannaya: folds
AKsEffekt: folds
dimetruk: raises 40 to 60
exjd111: folds
DODGE.WINS: folds
jwebow: folds
Maus219: folds
rumred14: folds
Gimbel 2: calls 40
*** FLOP *** [Kh 8s Jh]
Gimbel 2: checks
dimetruk: bets 89
Gimbel 2: folds
Uncalled bet (89) returned to dimetruk
dimetruk collected 177 from pot
dimetruk: doesn't show hand
*** SUMMARY ***
Total pot 177 | Rake 0
Board [Kh 8s Jh]
Seat 1: Maus219 (small blind) folded before Flop
Seat 2: rumred14 (big blind) folded before Flop
Seat 3: Gimbel 2 folded on the Flop
Seat 4: Strannaya folded before Flop (didn't bet)
Seat 5: AKsEffekt folded before Flop (didn't bet)
Seat 6: dimetruk collected (177)
Seat 7: exjd111 folded before Flop (didn't bet)
Seat 8: DODGE.WINS folded before Flop (didn't bet)
Seat 9: jwebow (button) folded before Flop (didn't bet)


PokerStars Hand #226549564668: Tournament #3188920119, $27.40+$2.60 USD Hold'em No Limit - Level II (15/30) - 2021/05/07 23:03:47 MSK [2021/05/07 16:03:47 ET]
Table '3188920119 1' 9-max Seat #2 is the button
Seat 1: Maus219 (1637 in chips)
Seat 2: rumred14 (1360 in chips)
Seat 3: Gimbel 2 (1779 in chips)
Seat 4: Strannaya (1300 in chips)
Seat 5: AKsEffekt (1440 in chips)
Seat 6: dimetruk (1496 in chips)
Seat 7: exjd111 (1551 in chips)
Seat 8: DODGE.WINS (1497 in chips)
Seat 9: jwebow (1440 in chips)
Maus219: posts the ante 4
rumred14: posts the ante 4
Gimbel 2: posts the ante 4
Strannaya: posts the ante 4
AKsEffekt: posts the ante 4
dimetruk: posts the ante 4
exjd111: posts the ante 4
DODGE.WINS: posts the ante 4
jwebow: posts the ante 4
Gimbel 2: posts small blind 15
Strannaya: posts big blind 30
*** HOLE CARDS ***
Dealt to dimetruk [4d 4c]
AKsEffekt: folds
dimetruk: raises 30 to 60
exjd111: calls 60
DODGE.WINS: folds
jwebow: folds
Maus219: folds
rumred14: folds
Gimbel 2: calls 45
Strannaya: calls 30
*** FLOP *** [8h 9h 7d]
Gimbel 2: checks
Strannaya: checks
dimetruk: checks
exjd111: checks
*** TURN *** [8h 9h 7d] [2h]
Gimbel 2: checks
Strannaya: checks
dimetruk: bets 138
exjd111: calls 138
Gimbel 2: folds
Strannaya: folds
*** RIVER *** [8h 9h 7d 2h] [Ks]
dimetruk: bets 414
exjd111: folds
Uncalled bet (414) returned to dimetruk
dimetruk collected 552 from pot
dimetruk: doesn't show hand
*** SUMMARY ***
Total pot 552 | Rake 0
Board [8h 9h 7d 2h Ks]
Seat 1: Maus219 folded before Flop (didn't bet)
Seat 2: rumred14 (button) folded before Flop (didn't bet)
Seat 3: Gimbel 2 (small blind) folded on the Turn
Seat 4: Strannaya (big blind) folded on the Turn
Seat 5: AKsEffekt folded before Flop (didn't bet)
Seat 6: dimetruk collected (552)
Seat 7: exjd111 folded on the River
Seat 8: DODGE.WINS folded before Flop (didn't bet)
Seat 9: jwebow folded before Flop (didn't bet)


PokerStars Hand #226550019826: Tournament #3188920119, $27.40+$2.60 USD Hold'em No Limit - Level III (25/50) - 2021/05/07 23:15:27 MSK [2021/05/07 16:15:27 ET]
Table '3188920119 1' 9-max Seat #4 is the button
Seat 1: Maus219 (1529 in chips)
Seat 2: rumred14 (1103 in chips)
Seat 3: Gimbel 2 (1868 in chips)
Seat 4: Strannaya (1531 in chips)
Seat 5: AKsEffekt (1297 in chips)
Seat 6: dimetruk (1757 in chips)
Seat 7: exjd111 (913 in chips)
Seat 8: DODGE.WINS (1686 in chips)
Seat 9: jwebow (1816 in chips)
Maus219: posts the ante 6
rumred14: posts the ante 6
Gimbel 2: posts the ante 6
Strannaya: posts the ante 6
AKsEffekt: posts the ante 6
dimetruk: posts the ante 6
exjd111: posts the ante 6
DODGE.WINS: posts the ante 6
jwebow: posts the ante 6
AKsEffekt: posts small blind 25
dimetruk: posts big blind 50
*** HOLE CARDS ***
Dealt to dimetruk [Th 6h]
exjd111: calls 50
DODGE.WINS: folds
jwebow: folds
Maus219: folds
rumred14: folds
Gimbel 2: folds
Strannaya: folds
AKsEffekt: folds
dimetruk: checks
*** FLOP *** [Ad 5d 3h]
dimetruk: checks
exjd111: checks
*** TURN *** [Ad 5d 3h] [3c]
dimetruk: checks
exjd111: checks
*** RIVER *** [Ad 5d 3h 3c] [Tc]
dimetruk: checks
exjd111: checks
*** SHOW DOWN ***
dimetruk: shows [Th 6h] (two pair, Tens and Threes)
exjd111: mucks hand
dimetruk collected 179 from pot
*** SUMMARY ***
Total pot 179 | Rake 0
Board [Ad 5d 3h 3c Tc]
Seat 1: Maus219 folded before Flop (didn't bet)
Seat 2: rumred14 folded before Flop (didn't bet)
Seat 3: Gimbel 2 folded before Flop (didn't bet)
Seat 4: Strannaya (button) folded before Flop (didn't bet)
Seat 5: AKsEffekt (small blind) folded before Flop
Seat 6: dimetruk (big blind) showed [Th 6h] and won (179) with two pair, Tens and Threes
Seat 7: exjd111 mucked [Ks 4s]
Seat 8: DODGE.WINS folded before Flop (didn't bet)
Seat 9: jwebow folded before Flop (didn't bet)


PokerStars Hand #226550044223: Tournament #3188920119, $27.40+$2.60 USD Hold'em No Limit - Level III (25/50) - 2021/05/07 23:16:04 MSK [2021/05/07 16:16:04 ET]
Table '3188920119 1' 9-max Seat #5 is the button
Seat 1: Maus219 (1523 in chips)
Seat 2: rumred14 (1097 in chips)
Seat 3: Gimbel 2 (1862 in chips)
Seat 4: Strannaya (1525 in chips)
Seat 5: AKsEffekt (1266 in chips)
Seat 6: dimetruk (1880 in chips)
Seat 7: exjd111 (857 in chips)
Seat 8: DODGE.WINS (1680 in chips)
Seat 9: jwebow (1810 in chips)
Maus219: posts the ante 6
rumred14: posts the ante 6
Gimbel 2: posts the ante 6
Strannaya: posts the ante 6
AKsEffekt: posts the ante 6
dimetruk: posts the ante 6
exjd111: posts the ante 6
DODGE.WINS: posts the ante 6
jwebow: posts the ante 6
dimetruk: posts small blind 25
exjd111: posts big blind 50
*** HOLE CARDS ***
Dealt to dimetruk [Qs Kc]
DODGE.WINS: folds
jwebow: folds
Maus219: folds
rumred14: folds
Gimbel 2: calls 50
Strannaya: folds
AKsEffekt: folds
dimetruk: raises 100 to 150
exjd111: calls 100
Gimbel 2: calls 100
*** FLOP *** [9d 4s 2d]
dimetruk: bets 252
exjd111: calls 252
Gimbel 2: folds
*** TURN *** [9d 4s 2d] [8h]
dimetruk: bets 500
exjd111: folds
Uncalled bet (500) returned to dimetruk
dimetruk collected 1008 from pot
dimetruk: doesn't show hand
*** SUMMARY ***
Total pot 1008 | Rake 0
Board [9d 4s 2d 8h]
Seat 1: Maus219 folded before Flop (didn't bet)
Seat 2: rumred14 folded before Flop (didn't bet)
Seat 3: Gimbel 2 folded on the Flop
Seat 4: Strannaya folded before Flop (didn't bet)
Seat 5: AKsEffekt (button) folded before Flop (didn't bet)
Seat 6: dimetruk (small blind) collected (1008)
Seat 7: exjd111 (big blind) folded on the Turn
Seat 8: DODGE.WINS folded before Flop (didn't bet)
Seat 9: jwebow folded before Flop (didn't bet)


PokerStars Hand #226550158204: Tournament #3188920119, $27.40+$2.60 USD Hold'em No Limit - Level III (25/50) - 2021/05/07 23:18:50 MSK [2021/05/07 16:18:50 ET]
Table '3188920119 1' 9-max Seat #8 is the button
Seat 1: Maus219 (1505 in chips)
Seat 2: rumred14 (1079 in chips)
Seat 3: Gimbel 2 (1644 in chips)
Seat 4: Strannaya (2254 in chips)
Seat 5: AKsEffekt (1093 in chips)
Seat 6: dimetruk (2468 in chips)
Seat 7: exjd111 (412 in chips)
Seat 8: DODGE.WINS (1303 in chips)
Seat 9: jwebow (1742 in chips)
Maus219: posts the ante 6
rumred14: posts the ante 6
Gimbel 2: posts the ante 6
Strannaya: posts the ante 6
AKsEffekt: posts the ante 6
dimetruk: posts the ante 6
exjd111: posts the ante 6
DODGE.WINS: posts the ante 6
jwebow: posts the ante 6
jwebow: posts small blind 25
Maus219: posts big blind 50
*** HOLE CARDS ***
Dealt to dimetruk [Td Ad]
rumred14: folds
Gimbel 2: folds
Strannaya: folds
AKsEffekt: folds
dimetruk: raises 50 to 100
exjd111: raises 306 to 406 and is all-in
DODGE.WINS: folds
jwebow: folds
Maus219: folds
dimetruk: calls 306
*** FLOP *** [6s 2s 5h]
*** TURN *** [6s 2s 5h] [5c]
*** RIVER *** [6s 2s 5h 5c] [7h]
*** SHOW DOWN ***
dimetruk: shows [Td Ad] (a pair of Fives)
exjd111: shows [Ac 3h] (a pair of Fives - lower kicker)
dimetruk collected 941 from pot
exjd111 finished the tournament in 9th place
*** SUMMARY ***
Total pot 941 | Rake 0
Board [6s 2s 5h 5c 7h]
Seat 1: Maus219 (big blind) folded before Flop
Seat 2: rumred14 folded before Flop (didn't bet)
Seat 3: Gimbel 2 folded before Flop (didn't bet)
Seat 4: Strannaya folded before Flop (didn't bet)
Seat 5: AKsEffekt folded before Flop (didn't bet)
Seat 6: dimetruk showed [Td Ad] and won (941) with a pair of Fives
Seat 7: exjd111 showed [Ac 3h] and lost with a pair of Fives
Seat 8: DODGE.WINS (button) folded before Flop (didn't bet)
Seat 9: jwebow (small blind) folded before Flop


PokerStars Hand #226550276240: Tournament #3188920119, $27.40+$2.60 USD Hold'em No Limit - Level III (25/50) - 2021/05/07 23:21:31 MSK [2021/05/07 16:21:31 ET]
Table '3188920119 1' 9-max Seat #4 is the button
Seat 1: Maus219 (1400 in chips)
Seat 2: rumred14 (974 in chips)
Seat 3: Gimbel 2 (1662 in chips)
Seat 4: Strannaya (2272 in chips)
Seat 5: AKsEffekt (1086 in chips)
Seat 6: dimetruk (2973 in chips)
Seat 8: DODGE.WINS (1273 in chips)
Seat 9: jwebow (1860 in chips)
Maus219: posts the ante 6
rumred14: posts the ante 6
Gimbel 2: posts the ante 6
Strannaya: posts the ante 6
AKsEffekt: posts the ante 6
dimetruk: posts the ante 6
DODGE.WINS: posts the ante 6
jwebow: posts the ante 6
AKsEffekt: posts small blind 25
dimetruk: posts big blind 50
*** HOLE CARDS ***
Dealt to dimetruk [Tc Ah]
DODGE.WINS: folds
jwebow: calls 50
Maus219: folds
rumred14: folds
Gimbel 2: calls 50
Strannaya: folds
AKsEffekt: folds
dimetruk: checks
*** FLOP *** [8c 5h Td]
dimetruk: checks
jwebow: checks
Gimbel 2: bets 223
dimetruk: raises 2694 to 2917 and is all-in
jwebow: folds
Gimbel 2: folds
Uncalled bet (2694) returned to dimetruk
dimetruk collected 669 from pot
dimetruk: doesn't show hand
*** SUMMARY ***
Total pot 669 | Rake 0
Board [8c 5h Td]
Seat 1: Maus219 folded before Flop (didn't bet)
Seat 2: rumred14 folded before Flop (didn't bet)
Seat 3: Gimbel 2 folded on the Flop
Seat 4: Strannaya (button) folded before Flop (didn't bet)
Seat 5: AKsEffekt (small blind) folded before Flop
Seat 6: dimetruk (big blind) collected (669)
Seat 8: DODGE.WINS folded before Flop (didn't bet)
Seat 9: jwebow folded on the Flop


PokerStars Hand #226550668579: Tournament #3188920119, $27.40+$2.60 USD Hold'em No Limit - Level IV (40/80) - 2021/05/07 23:31:05 MSK [2021/05/07 16:31:05 ET]
Table '3188920119 1' 9-max Seat #4 is the button
Seat 1: Maus219 (1778 in chips)
Seat 3: Gimbel 2 (2023 in chips)
Seat 4: Strannaya (2410 in chips)
Seat 5: AKsEffekt (1305 in chips)
Seat 6: dimetruk (3253 in chips)
Seat 8: DODGE.WINS (1317 in chips)
Seat 9: jwebow (1414 in chips)
Maus219: posts the ante 10
Gimbel 2: posts the ante 10
Strannaya: posts the ante 10
AKsEffekt: posts the ante 10
dimetruk: posts the ante 10
DODGE.WINS: posts the ante 10
jwebow: posts the ante 10
AKsEffekt: posts small blind 40
dimetruk: posts big blind 80
*** HOLE CARDS ***
Dealt to dimetruk [3d Ac]
DODGE.WINS: folds
jwebow: folds
Maus219: folds
Gimbel 2: folds
Strannaya: raises 94 to 174
AKsEffekt: folds
dimetruk: calls 94
*** FLOP *** [Th Kh Jh]
dimetruk: checks
Strannaya: bets 160
dimetruk: folds
Uncalled bet (160) returned to Strannaya
Strannaya collected 458 from pot
Strannaya: doesn't show hand
*** SUMMARY ***
Total pot 458 | Rake 0
Board [Th Kh Jh]
Seat 1: Maus219 folded before Flop (didn't bet)
Seat 3: Gimbel 2 folded before Flop (didn't bet)
Seat 4: Strannaya (button) collected (458)
Seat 5: AKsEffekt (small blind) folded before Flop
Seat 6: dimetruk (big blind) folded on the Flop
Seat 8: DODGE.WINS folded before Flop (didn't bet)
Seat 9: jwebow folded before Flop (didn't bet)


PokerStars Hand #226550698077: Tournament #3188920119, $27.40+$2.60 USD Hold'em No Limit - Level IV (40/80) - 2021/05/07 23:31:49 MSK [2021/05/07 16:31:49 ET]
Table '3188920119 1' 9-max Seat #6 is the button
Seat 1: Maus219 (1758 in chips)
Seat 3: Gimbel 2 (2003 in chips)
Seat 4: Strannaya (2674 in chips)
Seat 5: AKsEffekt (1245 in chips)
Seat 6: dimetruk (3019 in chips)
Seat 8: DODGE.WINS (1407 in chips)
Seat 9: jwebow (1394 in chips)
Maus219: posts the ante 10
Gimbel 2: posts the ante 10
Strannaya: posts the ante 10
AKsEffekt: posts the ante 10
dimetruk: posts the ante 10
DODGE.WINS: posts the ante 10
jwebow: posts the ante 10
DODGE.WINS: posts small blind 40
jwebow: posts big blind 80
*** HOLE CARDS ***
Dealt to dimetruk [Ts 7s]
Maus219: folds
Gimbel 2: folds
Strannaya: folds
AKsEffekt: folds
dimetruk: raises 80 to 160
DODGE.WINS: calls 120
jwebow: calls 80
*** FLOP *** [4d 9c Kh]
DODGE.WINS: checks
jwebow: checks
dimetruk: checks
*** TURN *** [4d 9c Kh] [4h]
DODGE.WINS: bets 240
jwebow: folds
dimetruk: folds
Uncalled bet (240) returned to DODGE.WINS
DODGE.WINS collected 550 from pot
DODGE.WINS: doesn't show hand
*** SUMMARY ***
Total pot 550 | Rake 0
Board [4d 9c Kh 4h]
Seat 1: Maus219 folded before Flop (didn't bet)
Seat 3: Gimbel 2 folded before Flop (didn't bet)
Seat 4: Strannaya folded before Flop (didn't bet)
Seat 5: AKsEffekt folded before Flop (didn't bet)
Seat 6: dimetruk (button) folded on the Turn
Seat 8: DODGE.WINS (small blind) collected (550)
Seat 9: jwebow (big blind) folded on the Turn


PokerStars Hand #226550744000: Tournament #3188920119, $27.40+$2.60 USD Hold'em No Limit - Level V (60/120) - 2021/05/07 23:32:57 MSK [2021/05/07 16:32:57 ET]
Table '3188920119 1' 9-max Seat #9 is the button
Seat 1: Maus219 (1613 in chips)
Seat 3: Gimbel 2 (1978 in chips)
Seat 4: Strannaya (2934 in chips)
Seat 5: AKsEffekt (1220 in chips)
Seat 6: dimetruk (2834 in chips)
Seat 8: DODGE.WINS (1772 in chips)
Seat 9: jwebow (1149 in chips)
Maus219: posts the ante 15
Gimbel 2: posts the ante 15
Strannaya: posts the ante 15
AKsEffekt: posts the ante 15
dimetruk: posts the ante 15
DODGE.WINS: posts the ante 15
jwebow: posts the ante 15
Maus219: posts small blind 60
Gimbel 2: posts big blind 120
*** HOLE CARDS ***
Dealt to dimetruk [Tc Qh]
Strannaya: folds
AKsEffekt: folds
dimetruk: raises 120 to 240
DODGE.WINS: folds
jwebow: calls 240
Maus219: folds
Gimbel 2: calls 120
*** FLOP *** [4c 6h 8s]
Gimbel 2: checks
dimetruk: checks
jwebow: bets 894 and is all-in
Gimbel 2: folds
dimetruk: folds
Uncalled bet (894) returned to jwebow
jwebow collected 885 from pot
*** SUMMARY ***
Total pot 885 | Rake 0
Board [4c 6h 8s]
Seat 1: Maus219 (small blind) folded before Flop
Seat 3: Gimbel 2 (big blind) folded on the Flop
Seat 4: Strannaya folded before Flop (didn't bet)
Seat 5: AKsEffekt folded before Flop (didn't bet)
Seat 6: dimetruk folded on the Flop
Seat 8: DODGE.WINS folded before Flop (didn't bet)
Seat 9: jwebow (button) collected (885)


PokerStars Hand #226550825158: Tournament #3188920119, $27.40+$2.60 USD Hold'em No Limit - Level V (60/120) - 2021/05/07 23:34:56 MSK [2021/05/07 16:34:56 ET]
Table '3188920119 1' 9-max Seat #4 is the button
Seat 1: Maus219 (1508 in chips)
Seat 3: Gimbel 2 (1633 in chips)
Seat 4: Strannaya (2529 in chips)
Seat 5: AKsEffekt (1055 in chips)
Seat 6: dimetruk (2549 in chips)
Seat 8: DODGE.WINS (2012 in chips)
Seat 9: jwebow (2214 in chips)
Maus219: posts the ante 15
Gimbel 2: posts the ante 15
Strannaya: posts the ante 15
AKsEffekt: posts the ante 15
dimetruk: posts the ante 15
DODGE.WINS: posts the ante 15
jwebow: posts the ante 15
AKsEffekt: posts small blind 60
dimetruk: posts big blind 120
*** HOLE CARDS ***
Dealt to dimetruk [2c Ad]
DODGE.WINS: folds
jwebow: raises 120 to 240
Maus219: folds
Gimbel 2: folds
Strannaya: folds
AKsEffekt: folds
dimetruk: calls 120
*** FLOP *** [Qs 3c Qd]
dimetruk: checks
jwebow: checks
*** TURN *** [Qs 3c Qd] [7d]
dimetruk: bets 213
jwebow: folds
Uncalled bet (213) returned to dimetruk
dimetruk collected 645 from pot
dimetruk: doesn't show hand
*** SUMMARY ***
Total pot 645 | Rake 0
Board [Qs 3c Qd 7d]
Seat 1: Maus219 folded before Flop (didn't bet)
Seat 3: Gimbel 2 folded before Flop (didn't bet)
Seat 4: Strannaya (button) folded before Flop (didn't bet)
Seat 5: AKsEffekt (small blind) folded before Flop
Seat 6: dimetruk (big blind) collected (645)
Seat 8: DODGE.WINS folded before Flop (didn't bet)
Seat 9: jwebow folded on the Turn


PokerStars Hand #226550879919: Tournament #3188920119, $27.40+$2.60 USD Hold'em No Limit - Level V (60/120) - 2021/05/07 23:36:18 MSK [2021/05/07 16:36:18 ET]
Table '3188920119 1' 9-max Seat #8 is the button
Seat 1: Maus219 (1463 in chips)
Seat 3: Gimbel 2 (1588 in chips)
Seat 4: Strannaya (2769 in chips)
Seat 5: AKsEffekt (1235 in chips)
Seat 6: dimetruk (2849 in chips)
Seat 8: DODGE.WINS (1787 in chips)
Seat 9: jwebow (1809 in chips)
Maus219: posts the ante 15
Gimbel 2: posts the ante 15
Strannaya: posts the ante 15
AKsEffekt: posts the ante 15
dimetruk: posts the ante 15
DODGE.WINS: posts the ante 15
jwebow: posts the ante 15
jwebow: posts small blind 60
Maus219: posts big blind 120
*** HOLE CARDS ***
Dealt to dimetruk [7s 6s]
Gimbel 2: folds
Strannaya: folds
AKsEffekt: folds
dimetruk: raises 120 to 240
DODGE.WINS: calls 240
jwebow: calls 180
Maus219: folds
*** FLOP *** [3c 8d 4h]
jwebow: checks
dimetruk: bets 312
DODGE.WINS: folds
jwebow: folds
Uncalled bet (312) returned to dimetruk
dimetruk collected 945 from pot
dimetruk: doesn't show hand
*** SUMMARY ***
Total pot 945 | Rake 0
Board [3c 8d 4h]
Seat 1: Maus219 (big blind) folded before Flop
Seat 3: Gimbel 2 folded before Flop (didn't bet)
Seat 4: Strannaya folded before Flop (didn't bet)
Seat 5: AKsEffekt folded before Flop (didn't bet)
Seat 6: dimetruk collected (945)
Seat 8: DODGE.WINS (button) folded on the Flop
Seat 9: jwebow (small blind) folded on the Flop


PokerStars Hand #226551070071: Tournament #3188920119, $27.40+$2.60 USD Hold'em No Limit - Level V (60/120) - 2021/05/07 23:40:45 MSK [2021/05/07 16:40:45 ET]
Table '3188920119 1' 9-max Seat #4 is the button
Seat 1: Maus219 (1508 in chips)
Seat 3: Gimbel 2 (1348 in chips)
Seat 4: Strannaya (1884 in chips)
Seat 5: AKsEffekt (1055 in chips)
Seat 6: dimetruk (3779 in chips)
Seat 8: DODGE.WINS (2132 in chips)
Seat 9: jwebow (1794 in chips)
Maus219: posts the ante 15
Gimbel 2: posts the ante 15
Strannaya: posts the ante 15
AKsEffekt: posts the ante 15
dimetruk: posts the ante 15
DODGE.WINS: posts the ante 15
jwebow: posts the ante 15
AKsEffekt: posts small blind 60
dimetruk: posts big blind 120
*** HOLE CARDS ***
Dealt to dimetruk [Th 4h]
DODGE.WINS: folds
jwebow: folds
Maus219: calls 120
Gimbel 2: folds
Strannaya: folds
AKsEffekt: folds
dimetruk: checks
*** FLOP *** [Kd 4d 9c]
dimetruk: checks
Maus219: bets 120
dimetruk: calls 120
*** TURN *** [Kd 4d 9c] [4s]
dimetruk: checks
Maus219: bets 290
dimetruk: raises 3130 to 3420
Maus219: calls 963 and is all-in
Uncalled bet (2167) returned to dimetruk
*** RIVER *** [Kd 4d 9c 4s] [6c]
*** SHOW DOWN ***
dimetruk: shows [Th 4h] (three of a kind, Fours)
Maus219: shows [Kh Ks] (a full house, Kings full of Fours)
Maus219 collected 3151 from pot
*** SUMMARY ***
Total pot 3151 | Rake 0
Board [Kd 4d 9c 4s 6c]
Seat 1: Maus219 showed [Kh Ks] and won (3151) with a full house, Kings full of Fours
Seat 3: Gimbel 2 folded before Flop (didn't bet)
Seat 4: Strannaya (button) folded before Flop (didn't bet)
Seat 5: AKsEffekt (small blind) folded before Flop
Seat 6: dimetruk (big blind) showed [Th 4h] and lost with three of a kind, Fours
Seat 8: DODGE.WINS folded before Flop (didn't bet)
Seat 9: jwebow folded before Flop (didn't bet)


PokerStars Hand #226551205112: Tournament #3188920119, $27.40+$2.60 USD Hold'em No Limit - Level VI (80/160) - 2021/05/07 23:44:07 MSK [2021/05/07 16:44:07 ET]
Table '3188920119 1' 9-max Seat #4 is the button
Seat 1: Maus219 (1867 in chips)
Seat 3: Gimbel 2 (1648 in chips)
Seat 4: Strannaya (3498 in chips)
Seat 5: AKsEffekt (710 in chips)
Seat 6: dimetruk (2101 in chips)
Seat 8: DODGE.WINS (1827 in chips)
Seat 9: jwebow (1849 in chips)
Maus219: posts the ante 20
Gimbel 2: posts the ante 20
Strannaya: posts the ante 20
AKsEffekt: posts the ante 20
dimetruk: posts the ante 20
DODGE.WINS: posts the ante 20
jwebow: posts the ante 20
AKsEffekt: posts small blind 80
dimetruk: posts big blind 160
*** HOLE CARDS ***
Dealt to dimetruk [8d Qd]
DODGE.WINS: folds
jwebow: folds
Maus219: folds
Gimbel 2: folds
Strannaya: raises 160 to 320
AKsEffekt: folds
dimetruk: calls 160
*** FLOP *** [7c 9s 2s]
dimetruk: checks
Strannaya: checks
*** TURN *** [7c 9s 2s] [Td]
dimetruk: bets 1761 and is all-in
Strannaya: folds
Uncalled bet (1761) returned to dimetruk
dimetruk collected 860 from pot
dimetruk: doesn't show hand
*** SUMMARY ***
Total pot 860 | Rake 0
Board [7c 9s 2s Td]
Seat 1: Maus219 folded before Flop (didn't bet)
Seat 3: Gimbel 2 folded before Flop (didn't bet)
Seat 4: Strannaya (button) folded on the Turn
Seat 5: AKsEffekt (small blind) folded before Flop
Seat 6: dimetruk (big blind) collected (860)
Seat 8: DODGE.WINS folded before Flop (didn't bet)
Seat 9: jwebow folded before Flop (didn't bet)


PokerStars Hand #226551263557: Tournament #3188920119, $27.40+$2.60 USD Hold'em No Limit - Level VI (80/160) - 2021/05/07 23:45:34 MSK [2021/05/07 16:45:34 ET]
Table '3188920119 1' 9-max Seat #8 is the button
Seat 1: Maus219 (2757 in chips)
Seat 3: Gimbel 2 (1968 in chips)
Seat 4: Strannaya (3118 in chips)
Seat 6: dimetruk (2501 in chips)
Seat 8: DODGE.WINS (1527 in chips)
Seat 9: jwebow (1629 in chips)
Maus219: posts the ante 20
Gimbel 2: posts the ante 20
Strannaya: posts the ante 20
dimetruk: posts the ante 20
DODGE.WINS: posts the ante 20
jwebow: posts the ante 20
jwebow: posts small blind 80
Maus219: posts big blind 160
*** HOLE CARDS ***
Dealt to dimetruk [5c 8c]
Gimbel 2: folds
Strannaya: folds
dimetruk: raises 160 to 320
DODGE.WINS: folds
jwebow: folds
Maus219: calls 160
*** FLOP *** [Jh Qh 8s]
Maus219: checks
dimetruk: bets 277
Maus219: calls 277
*** TURN *** [Jh Qh 8s] [7s]
Maus219: checks
dimetruk: bets 460
Maus219: folds
Uncalled bet (460) returned to dimetruk
dimetruk collected 1394 from pot
dimetruk: doesn't show hand
*** SUMMARY ***
Total pot 1394 | Rake 0
Board [Jh Qh 8s 7s]
Seat 1: Maus219 (big blind) folded on the Turn
Seat 3: Gimbel 2 folded before Flop (didn't bet)
Seat 4: Strannaya folded before Flop (didn't bet)
Seat 6: dimetruk collected (1394)
Seat 8: DODGE.WINS (button) folded before Flop (didn't bet)
Seat 9: jwebow (small blind) folded before Flop


PokerStars Hand #226551342105: Tournament #3188920119, $27.40+$2.60 USD Hold'em No Limit - Level VI (80/160) - 2021/05/07 23:47:30 MSK [2021/05/07 16:47:30 ET]
Table '3188920119 1' 9-max Seat #4 is the button
Seat 1: Maus219 (2000 in chips)
Seat 3: Gimbel 2 (1648 in chips)
Seat 4: Strannaya (3478 in chips)
Seat 6: dimetruk (3058 in chips)
Seat 8: DODGE.WINS (1807 in chips)
Seat 9: jwebow (1509 in chips)
Maus219: posts the ante 20
Gimbel 2: posts the ante 20
Strannaya: posts the ante 20
dimetruk: posts the ante 20
DODGE.WINS: posts the ante 20
jwebow: posts the ante 20
dimetruk: posts small blind 80
DODGE.WINS: posts big blind 160
*** HOLE CARDS ***
Dealt to dimetruk [7h 3s]
jwebow: folds
Maus219: folds
Gimbel 2: folds
Strannaya: folds
dimetruk: raises 160 to 320
DODGE.WINS: calls 160
*** FLOP *** [Ah 7c 2h]
dimetruk: bets 251
DODGE.WINS: calls 251
*** TURN *** [Ah 7c 2h] [3c]
dimetruk: bets 1600
DODGE.WINS: folds
Uncalled bet (1600) returned to dimetruk
dimetruk collected 1262 from pot
dimetruk: doesn't show hand
*** SUMMARY ***
Total pot 1262 | Rake 0
Board [Ah 7c 2h 3c]
Seat 1: Maus219 folded before Flop (didn't bet)
Seat 3: Gimbel 2 folded before Flop (didn't bet)
Seat 4: Strannaya (button) folded before Flop (didn't bet)
Seat 6: dimetruk (small blind) collected (1262)
Seat 8: DODGE.WINS (big blind) folded on the Turn
Seat 9: jwebow folded before Flop (didn't bet)


PokerStars Hand #226551446551: Tournament #3188920119, $27.40+$2.60 USD Hold'em No Limit - Level VI (80/160) - 2021/05/07 23:50:00 MSK [2021/05/07 16:50:00 ET]
Table '3188920119 1' 9-max Seat #6 is the button
Seat 3: Gimbel 2 (1788 in chips)
Seat 4: Strannaya (3118 in chips)
Seat 6: dimetruk (3069 in chips)
Seat 8: DODGE.WINS (3432 in chips)
Seat 9: jwebow (2093 in chips)
Gimbel 2: posts the ante 20
Strannaya: posts the ante 20
dimetruk: posts the ante 20
DODGE.WINS: posts the ante 20
jwebow: posts the ante 20
DODGE.WINS: posts small blind 80
jwebow: posts big blind 160
*** HOLE CARDS ***
Dealt to dimetruk [7c 7h]
Gimbel 2: folds
Strannaya: raises 160 to 320
dimetruk: calls 320
DODGE.WINS: folds
jwebow: calls 160
*** FLOP *** [5c Td 2h]
jwebow: checks
Strannaya: bets 616
dimetruk: calls 616
jwebow: folds
*** TURN *** [5c Td 2h] [Kh]
Strannaya: bets 2162 and is all-in
dimetruk: folds
Uncalled bet (2162) returned to Strannaya
Strannaya collected 2372 from pot
Strannaya: doesn't show hand
*** SUMMARY ***
Total pot 2372 | Rake 0
Board [5c Td 2h Kh]
Seat 3: Gimbel 2 folded before Flop (didn't bet)
Seat 4: Strannaya collected (2372)
Seat 6: dimetruk (button) folded on the Turn
Seat 8: DODGE.WINS (small blind) folded before Flop
Seat 9: jwebow (big blind) folded on the Flop


PokerStars Hand #226551658594: Tournament #3188920119, $27.40+$2.60 USD Hold'em No Limit - Level VII (100/200) - 2021/05/07 23:55:39 MSK [2021/05/07 16:55:39 ET]
Table '3188920119 1' 9-max Seat #4 is the button
Seat 3: Gimbel 2 (2456 in chips)
Seat 4: Strannaya (1128 in chips)
Seat 6: dimetruk (3348 in chips)
Seat 8: DODGE.WINS (3717 in chips)
Seat 9: jwebow (2851 in chips)
Gimbel 2: posts the ante 25
Strannaya: posts the ante 25
dimetruk: posts the ante 25
DODGE.WINS: posts the ante 25
jwebow: posts the ante 25
dimetruk: posts small blind 100
DODGE.WINS: posts big blind 200
*** HOLE CARDS ***
Dealt to dimetruk [Kc Ac]
jwebow: folds
Gimbel 2: raises 2231 to 2431 and is all-in
Strannaya: folds
dimetruk: raises 892 to 3323 and is all-in
DODGE.WINS: folds
Uncalled bet (892) returned to dimetruk
*** FLOP *** [8s 6c Qs]
*** TURN *** [8s 6c Qs] [5h]
*** RIVER *** [8s 6c Qs 5h] [9d]
*** SHOW DOWN ***
dimetruk: shows [Kc Ac] (high card Ace)
Gimbel 2: shows [Ts Tc] (a pair of Tens)
Gimbel 2 collected 5187 from pot
*** SUMMARY ***
Total pot 5187 | Rake 0
Board [8s 6c Qs 5h 9d]
Seat 3: Gimbel 2 showed [Ts Tc] and won (5187) with a pair of Tens
Seat 4: Strannaya (button) folded before Flop (didn't bet)
Seat 6: dimetruk (small blind) showed [Kc Ac] and lost with high card Ace
Seat 8: DODGE.WINS (big blind) folded before Flop
Seat 9: jwebow folded before Flop (didn't bet)


PokerStars Hand #226551670889: Tournament #3188920119, $27.40+$2.60 USD Hold'em No Limit - Level VII (100/200) - 2021/05/07 23:56:07 MSK [2021/05/07 16:56:07 ET]
Table '3188920119 1' 9-max Seat #6 is the button
Seat 3: Gimbel 2 (5187 in chips)
Seat 4: Strannaya (1103 in chips)
Seat 6: dimetruk (892 in chips)
Seat 8: DODGE.WINS (3492 in chips)
Seat 9: jwebow (2826 in chips)
Gimbel 2: posts the ante 25
Strannaya: posts the ante 25
dimetruk: posts the ante 25
DODGE.WINS: posts the ante 25
jwebow: posts the ante 25
DODGE.WINS: posts small blind 100
jwebow: posts big blind 200
*** HOLE CARDS ***
Dealt to dimetruk [Tc Ts]
Gimbel 2: calls 200
Strannaya: raises 200 to 400
dimetruk: raises 467 to 867 and is all-in
DODGE.WINS: folds
jwebow: folds
Gimbel 2: raises 467 to 1334
Strannaya: calls 678 and is all-in
Uncalled bet (256) returned to Gimbel 2
*** FLOP *** [Jc Jd Qd]
*** TURN *** [Jc Jd Qd] [Kc]
*** RIVER *** [Jc Jd Qd Kc] [Td]
*** SHOW DOWN ***
Gimbel 2: shows [8h 8s] (two pair, Jacks and Eights)
Strannaya: shows [9c 9d] (a straight, Nine to King)
Strannaya collected 422 from side pot
dimetruk: shows [Tc Ts] (a full house, Tens full of Jacks)
dimetruk collected 3026 from main pot
*** SUMMARY ***
Total pot 3448 Main pot 3026. Side pot 422. | Rake 0
Board [Jc Jd Qd Kc Td]
Seat 3: Gimbel 2 showed [8h 8s] and lost with two pair, Jacks and Eights
Seat 4: Strannaya showed [9c 9d] and won (422) with a straight, Nine to King
Seat 6: dimetruk (button) showed [Tc Ts] and won (3026) with a full house, Tens full of Jacks
Seat 8: DODGE.WINS (small blind) folded before Flop
Seat 9: jwebow (big blind) folded before Flop


PokerStars Hand #226551692092: Tournament #3188920119, $27.40+$2.60 USD Hold'em No Limit - Level VII (100/200) - 2021/05/07 23:56:55 MSK [2021/05/07 16:56:55 ET]
Table '3188920119 1' 9-max Seat #8 is the button
Seat 3: Gimbel 2 (4084 in chips)
Seat 4: Strannaya (422 in chips)
Seat 6: dimetruk (3026 in chips)
Seat 8: DODGE.WINS (3367 in chips)
Seat 9: jwebow (2601 in chips)
Gimbel 2: posts the ante 25
Strannaya: posts the ante 25
dimetruk: posts the ante 25
DODGE.WINS: posts the ante 25
jwebow: posts the ante 25
jwebow: posts small blind 100
Gimbel 2: posts big blind 200
*** HOLE CARDS ***
Dealt to dimetruk [As Jc]
Strannaya: folds
dimetruk: raises 2801 to 3001 and is all-in
DODGE.WINS: folds
jwebow: calls 2476 and is all-in
Gimbel 2: folds
Uncalled bet (425) returned to dimetruk
*** FLOP *** [Qd Ah Jh]
*** TURN *** [Qd Ah Jh] [9c]
*** RIVER *** [Qd Ah Jh 9c] [3h]
*** SHOW DOWN ***
jwebow: shows [Kh Ac] (a pair of Aces)
dimetruk: shows [As Jc] (two pair, Aces and Jacks)
dimetruk collected 5477 from pot
jwebow finished the tournament in 5th place
*** SUMMARY ***
Total pot 5477 | Rake 0
Board [Qd Ah Jh 9c 3h]
Seat 3: Gimbel 2 (big blind) folded before Flop
Seat 4: Strannaya folded before Flop (didn't bet)
Seat 6: dimetruk showed [As Jc] and won (5477) with two pair, Aces and Jacks
Seat 8: DODGE.WINS (button) folded before Flop (didn't bet)
Seat 9: jwebow (small blind) showed [Kh Ac] and lost with a pair of Aces


PokerStars Hand #226551702686: Tournament #3188920119, $27.40+$2.60 USD Hold'em No Limit - Level VII (100/200) - 2021/05/07 23:57:18 MSK [2021/05/07 16:57:18 ET]
Table '3188920119 1' 9-max Seat #3 is the button
Seat 3: Gimbel 2 (3859 in chips)
Seat 4: Strannaya (397 in chips)
Seat 6: dimetruk (5902 in chips)
Seat 8: DODGE.WINS (3342 in chips)
Gimbel 2: posts the ante 25
Strannaya: posts the ante 25
dimetruk: posts the ante 25
DODGE.WINS: posts the ante 25
Strannaya: posts small blind 100
dimetruk: posts big blind 200
*** HOLE CARDS ***
Dealt to dimetruk [2h Kh]
DODGE.WINS: folds
Gimbel 2: folds
Strannaya: raises 172 to 372 and is all-in
dimetruk: calls 172
*** FLOP *** [Qs 2s 6h]
*** TURN *** [Qs 2s 6h] [3d]
*** RIVER *** [Qs 2s 6h 3d] [Qd]
*** SHOW DOWN ***
Strannaya: shows [5c Jc] (a pair of Queens)
dimetruk: shows [2h Kh] (two pair, Queens and Deuces)
dimetruk collected 844 from pot
Strannaya finished the tournament in 4th place
*** SUMMARY ***
Total pot 844 | Rake 0
Board [Qs 2s 6h 3d Qd]
Seat 3: Gimbel 2 (button) folded before Flop (didn't bet)
Seat 4: Strannaya (small blind) showed [5c Jc] and lost with a pair of Queens
Seat 6: dimetruk (big blind) showed [2h Kh] and won (844) with two pair, Queens and Deuces
Seat 8: DODGE.WINS folded before Flop (didn't bet)


PokerStars Hand #226551716012: Tournament #3188920119, $27.40+$2.60 USD Hold'em No Limit - Level VII (100/200) - 2021/05/07 23:57:48 MSK [2021/05/07 16:57:48 ET]
Table '3188920119 1' 9-max Seat #8 is the button
Seat 3: Gimbel 2 (3609 in chips)
Seat 6: dimetruk (6324 in chips)
Seat 8: DODGE.WINS (3567 in chips)
Gimbel 2: posts the ante 25
dimetruk: posts the ante 25
DODGE.WINS: posts the ante 25
Gimbel 2: posts small blind 100
dimetruk: posts big blind 200
*** HOLE CARDS ***
Dealt to dimetruk [5h 7h]
DODGE.WINS: folds
Gimbel 2: calls 100
dimetruk: checks
*** FLOP *** [Jh Js 7d]
Gimbel 2: checks
dimetruk: bets 200
Gimbel 2: calls 200
*** TURN *** [Jh Js 7d] [5d]
Gimbel 2: checks
dimetruk: bets 438
Gimbel 2: calls 438
*** RIVER *** [Jh Js 7d 5d] [Qs]
Gimbel 2: checks
dimetruk: checks
*** SHOW DOWN ***
Gimbel 2: shows [As Ah] (two pair, Aces and Jacks)
dimetruk: mucks hand
Gimbel 2 collected 1751 from pot
*** SUMMARY ***
Total pot 1751 | Rake 0
Board [Jh Js 7d 5d Qs]
Seat 3: Gimbel 2 (small blind) showed [As Ah] and won (1751) with two pair, Aces and Jacks
Seat 6: dimetruk (big blind) mucked [5h 7h]
Seat 8: DODGE.WINS (button) folded before Flop (didn't bet)


PokerStars Hand #226551757396: Tournament #3188920119, $27.40+$2.60 USD Hold'em No Limit - Level VII (100/200) - 2021/05/07 23:59:19 MSK [2021/05/07 16:59:19 ET]
Table '3188920119 1' 9-max Seat #8 is the button
Seat 3: Gimbel 2 (4247 in chips)
Seat 6: dimetruk (5686 in chips)
Seat 8: DODGE.WINS (3567 in chips)
Gimbel 2: posts the ante 25
dimetruk: posts the ante 25
DODGE.WINS: posts the ante 25
Gimbel 2: posts small blind 100
dimetruk: posts big blind 200
*** HOLE CARDS ***
Dealt to dimetruk [5h 5s]
DODGE.WINS: raises 200 to 400
Gimbel 2: folds
dimetruk: calls 200
*** FLOP *** [Jh Ks 4h]
dimetruk: checks
DODGE.WINS: bets 400
dimetruk: folds
Uncalled bet (400) returned to DODGE.WINS
DODGE.WINS collected 975 from pot
DODGE.WINS: doesn't show hand
*** SUMMARY ***
Total pot 975 | Rake 0
Board [Jh Ks 4h]
Seat 3: Gimbel 2 (small blind) folded before Flop
Seat 6: dimetruk (big blind) folded on the Flop
Seat 8: DODGE.WINS (button) collected (975)


PokerStars Hand #226551798248: Tournament #3188920119, $27.40+$2.60 USD Hold'em No Limit - Level VII (100/200) - 2021/05/08 0:00:48 MSK [2021/05/07 17:00:48 ET]
Table '3188920119 1' 9-max Seat #8 is the button
Seat 3: Gimbel 2 (3672 in chips)
Seat 6: dimetruk (5486 in chips)
Seat 8: DODGE.WINS (4342 in chips)
Gimbel 2: posts the ante 25
dimetruk: posts the ante 25
DODGE.WINS: posts the ante 25
Gimbel 2: posts small blind 100
dimetruk: posts big blind 200
*** HOLE CARDS ***
Dealt to dimetruk [6h 9s]
DODGE.WINS: raises 200 to 400
Gimbel 2: folds
dimetruk: calls 200
*** FLOP *** [Ad Ah 6c]
dimetruk: checks
DODGE.WINS: bets 400
dimetruk: calls 400
*** TURN *** [Ad Ah 6c] [Ac]
dimetruk: checks
DODGE.WINS: bets 888
dimetruk: calls 888
*** RIVER *** [Ad Ah 6c Ac] [8d]
dimetruk: checks
DODGE.WINS: bets 2629 and is all-in
dimetruk: folds
Uncalled bet (2629) returned to DODGE.WINS
DODGE.WINS collected 3551 from pot
DODGE.WINS: doesn't show hand
*** SUMMARY ***
Total pot 3551 | Rake 0
Board [Ad Ah 6c Ac 8d]
Seat 3: Gimbel 2 (small blind) folded before Flop
Seat 6: dimetruk (big blind) folded on the River
Seat 8: DODGE.WINS (button) collected (3551)


PokerStars Hand #226551883448: Tournament #3188920119, $27.40+$2.60 USD Hold'em No Limit - Level VIII (150/300) - 2021/05/08 0:02:51 MSK [2021/05/07 17:02:51 ET]
Table '3188920119 1' 9-max Seat #3 is the button
Seat 3: Gimbel 2 (2747 in chips)
Seat 6: dimetruk (3798 in chips)
Seat 8: DODGE.WINS (6955 in chips)
Gimbel 2: posts the ante 25
dimetruk: posts the ante 25
DODGE.WINS: posts the ante 25
dimetruk: posts small blind 150
DODGE.WINS: posts big blind 300
*** HOLE CARDS ***
Dealt to dimetruk [6d 7d]
Gimbel 2: calls 300
dimetruk: calls 150
DODGE.WINS: checks
*** FLOP *** [9c 7h Kh]
dimetruk: checks
DODGE.WINS: checks
Gimbel 2: bets 2422 and is all-in
dimetruk: folds
DODGE.WINS: folds
Uncalled bet (2422) returned to Gimbel 2
Gimbel 2 collected 975 from pot
Gimbel 2: doesn't show hand
*** SUMMARY ***
Total pot 975 | Rake 0
Board [9c 7h Kh]
Seat 3: Gimbel 2 (button) collected (975)
Seat 6: dimetruk (small blind) folded on the Flop
Seat 8: DODGE.WINS (big blind) folded on the Flop


PokerStars Hand #226551993501: Tournament #3188920119, $27.40+$2.60 USD Hold'em No Limit - Level VIII (150/300) - 2021/05/08 0:05:36 MSK [2021/05/07 17:05:36 ET]
Table '3188920119 1' 9-max Seat #8 is the button
Seat 3: Gimbel 2 (3072 in chips)
Seat 6: dimetruk (3298 in chips)
Seat 8: DODGE.WINS (7130 in chips)
Gimbel 2: posts the ante 25
dimetruk: posts the ante 25
DODGE.WINS: posts the ante 25
Gimbel 2: posts small blind 150
dimetruk: posts big blind 300
*** HOLE CARDS ***
Dealt to dimetruk [Kh 9c]
DODGE.WINS: raises 300 to 600
Gimbel 2: folds
dimetruk: calls 300
*** FLOP *** [8d Ac 2h]
dimetruk: checks
DODGE.WINS: bets 300
dimetruk: folds
Uncalled bet (300) returned to DODGE.WINS
DODGE.WINS collected 1425 from pot
DODGE.WINS: doesn't show hand
*** SUMMARY ***
Total pot 1425 | Rake 0
Board [8d Ac 2h]
Seat 3: Gimbel 2 (small blind) folded before Flop
Seat 6: dimetruk (big blind) folded on the Flop
Seat 8: DODGE.WINS (button) collected (1425)


PokerStars Hand #226552010682: Tournament #3188920119, $27.40+$2.60 USD Hold'em No Limit - Level VIII (150/300) - 2021/05/08 0:06:02 MSK [2021/05/07 17:06:02 ET]
Table '3188920119 1' 9-max Seat #3 is the button
Seat 3: Gimbel 2 (2897 in chips)
Seat 6: dimetruk (2673 in chips)
Seat 8: DODGE.WINS (7930 in chips)
Gimbel 2: posts the ante 25
dimetruk: posts the ante 25
DODGE.WINS: posts the ante 25
dimetruk: posts small blind 150
DODGE.WINS: posts big blind 300
*** HOLE CARDS ***
Dealt to dimetruk [Ts 6s]
Gimbel 2: folds
dimetruk: calls 150
DODGE.WINS: checks
*** FLOP *** [Ac 5c 9c]
dimetruk: bets 300
DODGE.WINS: calls 300
*** TURN *** [Ac 5c 9c] [2s]
dimetruk: checks
DODGE.WINS: bets 300
dimetruk: folds
Uncalled bet (300) returned to DODGE.WINS
DODGE.WINS collected 1275 from pot
DODGE.WINS: doesn't show hand
*** SUMMARY ***
Total pot 1275 | Rake 0
Board [Ac 5c 9c 2s]
Seat 3: Gimbel 2 (button) folded before Flop (didn't bet)
Seat 6: dimetruk (small blind) folded on the Turn
Seat 8: DODGE.WINS (big blind) collected (1275)


PokerStars Hand #226552037636: Tournament #3188920119, $27.40+$2.60 USD Hold'em No Limit - Level VIII (150/300) - 2021/05/08 0:06:42 MSK [2021/05/07 17:06:42 ET]
Table '3188920119 1' 9-max Seat #8 is the button
Seat 3: Gimbel 2 (3522 in chips)
Seat 6: dimetruk (2023 in chips)
Seat 8: DODGE.WINS (7955 in chips)
Gimbel 2: posts the ante 25
dimetruk: posts the ante 25
DODGE.WINS: posts the ante 25
Gimbel 2: posts small blind 150
dimetruk: posts big blind 300
*** HOLE CARDS ***
Dealt to dimetruk [Td 9h]
DODGE.WINS: raises 300 to 600
Gimbel 2: folds
dimetruk: calls 300
*** FLOP *** [8d 4h 3d]
dimetruk: checks
DODGE.WINS: bets 1425
dimetruk: folds
Uncalled bet (1425) returned to DODGE.WINS
DODGE.WINS collected 1425 from pot
DODGE.WINS: doesn't show hand
*** SUMMARY ***
Total pot 1425 | Rake 0
Board [8d 4h 3d]
Seat 3: Gimbel 2 (small blind) folded before Flop
Seat 6: dimetruk (big blind) folded on the Flop
Seat 8: DODGE.WINS (button) collected (1425)


PokerStars Hand #226552101338: Tournament #3188920119, $27.40+$2.60 USD Hold'em No Limit - Level VIII (150/300) - 2021/05/08 0:08:18 MSK [2021/05/07 17:08:18 ET]
Table '3188920119 1' 9-max Seat #6 is the button
Seat 6: dimetruk (1398 in chips)
Seat 8: DODGE.WINS (12102 in chips)
dimetruk: posts the ante 25
DODGE.WINS: posts the ante 25
dimetruk: posts small blind 150
DODGE.WINS: posts big blind 300
*** HOLE CARDS ***
Dealt to dimetruk [Qc 6s]
dimetruk: raises 1073 to 1373 and is all-in
DODGE.WINS: calls 1073
*** FLOP *** [Ac 4c 6h]
*** TURN *** [Ac 4c 6h] [Th]
*** RIVER *** [Ac 4c 6h Th] [Kc]
*** SHOW DOWN ***
DODGE.WINS: shows [6c Jc] (a flush, Ace high)
dimetruk: shows [Qc 6s] (a pair of Sixes)
DODGE.WINS collected 2796 from pot
dimetruk finished the tournament in 2nd place and received $73.98.
DODGE.WINS wins the tournament and receives $123.30 - congratulations!
*** SUMMARY ***
Total pot 2796 | Rake 0
Board [Ac 4c 6h Th Kc]
Seat 6: dimetruk (button) (small blind) showed [Qc 6s] and lost with a pair of Sixes
Seat 8: DODGE.WINS (big blind) showed [6c Jc] and won (2796) with a flush, Ace high


PokerStars Hand #226571483890: Tournament #3189227656, $27.40+$2.60 USD Hold'em No Limit - Level I (10/20) - 2021/05/08 17:31:19 MSK [2021/05/08 10:31:19 ET]
Table '3189227656 1' 9-max Seat #4 is the button
Seat 1: mr.Unezh (1491 in chips)
Seat 2: scottamac1984 (1471 in chips)
Seat 3: Luke141269 (1515 in chips)
Seat 4: JulesR1111 (1431 in chips)
Seat 5: UMT4IFT (3369 in chips)
Seat 6: dimetruk (1491 in chips)
Seat 7: InYourfAces1 (1491 in chips)
Seat 8: Kenneth10101 (1241 in chips)
mr.Unezh: posts the ante 3
scottamac1984: posts the ante 3
Luke141269: posts the ante 3
JulesR1111: posts the ante 3
UMT4IFT: posts the ante 3
dimetruk: posts the ante 3
InYourfAces1: posts the ante 3
Kenneth10101: posts the ante 3
UMT4IFT: posts small blind 10
dimetruk: posts big blind 20
*** HOLE CARDS ***
Dealt to dimetruk [Tc Ac]
InYourfAces1: folds
Kenneth10101: folds
mr.Unezh: folds
scottamac1984: folds
Luke141269: folds
JulesR1111: folds
UMT4IFT: calls 10
dimetruk: raises 45 to 65
UMT4IFT: calls 45
*** FLOP *** [6d Qs Kh]
UMT4IFT: checks
dimetruk: bets 77
UMT4IFT: folds
Uncalled bet (77) returned to dimetruk
dimetruk collected 154 from pot
dimetruk: doesn't show hand
*** SUMMARY ***
Total pot 154 | Rake 0
Board [6d Qs Kh]
Seat 1: mr.Unezh folded before Flop (didn't bet)
Seat 2: scottamac1984 folded before Flop (didn't bet)
Seat 3: Luke141269 folded before Flop (didn't bet)
Seat 4: JulesR1111 (button) folded before Flop (didn't bet)
Seat 5: UMT4IFT (small blind) folded on the Flop
Seat 6: dimetruk (big blind) collected (154)
Seat 7: InYourfAces1 folded before Flop (didn't bet)
Seat 8: Kenneth10101 folded before Flop (didn't bet)


PokerStars Hand #226571573693: Tournament #3189227656, $27.40+$2.60 USD Hold'em No Limit - Level I (10/20) - 2021/05/08 17:35:10 MSK [2021/05/08 10:35:10 ET]
Table '3189227656 1' 9-max Seat #1 is the button
Seat 1: mr.Unezh (1864 in chips)
Seat 2: scottamac1984 (1396 in chips)
Seat 3: Luke141269 (1500 in chips)
Seat 4: JulesR1111 (1116 in chips)
Seat 5: UMT4IFT (3523 in chips)
Seat 6: dimetruk (1555 in chips)
Seat 7: InYourfAces1 (1376 in chips)
Seat 8: Kenneth10101 (1170 in chips)
mr.Unezh: posts the ante 3
scottamac1984: posts the ante 3
Luke141269: posts the ante 3
JulesR1111: posts the ante 3
UMT4IFT: posts the ante 3
dimetruk: posts the ante 3
InYourfAces1: posts the ante 3
Kenneth10101: posts the ante 3
scottamac1984: posts small blind 10
Luke141269: posts big blind 20
*** HOLE CARDS ***
Dealt to dimetruk [Qc Qs]
JulesR1111: folds
UMT4IFT: folds
dimetruk: raises 20 to 40
InYourfAces1: folds
Kenneth10101: folds
mr.Unezh: folds
scottamac1984: calls 30
Luke141269: folds
*** FLOP *** [Js 3c 5c]
scottamac1984: bets 124
dimetruk: raises 1388 to 1512 and is all-in
scottamac1984: folds
Uncalled bet (1388) returned to dimetruk
dimetruk collected 372 from pot
dimetruk: doesn't show hand
*** SUMMARY ***
Total pot 372 | Rake 0
Board [Js 3c 5c]
Seat 1: mr.Unezh (button) folded before Flop (didn't bet)
Seat 2: scottamac1984 (small blind) folded on the Flop
Seat 3: Luke141269 (big blind) folded before Flop
Seat 4: JulesR1111 folded before Flop (didn't bet)
Seat 5: UMT4IFT folded before Flop (didn't bet)
Seat 6: dimetruk collected (372)
Seat 7: InYourfAces1 folded before Flop (didn't bet)
Seat 8: Kenneth10101 folded before Flop (didn't bet)


PokerStars Hand #226571625431: Tournament #3189227656, $27.40+$2.60 USD Hold'em No Limit - Level I (10/20) - 2021/05/08 17:37:23 MSK [2021/05/08 10:37:23 ET]
Table '3189227656 1' 9-max Seat #4 is the button
Seat 1: mr.Unezh (1909 in chips)
Seat 2: scottamac1984 (1223 in chips)
Seat 3: Luke141269 (1461 in chips)
Seat 4: JulesR1111 (1077 in chips)
Seat 5: UMT4IFT (3708 in chips)
Seat 6: dimetruk (1754 in chips)
Seat 7: InYourfAces1 (1367 in chips)
Seat 8: Kenneth10101 (1001 in chips)
mr.Unezh: posts the ante 3
scottamac1984: posts the ante 3
Luke141269: posts the ante 3
JulesR1111: posts the ante 3
UMT4IFT: posts the ante 3
dimetruk: posts the ante 3
InYourfAces1: posts the ante 3
Kenneth10101: posts the ante 3
UMT4IFT: posts small blind 10
dimetruk: posts big blind 20
*** HOLE CARDS ***
Dealt to dimetruk [9h 3s]
InYourfAces1: folds
Kenneth10101: folds
mr.Unezh: folds
scottamac1984: folds
Luke141269: folds
JulesR1111: raises 20 to 40
UMT4IFT: folds
dimetruk: calls 20
*** FLOP *** [8s 4c 4h]
dimetruk: checks
JulesR1111: bets 20
dimetruk: folds
Uncalled bet (20) returned to JulesR1111
JulesR1111 collected 114 from pot
JulesR1111: doesn't show hand
*** SUMMARY ***
Total pot 114 | Rake 0
Board [8s 4c 4h]
Seat 1: mr.Unezh folded before Flop (didn't bet)
Seat 2: scottamac1984 folded before Flop (didn't bet)
Seat 3: Luke141269 folded before Flop (didn't bet)
Seat 4: JulesR1111 (button) collected (114)
Seat 5: UMT4IFT (small blind) folded before Flop
Seat 6: dimetruk (big blind) folded on the Flop
Seat 7: InYourfAces1 folded before Flop (didn't bet)
Seat 8: Kenneth10101 folded before Flop (didn't bet)


PokerStars Hand #226571811244: Tournament #3189227656, $27.40+$2.60 USD Hold'em No Limit - Level II (15/30) - 2021/05/08 17:45:16 MSK [2021/05/08 10:45:16 ET]
Table '3189227656 1' 9-max Seat #4 is the button
Seat 1: mr.Unezh (1584 in chips)
Seat 2: scottamac1984 (1601 in chips)
Seat 3: Luke141269 (1385 in chips)
Seat 4: JulesR1111 (970 in chips)
Seat 5: UMT4IFT (3270 in chips)
Seat 6: dimetruk (1668 in chips)
Seat 7: InYourfAces1 (1823 in chips)
Seat 8: Kenneth10101 (1199 in chips)
mr.Unezh: posts the ante 4
scottamac1984: posts the ante 4
Luke141269: posts the ante 4
JulesR1111: posts the ante 4
UMT4IFT: posts the ante 4
dimetruk: posts the ante 4
InYourfAces1: posts the ante 4
Kenneth10101: posts the ante 4
UMT4IFT: posts small blind 15
dimetruk: posts big blind 30
*** HOLE CARDS ***
Dealt to dimetruk [As Ac]
InYourfAces1: folds
Kenneth10101: folds
mr.Unezh: folds
scottamac1984: folds
Luke141269: folds
JulesR1111: folds
UMT4IFT: raises 60 to 90
dimetruk: raises 135 to 225
UMT4IFT: raises 495 to 720
dimetruk: raises 944 to 1664 and is all-in
UMT4IFT: calls 944
*** FLOP *** [7d 9c 7s]
*** TURN *** [7d 9c 7s] [Kd]
*** RIVER *** [7d 9c 7s Kd] [Ah]
*** SHOW DOWN ***
UMT4IFT: shows [Qc Qh] (two pair, Queens and Sevens)
dimetruk: shows [As Ac] (a full house, Aces full of Sevens)
dimetruk collected 3360 from pot
*** SUMMARY ***
Total pot 3360 | Rake 0
Board [7d 9c 7s Kd Ah]
Seat 1: mr.Unezh folded before Flop (didn't bet)
Seat 2: scottamac1984 folded before Flop (didn't bet)
Seat 3: Luke141269 folded before Flop (didn't bet)
Seat 4: JulesR1111 (button) folded before Flop (didn't bet)
Seat 5: UMT4IFT (small blind) showed [Qc Qh] and lost with two pair, Queens and Sevens
Seat 6: dimetruk (big blind) showed [As Ac] and won (3360) with a full house, Aces full of Sevens
Seat 7: InYourfAces1 folded before Flop (didn't bet)
Seat 8: Kenneth10101 folded before Flop (didn't bet)


PokerStars Hand #226571911095: Tournament #3189227656, $27.40+$2.60 USD Hold'em No Limit - Level III (25/50) - 2021/05/08 17:49:32 MSK [2021/05/08 10:49:32 ET]
Table '3189227656 1' 9-max Seat #1 is the button
Seat 1: mr.Unezh (1572 in chips)
Seat 2: scottamac1984 (1527 in chips)
Seat 3: Luke141269 (1361 in chips)
Seat 4: JulesR1111 (913 in chips)
Seat 5: UMT4IFT (1805 in chips)
Seat 6: dimetruk (3325 in chips)
Seat 7: InYourfAces1 (1927 in chips)
Seat 8: Kenneth10101 (1070 in chips)
mr.Unezh: posts the ante 6
scottamac1984: posts the ante 6
Luke141269: posts the ante 6
JulesR1111: posts the ante 6
UMT4IFT: posts the ante 6
dimetruk: posts the ante 6
InYourfAces1: posts the ante 6
Kenneth10101: posts the ante 6
scottamac1984: posts small blind 25
Luke141269: posts big blind 50
*** HOLE CARDS ***
Dealt to dimetruk [Jd Td]
JulesR1111: folds
UMT4IFT: folds
dimetruk: raises 50 to 100
InYourfAces1: calls 100
Kenneth10101: folds
mr.Unezh: folds
scottamac1984: folds
Luke141269: calls 50
*** FLOP *** [7s 2d 3h]
Luke141269: checks
dimetruk: checks
InYourfAces1: bets 149
Luke141269: calls 149
dimetruk: folds
*** TURN *** [7s 2d 3h] [3c]
Luke141269: checks
InYourfAces1: bets 268
Luke141269: raises 838 to 1106 and is all-in
InYourfAces1: folds
Uncalled bet (838) returned to Luke141269
Luke141269 collected 1207 from pot
Luke141269: doesn't show hand
*** SUMMARY ***
Total pot 1207 | Rake 0
Board [7s 2d 3h 3c]
Seat 1: mr.Unezh (button) folded before Flop (didn't bet)
Seat 2: scottamac1984 (small blind) folded before Flop
Seat 3: Luke141269 (big blind) collected (1207)
Seat 4: JulesR1111 folded before Flop (didn't bet)
Seat 5: UMT4IFT folded before Flop (didn't bet)
Seat 6: dimetruk folded on the Flop
Seat 7: InYourfAces1 folded on the Turn
Seat 8: Kenneth10101 folded before Flop (didn't bet)


PokerStars Hand #226571984118: Tournament #3189227656, $27.40+$2.60 USD Hold'em No Limit - Level III (25/50) - 2021/05/08 17:52:37 MSK [2021/05/08 10:52:37 ET]
Table '3189227656 1' 9-max Seat #4 is the button
Seat 1: mr.Unezh (1354 in chips)
Seat 2: scottamac1984 (1484 in chips)
Seat 3: Luke141269 (2008 in chips)
Seat 4: JulesR1111 (820 in chips)
Seat 5: UMT4IFT (802 in chips)
Seat 6: dimetruk (3207 in chips)
Seat 7: InYourfAces1 (1392 in chips)
Seat 8: Kenneth10101 (2433 in chips)
mr.Unezh: posts the ante 6
scottamac1984: posts the ante 6
Luke141269: posts the ante 6
JulesR1111: posts the ante 6
UMT4IFT: posts the ante 6
dimetruk: posts the ante 6
InYourfAces1: posts the ante 6
Kenneth10101: posts the ante 6
UMT4IFT: posts small blind 25
dimetruk: posts big blind 50
*** HOLE CARDS ***
Dealt to dimetruk [8d 5s]
InYourfAces1: raises 50 to 100
Kenneth10101: calls 100
mr.Unezh: folds
scottamac1984: calls 100
Luke141269: folds
JulesR1111: calls 100
UMT4IFT: calls 75
dimetruk: calls 50
*** FLOP *** [Kd Ad 8c]
UMT4IFT: checks
dimetruk: checks
InYourfAces1: checks
Kenneth10101: bets 150
scottamac1984: folds
JulesR1111: folds
UMT4IFT: folds
dimetruk: calls 150
InYourfAces1: folds
*** TURN *** [Kd Ad 8c] [9s]
dimetruk: checks
Kenneth10101: checks
*** RIVER *** [Kd Ad 8c 9s] [7d]
dimetruk: bets 474
Kenneth10101: calls 474
*** SHOW DOWN ***
dimetruk: shows [8d 5s] (a pair of Eights)
Kenneth10101: shows [Ac Qd] (a pair of Aces)
Kenneth10101 collected 1896 from pot
*** SUMMARY ***
Total pot 1896 | Rake 0
Board [Kd Ad 8c 9s 7d]
Seat 1: mr.Unezh folded before Flop (didn't bet)
Seat 2: scottamac1984 folded on the Flop
Seat 3: Luke141269 folded before Flop (didn't bet)
Seat 4: JulesR1111 (button) folded on the Flop
Seat 5: UMT4IFT (small blind) folded on the Flop
Seat 6: dimetruk (big blind) showed [8d 5s] and lost with a pair of Eights
Seat 7: InYourfAces1 folded on the Flop
Seat 8: Kenneth10101 showed [Ac Qd] and won (1896) with a pair of Aces


PokerStars Hand #226572084174: Tournament #3189227656, $27.40+$2.60 USD Hold'em No Limit - Level III (25/50) - 2021/05/08 17:57:16 MSK [2021/05/08 10:57:16 ET]
Table '3189227656 1' 9-max Seat #2 is the button
Seat 1: mr.Unezh (3200 in chips)
Seat 2: scottamac1984 (1204 in chips)
Seat 3: Luke141269 (1878 in chips)
Seat 4: JulesR1111 (590 in chips)
Seat 5: UMT4IFT (533 in chips)
Seat 6: dimetruk (2428 in chips)
Seat 8: Kenneth10101 (3667 in chips)
mr.Unezh: posts the ante 6
scottamac1984: posts the ante 6
Luke141269: posts the ante 6
JulesR1111: posts the ante 6
UMT4IFT: posts the ante 6
dimetruk: posts the ante 6
Kenneth10101: posts the ante 6
Luke141269: posts small blind 25
JulesR1111: posts big blind 50
*** HOLE CARDS ***
Dealt to dimetruk [Ks Qd]
UMT4IFT: folds
dimetruk: raises 50 to 100
Kenneth10101: calls 100
mr.Unezh: folds
scottamac1984: folds
Luke141269: folds
JulesR1111: calls 50
*** FLOP *** [8s Ad Jh]
JulesR1111: checks
dimetruk: bets 128
Kenneth10101: calls 128
JulesR1111: folds
*** TURN *** [8s Ad Jh] [As]
dimetruk: checks
Kenneth10101: bets 50
dimetruk: calls 50
*** RIVER *** [8s Ad Jh As] [9s]
dimetruk: checks
Kenneth10101: bets 200
dimetruk: folds
Uncalled bet (200) returned to Kenneth10101
Kenneth10101 collected 723 from pot
Kenneth10101: doesn't show hand
*** SUMMARY ***
Total pot 723 | Rake 0
Board [8s Ad Jh As 9s]
Seat 1: mr.Unezh folded before Flop (didn't bet)
Seat 2: scottamac1984 (button) folded before Flop (didn't bet)
Seat 3: Luke141269 (small blind) folded before Flop
Seat 4: JulesR1111 (big blind) folded on the Flop
Seat 5: UMT4IFT folded before Flop (didn't bet)
Seat 6: dimetruk folded on the River
Seat 8: Kenneth10101 collected (723)


PokerStars Hand #226572120049: Tournament #3189227656, $27.40+$2.60 USD Hold'em No Limit - Level IV (40/80) - 2021/05/08 17:59:13 MSK [2021/05/08 10:59:13 ET]
Table '3189227656 1' 9-max Seat #6 is the button
Seat 1: mr.Unezh (3174 in chips)
Seat 2: scottamac1984 (1178 in chips)
Seat 3: Luke141269 (1827 in chips)
Seat 4: JulesR1111 (424 in chips)
Seat 6: dimetruk (2044 in chips)
Seat 8: Kenneth10101 (4853 in chips)
mr.Unezh: posts the ante 10
scottamac1984: posts the ante 10
Luke141269: posts the ante 10
JulesR1111: posts the ante 10
dimetruk: posts the ante 10
Kenneth10101: posts the ante 10
Kenneth10101: posts small blind 40
mr.Unezh: posts big blind 80
*** HOLE CARDS ***
Dealt to dimetruk [4d Ac]
scottamac1984: folds
Luke141269: folds
JulesR1111: folds
dimetruk: raises 180 to 260
Kenneth10101: folds
mr.Unezh: calls 180
*** FLOP *** [Kc Qd 8d]
mr.Unezh: checks
dimetruk: bets 310
mr.Unezh: folds
Uncalled bet (310) returned to dimetruk
dimetruk collected 620 from pot
dimetruk: doesn't show hand
*** SUMMARY ***
Total pot 620 | Rake 0
Board [Kc Qd 8d]
Seat 1: mr.Unezh (big blind) folded on the Flop
Seat 2: scottamac1984 folded before Flop (didn't bet)
Seat 3: Luke141269 folded before Flop (didn't bet)
Seat 4: JulesR1111 folded before Flop (didn't bet)
Seat 6: dimetruk (button) collected (620)
Seat 8: Kenneth10101 (small blind) folded before Flop


PokerStars Hand #226572136505: Tournament #3189227656, $27.40+$2.60 USD Hold'em No Limit - Level IV (40/80) - 2021/05/08 18:00:07 MSK [2021/05/08 11:00:07 ET]
Table '3189227656 1' 9-max Seat #1 is the button
Seat 1: mr.Unezh (4516 in chips)
Seat 3: Luke141269 (1807 in chips)
Seat 6: dimetruk (2384 in chips)
Seat 8: Kenneth10101 (4793 in chips)
mr.Unezh: posts the ante 10
Luke141269: posts the ante 10
dimetruk: posts the ante 10
Kenneth10101: posts the ante 10
Luke141269: posts small blind 40
dimetruk: posts big blind 80
*** HOLE CARDS ***
Dealt to dimetruk [5s 4h]
Kenneth10101: folds
mr.Unezh: raises 80 to 160
Luke141269: folds
dimetruk: calls 80
*** FLOP *** [9h Kc 4c]
dimetruk: checks
mr.Unezh: bets 132
dimetruk: calls 132
*** TURN *** [9h Kc 4c] [Ts]
dimetruk: checks
mr.Unezh: bets 332
dimetruk: folds
Uncalled bet (332) returned to mr.Unezh
mr.Unezh collected 664 from pot
mr.Unezh: doesn't show hand
*** SUMMARY ***
Total pot 664 | Rake 0
Board [9h Kc 4c Ts]
Seat 1: mr.Unezh (button) collected (664)
Seat 3: Luke141269 (small blind) folded before Flop
Seat 6: dimetruk (big blind) folded on the Turn
Seat 8: Kenneth10101 folded before Flop (didn't bet)


PokerStars Hand #226572144731: Tournament #3189227656, $27.40+$2.60 USD Hold'em No Limit - Level IV (40/80) - 2021/05/08 18:00:33 MSK [2021/05/08 11:00:33 ET]
Table '3189227656 1' 9-max Seat #3 is the button
Seat 1: mr.Unezh (4878 in chips)
Seat 3: Luke141269 (1757 in chips)
Seat 6: dimetruk (2082 in chips)
Seat 8: Kenneth10101 (4783 in chips)
mr.Unezh: posts the ante 10
Luke141269: posts the ante 10
dimetruk: posts the ante 10
Kenneth10101: posts the ante 10
dimetruk: posts small blind 40
Kenneth10101: posts big blind 80
*** HOLE CARDS ***
Dealt to dimetruk [6h 7s]
mr.Unezh: folds
Luke141269: folds
dimetruk: raises 180 to 260
Kenneth10101: calls 180
*** FLOP *** [4s Qs 8s]
dimetruk: bets 280
Kenneth10101: folds
Uncalled bet (280) returned to dimetruk
dimetruk collected 560 from pot
dimetruk: doesn't show hand
*** SUMMARY ***
Total pot 560 | Rake 0
Board [4s Qs 8s]
Seat 1: mr.Unezh folded before Flop (didn't bet)
Seat 3: Luke141269 (button) folded before Flop (didn't bet)
Seat 6: dimetruk (small blind) collected (560)
Seat 8: Kenneth10101 (big blind) folded on the Flop


PokerStars Hand #226572153874: Tournament #3189227656, $27.40+$2.60 USD Hold'em No Limit - Level IV (40/80) - 2021/05/08 18:01:00 MSK [2021/05/08 11:01:00 ET]
Table '3189227656 1' 9-max Seat #6 is the button
Seat 1: mr.Unezh (4868 in chips)
Seat 3: Luke141269 (1747 in chips)
Seat 6: dimetruk (2372 in chips)
Seat 8: Kenneth10101 (4513 in chips)
mr.Unezh: posts the ante 10
Luke141269: posts the ante 10
dimetruk: posts the ante 10
Kenneth10101: posts the ante 10
Kenneth10101: posts small blind 40
mr.Unezh: posts big blind 80
*** HOLE CARDS ***
Dealt to dimetruk [Kc 6c]
Luke141269: folds
dimetruk: raises 80 to 160
Kenneth10101: folds
mr.Unezh: calls 80
*** FLOP *** [4c Tc 7c]
mr.Unezh: checks
dimetruk: checks
*** TURN *** [4c Tc 7c] [Qd]
mr.Unezh: bets 200
dimetruk: calls 200
*** RIVER *** [4c Tc 7c Qd] [6d]
mr.Unezh said, "dim q"
mr.Unezh: bets 400
dimetruk: raises 1602 to 2002 and is all-in
mr.Unezh: folds
Uncalled bet (1602) returned to dimetruk
dimetruk collected 1600 from pot
dimetruk: doesn't show hand
*** SUMMARY ***
Total pot 1600 | Rake 0
Board [4c Tc 7c Qd 6d]
Seat 1: mr.Unezh (big blind) folded on the River
Seat 3: Luke141269 folded before Flop (didn't bet)
Seat 6: dimetruk (button) collected (1600)
Seat 8: Kenneth10101 (small blind) folded before Flop


PokerStars Hand #226572183789: Tournament #3189227656, $27.40+$2.60 USD Hold'em No Limit - Level IV (40/80) - 2021/05/08 18:02:21 MSK [2021/05/08 11:02:21 ET]
Table '3189227656 1' 9-max Seat #6 is the button
Seat 1: mr.Unezh (4188 in chips)
Seat 3: Luke141269 (1907 in chips)
Seat 6: dimetruk (3212 in chips)
Seat 8: Kenneth10101 (4193 in chips)
mr.Unezh: posts the ante 10
Luke141269: posts the ante 10
dimetruk: posts the ante 10
Kenneth10101: posts the ante 10
Kenneth10101: posts small blind 40
mr.Unezh: posts big blind 80
*** HOLE CARDS ***
Dealt to dimetruk [9h Kc]
Luke141269: folds
dimetruk: raises 80 to 160
Kenneth10101: folds
mr.Unezh: calls 80
*** FLOP *** [Kd 4d Jh]
mr.Unezh: checks
dimetruk: checks
*** TURN *** [Kd 4d Jh] [9c]
mr.Unezh: bets 200
dimetruk: raises 280 to 480
mr.Unezh: calls 280
*** RIVER *** [Kd 4d Jh 9c] [2h]
mr.Unezh: checks
dimetruk: bets 476
mr.Unezh: folds
Uncalled bet (476) returned to dimetruk
dimetruk collected 1360 from pot
dimetruk: doesn't show hand
*** SUMMARY ***
Total pot 1360 | Rake 0
Board [Kd 4d Jh 9c 2h]
Seat 1: mr.Unezh (big blind) folded on the River
Seat 3: Luke141269 folded before Flop (didn't bet)
Seat 6: dimetruk (button) collected (1360)
Seat 8: Kenneth10101 (small blind) folded before Flop


PokerStars Hand #226572219901: Tournament #3189227656, $27.40+$2.60 USD Hold'em No Limit - Level IV (40/80) - 2021/05/08 18:03:52 MSK [2021/05/08 11:03:52 ET]
Table '3189227656 1' 9-max Seat #6 is the button
Seat 1: mr.Unezh (4188 in chips)
Seat 3: Luke141269 (1747 in chips)
Seat 6: dimetruk (3932 in chips)
Seat 8: Kenneth10101 (3633 in chips)
mr.Unezh: posts the ante 10
Luke141269: posts the ante 10
dimetruk: posts the ante 10
Kenneth10101: posts the ante 10
Kenneth10101: posts small blind 40
mr.Unezh: posts big blind 80
*** HOLE CARDS ***
Dealt to dimetruk [Kc Kh]
Luke141269: folds
dimetruk: raises 80 to 160
Kenneth10101: folds
mr.Unezh: calls 80
*** FLOP *** [8c 3c 4h]
mr.Unezh: checks
dimetruk: bets 200
mr.Unezh: folds
Uncalled bet (200) returned to dimetruk
dimetruk collected 400 from pot
dimetruk: doesn't show hand
*** SUMMARY ***
Total pot 400 | Rake 0
Board [8c 3c 4h]
Seat 1: mr.Unezh (big blind) folded on the Flop
Seat 3: Luke141269 folded before Flop (didn't bet)
Seat 6: dimetruk (button) collected (400)
Seat 8: Kenneth10101 (small blind) folded before Flop


PokerStars Hand #226572230022: Tournament #3189227656, $27.40+$2.60 USD Hold'em No Limit - Level IV (40/80) - 2021/05/08 18:04:08 MSK [2021/05/08 11:04:08 ET]
Table '3189227656 1' 9-max Seat #8 is the button
Seat 1: mr.Unezh (4018 in chips)
Seat 3: Luke141269 (1737 in chips)
Seat 6: dimetruk (4162 in chips)
Seat 8: Kenneth10101 (3583 in chips)
mr.Unezh: posts the ante 10
Luke141269: posts the ante 10
dimetruk: posts the ante 10
Kenneth10101: posts the ante 10
mr.Unezh: posts small blind 40
Luke141269: posts big blind 80
*** HOLE CARDS ***
Dealt to dimetruk [Ts Ks]
dimetruk: raises 80 to 160
Kenneth10101: folds
mr.Unezh: folds
Luke141269: calls 80
*** FLOP *** [5d 5c 4d]
Luke141269: checks
dimetruk: checks
*** TURN *** [5d 5c 4d] [7s]
Luke141269: bets 132
dimetruk: folds
Uncalled bet (132) returned to Luke141269
Luke141269 collected 400 from pot
Luke141269: doesn't show hand
*** SUMMARY ***
Total pot 400 | Rake 0
Board [5d 5c 4d 7s]
Seat 1: mr.Unezh (small blind) folded before Flop
Seat 3: Luke141269 (big blind) collected (400)
Seat 6: dimetruk folded on the Turn
Seat 8: Kenneth10101 (button) folded before Flop (didn't bet)


PokerStars Hand #226572291601: Tournament #3189227656, $27.40+$2.60 USD Hold'em No Limit - Level IV (40/80) - 2021/05/08 18:06:37 MSK [2021/05/08 11:06:37 ET]
Table '3189227656 1' 9-max Seat #1 is the button
Seat 1: mr.Unezh (1370 in chips)
Seat 3: Luke141269 (2127 in chips)
Seat 6: dimetruk (3992 in chips)
Seat 8: Kenneth10101 (6011 in chips)
mr.Unezh: posts the ante 10
Luke141269: posts the ante 10
dimetruk: posts the ante 10
Kenneth10101: posts the ante 10
Luke141269: posts small blind 40
dimetruk: posts big blind 80
*** HOLE CARDS ***
Dealt to dimetruk [Ad 4c]
Kenneth10101: folds
mr.Unezh: raises 80 to 160
Luke141269: folds
dimetruk: calls 80
*** FLOP *** [3s 7h Jc]
dimetruk: checks
mr.Unezh: checks
*** TURN *** [3s 7h Jc] [Qc]
dimetruk: checks
mr.Unezh: bets 200
dimetruk: folds
Uncalled bet (200) returned to mr.Unezh
mr.Unezh collected 400 from pot
mr.Unezh: doesn't show hand
*** SUMMARY ***
Total pot 400 | Rake 0
Board [3s 7h Jc Qc]
Seat 1: mr.Unezh (button) collected (400)
Seat 3: Luke141269 (small blind) folded before Flop
Seat 6: dimetruk (big blind) folded on the Turn
Seat 8: Kenneth10101 folded before Flop (didn't bet)


PokerStars Hand #226572302389: Tournament #3189227656, $27.40+$2.60 USD Hold'em No Limit - Level IV (40/80) - 2021/05/08 18:07:02 MSK [2021/05/08 11:07:02 ET]
Table '3189227656 1' 9-max Seat #3 is the button
Seat 1: mr.Unezh (1600 in chips)
Seat 3: Luke141269 (2077 in chips)
Seat 6: dimetruk (3822 in chips)
Seat 8: Kenneth10101 (6001 in chips)
mr.Unezh: posts the ante 10
Luke141269: posts the ante 10
dimetruk: posts the ante 10
Kenneth10101: posts the ante 10
dimetruk: posts small blind 40
Kenneth10101: posts big blind 80
*** HOLE CARDS ***
Dealt to dimetruk [Qh 8c]
mr.Unezh: folds
Luke141269: folds
dimetruk: raises 180 to 260
Kenneth10101: calls 180
*** FLOP *** [3c 5c As]
dimetruk: bets 196
Kenneth10101: folds
Uncalled bet (196) returned to dimetruk
dimetruk collected 560 from pot
dimetruk: doesn't show hand
*** SUMMARY ***
Total pot 560 | Rake 0
Board [3c 5c As]
Seat 1: mr.Unezh folded before Flop (didn't bet)
Seat 3: Luke141269 (button) folded before Flop (didn't bet)
Seat 6: dimetruk (small blind) collected (560)
Seat 8: Kenneth10101 (big blind) folded on the Flop


PokerStars Hand #226572310278: Tournament #3189227656, $27.40+$2.60 USD Hold'em No Limit - Level IV (40/80) - 2021/05/08 18:07:20 MSK [2021/05/08 11:07:20 ET]
Table '3189227656 1' 9-max Seat #6 is the button
Seat 1: mr.Unezh (1590 in chips)
Seat 3: Luke141269 (2067 in chips)
Seat 6: dimetruk (4112 in chips)
Seat 8: Kenneth10101 (5731 in chips)
mr.Unezh: posts the ante 10
Luke141269: posts the ante 10
dimetruk: posts the ante 10
Kenneth10101: posts the ante 10
Kenneth10101: posts small blind 40
mr.Unezh: posts big blind 80
*** HOLE CARDS ***
Dealt to dimetruk [5d 2d]
Luke141269: folds
dimetruk: raises 80 to 160
Kenneth10101: folds
mr.Unezh: calls 80
*** FLOP *** [Ac 3h Jd]
mr.Unezh: checks
dimetruk: bets 140
mr.Unezh: raises 224 to 364
dimetruk: calls 224
*** TURN *** [Ac 3h Jd] [3c]
mr.Unezh: checks
dimetruk: checks
*** RIVER *** [Ac 3h Jd 3c] [4s]
mr.Unezh: checks
dimetruk: bets 3578 and is all-in
mr.Unezh: folds
Uncalled bet (3578) returned to dimetruk
dimetruk collected 1128 from pot
dimetruk: doesn't show hand
*** SUMMARY ***
Total pot 1128 | Rake 0
Board [Ac 3h Jd 3c 4s]
Seat 1: mr.Unezh (big blind) folded on the River
Seat 3: Luke141269 folded before Flop (didn't bet)
Seat 6: dimetruk (button) collected (1128)
Seat 8: Kenneth10101 (small blind) folded before Flop


PokerStars Hand #226572401582: Tournament #3189227656, $27.40+$2.60 USD Hold'em No Limit - Level V (60/120) - 2021/05/08 18:10:55 MSK [2021/05/08 11:10:55 ET]
Table '3189227656 1' 9-max Seat #3 is the button
Seat 1: mr.Unezh (2802 in chips)
Seat 3: Luke141269 (1967 in chips)
Seat 6: dimetruk (4796 in chips)
Seat 8: Kenneth10101 (3935 in chips)
mr.Unezh: posts the ante 15
Luke141269: posts the ante 15
dimetruk: posts the ante 15
Kenneth10101: posts the ante 15
dimetruk: posts small blind 60
Kenneth10101: posts big blind 120
*** HOLE CARDS ***
Dealt to dimetruk [5c 5s]
mr.Unezh: folds
Luke141269: raises 120 to 240
dimetruk: calls 180
Kenneth10101: calls 120
*** FLOP *** [Ad 2d 6s]
dimetruk: checks
Kenneth10101: checks
Luke141269: checks
*** TURN *** [Ad 2d 6s] [4c]
dimetruk: bets 273
Kenneth10101: folds
Luke141269: calls 273
*** RIVER *** [Ad 2d 6s 4c] [9d]
dimetruk: bets 1440
Luke141269: folds
Uncalled bet (1440) returned to dimetruk
dimetruk collected 1326 from pot
dimetruk: doesn't show hand
*** SUMMARY ***
Total pot 1326 | Rake 0
Board [Ad 2d 6s 4c 9d]
Seat 1: mr.Unezh folded before Flop (didn't bet)
Seat 3: Luke141269 (button) folded on the River
Seat 6: dimetruk (small blind) collected (1326)
Seat 8: Kenneth10101 (big blind) folded on the Turn


PokerStars Hand #226572418314: Tournament #3189227656, $27.40+$2.60 USD Hold'em No Limit - Level V (60/120) - 2021/05/08 18:11:33 MSK [2021/05/08 11:11:33 ET]
Table '3189227656 1' 9-max Seat #6 is the button
Seat 1: mr.Unezh (2787 in chips)
Seat 3: Luke141269 (1439 in chips)
Seat 6: dimetruk (5594 in chips)
Seat 8: Kenneth10101 (3680 in chips)
mr.Unezh: posts the ante 15
Luke141269: posts the ante 15
dimetruk: posts the ante 15
Kenneth10101: posts the ante 15
Kenneth10101: posts small blind 60
mr.Unezh: posts big blind 120
*** HOLE CARDS ***
Dealt to dimetruk [7c Ts]
Luke141269: folds
dimetruk: raises 120 to 240
Kenneth10101: calls 180
mr.Unezh: calls 120
*** FLOP *** [5d 8d 6c]
Kenneth10101: checks
mr.Unezh: checks
dimetruk: checks
*** TURN *** [5d 8d 6c] [7s]
Kenneth10101: checks
mr.Unezh: checks
dimetruk: bets 390
Kenneth10101: calls 390
mr.Unezh: folds
*** RIVER *** [5d 8d 6c 7s] [Jc]
Kenneth10101: checks
dimetruk: checks
*** SHOW DOWN ***
Kenneth10101: shows [3s Ac] (high card Ace)
dimetruk: shows [7c Ts] (a pair of Sevens)
dimetruk collected 1560 from pot
*** SUMMARY ***
Total pot 1560 | Rake 0
Board [5d 8d 6c 7s Jc]
Seat 1: mr.Unezh (big blind) folded on the Turn
Seat 3: Luke141269 folded before Flop (didn't bet)
Seat 6: dimetruk (button) showed [7c Ts] and won (1560) with a pair of Sevens
Seat 8: Kenneth10101 (small blind) showed [3s Ac] and lost with high card Ace


PokerStars Hand #226572445720: Tournament #3189227656, $27.40+$2.60 USD Hold'em No Limit - Level V (60/120) - 2021/05/08 18:12:37 MSK [2021/05/08 11:12:37 ET]
Table '3189227656 1' 9-max Seat #3 is the button
Seat 1: mr.Unezh (2262 in chips)
Seat 3: Luke141269 (1634 in chips)
Seat 6: dimetruk (6599 in chips)
Seat 8: Kenneth10101 (3005 in chips)
mr.Unezh: posts the ante 15
Luke141269: posts the ante 15
dimetruk: posts the ante 15
Kenneth10101: posts the ante 15
dimetruk: posts small blind 60
Kenneth10101: posts big blind 120
*** HOLE CARDS ***
Dealt to dimetruk [Jd 4d]
mr.Unezh: folds
Luke141269: folds
dimetruk: raises 270 to 390
Kenneth10101: calls 270
*** FLOP *** [Td 8c 6s]
dimetruk: bets 420
Kenneth10101: calls 420
*** TURN *** [Td 8c 6s] [4h]
dimetruk: checks
Kenneth10101: bets 2180 and is all-in
dimetruk: folds
Uncalled bet (2180) returned to Kenneth10101
Kenneth10101 collected 1680 from pot
Kenneth10101: doesn't show hand
*** SUMMARY ***
Total pot 1680 | Rake 0
Board [Td 8c 6s 4h]
Seat 1: mr.Unezh folded before Flop (didn't bet)
Seat 3: Luke141269 (button) folded before Flop (didn't bet)
Seat 6: dimetruk (small blind) folded on the Turn
Seat 8: Kenneth10101 (big blind) collected (1680)


PokerStars Hand #226572504205: Tournament #3189227656, $27.40+$2.60 USD Hold'em No Limit - Level V (60/120) - 2021/05/08 18:14:31 MSK [2021/05/08 11:14:31 ET]
Table '3189227656 1' 9-max Seat #1 is the button
Seat 1: mr.Unezh (4434 in chips)
Seat 3: Luke141269 (1889 in chips)
Seat 6: dimetruk (5444 in chips)
Seat 8: Kenneth10101 (1733 in chips)
mr.Unezh: posts the ante 15
Luke141269: posts the ante 15
dimetruk: posts the ante 15
Kenneth10101: posts the ante 15
Luke141269: posts small blind 60
dimetruk: posts big blind 120
*** HOLE CARDS ***
Dealt to dimetruk [Kc Ks]
Kenneth10101: folds
mr.Unezh: raises 120 to 240
Luke141269: folds
dimetruk: calls 120
*** FLOP *** [Ad Td 2s]
dimetruk: checks
mr.Unezh: bets 198
dimetruk: calls 198
*** TURN *** [Ad Td 2s] [2c]
dimetruk: checks
mr.Unezh: bets 667
dimetruk: calls 667
*** RIVER *** [Ad Td 2s 2c] [7h]
dimetruk: checks
mr.Unezh: checks
*** SHOW DOWN ***
dimetruk: shows [Kc Ks] (two pair, Kings and Deuces)
mr.Unezh: mucks hand
dimetruk collected 2330 from pot
*** SUMMARY ***
Total pot 2330 | Rake 0
Board [Ad Td 2s 2c 7h]
Seat 1: mr.Unezh (button) mucked [3s 3h]
Seat 3: Luke141269 (small blind) folded before Flop
Seat 6: dimetruk (big blind) showed [Kc Ks] and won (2330) with two pair, Kings and Deuces
Seat 8: Kenneth10101 folded before Flop (didn't bet)


PokerStars Hand #226572517000: Tournament #3189227656, $27.40+$2.60 USD Hold'em No Limit - Level V (60/120) - 2021/05/08 18:15:00 MSK [2021/05/08 11:15:00 ET]
Table '3189227656 1' 9-max Seat #3 is the button
Seat 1: mr.Unezh (3314 in chips)
Seat 3: Luke141269 (1814 in chips)
Seat 6: dimetruk (6654 in chips)
Seat 8: Kenneth10101 (1718 in chips)
mr.Unezh: posts the ante 15
Luke141269: posts the ante 15
dimetruk: posts the ante 15
Kenneth10101: posts the ante 15
dimetruk: posts small blind 60
Kenneth10101: posts big blind 120
*** HOLE CARDS ***
Dealt to dimetruk [Kc As]
mr.Unezh: raises 120 to 240
Luke141269: raises 1559 to 1799 and is all-in
dimetruk: raises 4840 to 6639 and is all-in
Kenneth10101: folds
mr.Unezh: folds
Uncalled bet (4840) returned to dimetruk
*** FLOP *** [Jd 7s 4c]
*** TURN *** [Jd 7s 4c] [Kd]
*** RIVER *** [Jd 7s 4c Kd] [2s]
*** SHOW DOWN ***
dimetruk: shows [Kc As] (a pair of Kings)
Luke141269: shows [Jh Ah] (a pair of Jacks)
dimetruk collected 4018 from pot
Luke141269 finished the tournament in 4th place
*** SUMMARY ***
Total pot 4018 | Rake 0
Board [Jd 7s 4c Kd 2s]
Seat 1: mr.Unezh folded before Flop
Seat 3: Luke141269 (button) showed [Jh Ah] and lost with a pair of Jacks
Seat 6: dimetruk (small blind) showed [Kc As] and won (4018) with a pair of Kings
Seat 8: Kenneth10101 (big blind) folded before Flop


PokerStars Hand #226572534503: Tournament #3189227656, $27.40+$2.60 USD Hold'em No Limit - Level V (60/120) - 2021/05/08 18:15:41 MSK [2021/05/08 11:15:41 ET]
Table '3189227656 1' 9-max Seat #1 is the button
Seat 1: mr.Unezh (4657 in chips)
Seat 6: dimetruk (8843 in chips)
mr.Unezh: posts the ante 15
dimetruk: posts the ante 15
mr.Unezh: posts small blind 60
dimetruk: posts big blind 120
*** HOLE CARDS ***
Dealt to dimetruk [Js 8s]
mr.Unezh: raises 120 to 240
dimetruk said, "wp gl"
mr.Unezh said, "GL"
dimetruk: calls 120
*** FLOP *** [6c 9h Ks]
dimetruk: checks
mr.Unezh said, "napishu pozje v vK"
mr.Unezh: bets 168
dimetruk said, "ok"
dimetruk: calls 168
*** TURN *** [6c 9h Ks] [Ac]
dimetruk: checks
mr.Unezh: bets 423
dimetruk: folds
Uncalled bet (423) returned to mr.Unezh
mr.Unezh collected 846 from pot
mr.Unezh: doesn't show hand
*** SUMMARY ***
Total pot 846 | Rake 0
Board [6c 9h Ks Ac]
Seat 1: mr.Unezh (button) (small blind) collected (846)
Seat 6: dimetruk (big blind) folded on the Turn


PokerStars Hand #226572548076: Tournament #3189227656, $27.40+$2.60 USD Hold'em No Limit - Level V (60/120) - 2021/05/08 18:16:12 MSK [2021/05/08 11:16:12 ET]
Table '3189227656 1' 9-max Seat #6 is the button
Seat 1: mr.Unezh (5080 in chips)
Seat 6: dimetruk (8420 in chips)
mr.Unezh: posts the ante 15
dimetruk: posts the ante 15
dimetruk: posts small blind 60
mr.Unezh: posts big blind 120
*** HOLE CARDS ***
Dealt to dimetruk [Qc Td]
dimetruk: raises 120 to 240
mr.Unezh: calls 120
*** FLOP *** [Qh 9c 8d]
mr.Unezh: checks
dimetruk: checks
*** TURN *** [Qh 9c 8d] [Th]
mr.Unezh: checks
dimetruk: checks
*** RIVER *** [Qh 9c 8d Th] [5h]
mr.Unezh: checks
dimetruk: bets 444
mr.Unezh: folds
Uncalled bet (444) returned to dimetruk
dimetruk collected 510 from pot
dimetruk: doesn't show hand
*** SUMMARY ***
Total pot 510 | Rake 0
Board [Qh 9c 8d Th 5h]
Seat 1: mr.Unezh (big blind) folded on the River
Seat 6: dimetruk (button) (small blind) collected (510)


PokerStars Hand #226572570212: Tournament #3189227656, $27.40+$2.60 USD Hold'em No Limit - Level V (60/120) - 2021/05/08 18:17:04 MSK [2021/05/08 11:17:04 ET]
Table '3189227656 1' 9-max Seat #6 is the button
Seat 1: mr.Unezh (4570 in chips)
Seat 6: dimetruk (8930 in chips)
mr.Unezh: posts the ante 15
dimetruk: posts the ante 15
dimetruk: posts small blind 60
mr.Unezh: posts big blind 120
*** HOLE CARDS ***
Dealt to dimetruk [Kh Ad]
dimetruk: raises 270 to 390
mr.Unezh: calls 270
*** FLOP *** [Jd 4d 9s]
mr.Unezh: checks
dimetruk: checks
*** TURN *** [Jd 4d 9s] [Kc]
mr.Unezh: bets 405
dimetruk: calls 405
*** RIVER *** [Jd 4d 9s Kc] [4c]
mr.Unezh: checks
dimetruk: bets 810
mr.Unezh: calls 810
*** SHOW DOWN ***
dimetruk: shows [Kh Ad] (two pair, Kings and Fours)
mr.Unezh: mucks hand
dimetruk collected 3240 from pot
*** SUMMARY ***
Total pot 3240 | Rake 0
Board [Jd 4d 9s Kc 4c]
Seat 1: mr.Unezh (big blind) mucked [Ah 9c]
Seat 6: dimetruk (button) (small blind) showed [Kh Ad] and won (3240) with two pair, Kings and Fours


PokerStars Hand #226572584806: Tournament #3189227656, $27.40+$2.60 USD Hold'em No Limit - Level V (60/120) - 2021/05/08 18:17:37 MSK [2021/05/08 11:17:37 ET]
Table '3189227656 1' 9-max Seat #1 is the button
Seat 1: mr.Unezh (2950 in chips)
Seat 6: dimetruk (10550 in chips)
mr.Unezh: posts the ante 15
dimetruk: posts the ante 15
mr.Unezh: posts small blind 60
dimetruk: posts big blind 120
*** HOLE CARDS ***
Dealt to dimetruk [8c 9d]
mr.Unezh: raises 120 to 240
dimetruk: calls 120
*** FLOP *** [Qh 8h Ts]
dimetruk: checks
mr.Unezh: bets 342
dimetruk: calls 342
*** TURN *** [Qh 8h Ts] [2h]
dimetruk: checks
mr.Unezh: bets 597
dimetruk: folds
Uncalled bet (597) returned to mr.Unezh
mr.Unezh collected 1194 from pot
mr.Unezh: doesn't show hand
*** SUMMARY ***
Total pot 1194 | Rake 0
Board [Qh 8h Ts 2h]
Seat 1: mr.Unezh (button) (small blind) collected (1194)
Seat 6: dimetruk (big blind) folded on the Turn


PokerStars Hand #226572594731: Tournament #3189227656, $27.40+$2.60 USD Hold'em No Limit - Level VI (80/160) - 2021/05/08 18:18:00 MSK [2021/05/08 11:18:00 ET]
Table '3189227656 1' 9-max Seat #6 is the button
Seat 1: mr.Unezh (3547 in chips)
Seat 6: dimetruk (9953 in chips)
mr.Unezh: posts the ante 20
dimetruk: posts the ante 20
dimetruk: posts small blind 80
mr.Unezh: posts big blind 160
*** HOLE CARDS ***
Dealt to dimetruk [3h 4h]
dimetruk: calls 80
mr.Unezh: checks
*** FLOP *** [Jc Kc 3d]
mr.Unezh: checks
dimetruk: bets 160
mr.Unezh: folds
Uncalled bet (160) returned to dimetruk
dimetruk collected 360 from pot
dimetruk: doesn't show hand
*** SUMMARY ***
Total pot 360 | Rake 0
Board [Jc Kc 3d]
Seat 1: mr.Unezh (big blind) folded on the Flop
Seat 6: dimetruk (button) (small blind) collected (360)


PokerStars Hand #226572599036: Tournament #3189227656, $27.40+$2.60 USD Hold'em No Limit - Level VI (80/160) - 2021/05/08 18:18:10 MSK [2021/05/08 11:18:10 ET]
Table '3189227656 1' 9-max Seat #1 is the button
Seat 1: mr.Unezh (3367 in chips)
Seat 6: dimetruk (10133 in chips)
mr.Unezh: posts the ante 20
dimetruk: posts the ante 20
mr.Unezh: posts small blind 80
dimetruk: posts big blind 160
*** HOLE CARDS ***
Dealt to dimetruk [Tc 9d]
mr.Unezh: raises 160 to 320
dimetruk: calls 160
*** FLOP *** [7d Kh Ad]
dimetruk: checks
mr.Unezh: checks
*** TURN *** [7d Kh Ad] [As]
dimetruk: checks
mr.Unezh: bets 340
dimetruk: folds
Uncalled bet (340) returned to mr.Unezh
mr.Unezh collected 680 from pot
mr.Unezh: doesn't show hand
*** SUMMARY ***
Total pot 680 | Rake 0
Board [7d Kh Ad As]
Seat 1: mr.Unezh (button) (small blind) collected (680)
Seat 6: dimetruk (big blind) folded on the Turn


PokerStars Hand #226572608876: Tournament #3189227656, $27.40+$2.60 USD Hold'em No Limit - Level VI (80/160) - 2021/05/08 18:18:33 MSK [2021/05/08 11:18:33 ET]
Table '3189227656 1' 9-max Seat #1 is the button
Seat 1: mr.Unezh (3527 in chips)
Seat 6: dimetruk (9973 in chips)
mr.Unezh: posts the ante 20
dimetruk: posts the ante 20
mr.Unezh: posts small blind 80
dimetruk: posts big blind 160
*** HOLE CARDS ***
Dealt to dimetruk [Ah Ad]
mr.Unezh: raises 160 to 320
dimetruk: calls 160
*** FLOP *** [5d 4h Jc]
dimetruk: checks
mr.Unezh: checks
*** TURN *** [5d 4h Jc] [Td]
dimetruk: bets 340
mr.Unezh: folds
Uncalled bet (340) returned to dimetruk
dimetruk collected 680 from pot
dimetruk: doesn't show hand
*** SUMMARY ***
Total pot 680 | Rake 0
Board [5d 4h Jc Td]
Seat 1: mr.Unezh (button) (small blind) folded on the Turn
Seat 6: dimetruk (big blind) collected (680)


PokerStars Hand #226572619111: Tournament #3189227656, $27.40+$2.60 USD Hold'em No Limit - Level VI (80/160) - 2021/05/08 18:18:56 MSK [2021/05/08 11:18:56 ET]
Table '3189227656 1' 9-max Seat #6 is the button
Seat 1: mr.Unezh (2907 in chips)
Seat 6: dimetruk (10593 in chips)
mr.Unezh: posts the ante 20
dimetruk: posts the ante 20
dimetruk: posts small blind 80
mr.Unezh: posts big blind 160
*** HOLE CARDS ***
Dealt to dimetruk [4c 7h]
dimetruk: raises 160 to 320
mr.Unezh: calls 160
*** FLOP *** [Qd Qh 5d]
mr.Unezh: checks
dimetruk: bets 340
mr.Unezh: folds
Uncalled bet (340) returned to dimetruk
dimetruk collected 680 from pot
dimetruk: doesn't show hand
*** SUMMARY ***
Total pot 680 | Rake 0
Board [Qd Qh 5d]
Seat 1: mr.Unezh (big blind) folded on the Flop
Seat 6: dimetruk (button) (small blind) collected (680)


PokerStars Hand #226572635248: Tournament #3189227656, $27.40+$2.60 USD Hold'em No Limit - Level VI (80/160) - 2021/05/08 18:19:33 MSK [2021/05/08 11:19:33 ET]
Table '3189227656 1' 9-max Seat #6 is the button
Seat 1: mr.Unezh (2747 in chips)
Seat 6: dimetruk (10753 in chips)
mr.Unezh: posts the ante 20
dimetruk: posts the ante 20
dimetruk: posts small blind 80
mr.Unezh: posts big blind 160
*** HOLE CARDS ***
Dealt to dimetruk [6c 9d]
dimetruk: calls 80
mr.Unezh: checks
*** FLOP *** [6h As 8c]
mr.Unezh: checks
dimetruk: bets 160
mr.Unezh: folds
Uncalled bet (160) returned to dimetruk
dimetruk collected 360 from pot
dimetruk: doesn't show hand
*** SUMMARY ***
Total pot 360 | Rake 0
Board [6h As 8c]
Seat 1: mr.Unezh (big blind) folded on the Flop
Seat 6: dimetruk (button) (small blind) collected (360)


PokerStars Hand #226572650534: Tournament #3189227656, $27.40+$2.60 USD Hold'em No Limit - Level VI (80/160) - 2021/05/08 18:20:09 MSK [2021/05/08 11:20:09 ET]
Table '3189227656 1' 9-max Seat #6 is the button
Seat 1: mr.Unezh (2467 in chips)
Seat 6: dimetruk (11033 in chips)
mr.Unezh: posts the ante 20
dimetruk: posts the ante 20
dimetruk: posts small blind 80
mr.Unezh: posts big blind 160
*** HOLE CARDS ***
Dealt to dimetruk [Kc Ah]
dimetruk: raises 160 to 320
mr.Unezh: raises 2127 to 2447 and is all-in
dimetruk: calls 2127
*** FLOP *** [5s 6h 9d]
*** TURN *** [5s 6h 9d] [Qd]
*** RIVER *** [5s 6h 9d Qd] [2c]
*** SHOW DOWN ***
mr.Unezh: shows [4s 4d] (a pair of Fours)
dimetruk: shows [Kc Ah] (high card Ace)
mr.Unezh collected 4934 from pot
*** SUMMARY ***
Total pot 4934 | Rake 0
Board [5s 6h 9d Qd 2c]
Seat 1: mr.Unezh (big blind) showed [4s 4d] and won (4934) with a pair of Fours
Seat 6: dimetruk (button) (small blind) showed [Kc Ah] and lost with high card Ace


PokerStars Hand #226572658050: Tournament #3189227656, $27.40+$2.60 USD Hold'em No Limit - Level VI (80/160) - 2021/05/08 18:20:26 MSK [2021/05/08 11:20:26 ET]
Table '3189227656 1' 9-max Seat #6 is the button
Seat 1: mr.Unezh (4834 in chips)
Seat 6: dimetruk (8666 in chips)
mr.Unezh: posts the ante 20
dimetruk: posts the ante 20
dimetruk: posts small blind 80
mr.Unezh: posts big blind 160
*** HOLE CARDS ***
Dealt to dimetruk [7d Ts]
dimetruk: raises 160 to 320
mr.Unezh: calls 160
*** FLOP *** [Tc 8d 6c]
mr.Unezh: checks
dimetruk: bets 340
mr.Unezh: calls 340
*** TURN *** [Tc 8d 6c] [8s]
mr.Unezh: checks
dimetruk: bets 680
mr.Unezh: folds
Uncalled bet (680) returned to dimetruk
dimetruk collected 1360 from pot
dimetruk: doesn't show hand
*** SUMMARY ***
Total pot 1360 | Rake 0
Board [Tc 8d 6c 8s]
Seat 1: mr.Unezh (big blind) folded on the Turn
Seat 6: dimetruk (button) (small blind) collected (1360)


PokerStars Hand #226572667527: Tournament #3189227656, $27.40+$2.60 USD Hold'em No Limit - Level VI (80/160) - 2021/05/08 18:20:48 MSK [2021/05/08 11:20:48 ET]
Table '3189227656 1' 9-max Seat #6 is the button
Seat 1: mr.Unezh (3814 in chips)
Seat 6: dimetruk (9686 in chips)
mr.Unezh: posts the ante 20
dimetruk: posts the ante 20
dimetruk: posts small blind 80
mr.Unezh: posts big blind 160
*** HOLE CARDS ***
Dealt to dimetruk [4c 6h]
dimetruk: raises 160 to 320
mr.Unezh: calls 160
*** FLOP *** [3s Kh 2s]
mr.Unezh: checks
dimetruk: bets 238
mr.Unezh: folds
Uncalled bet (238) returned to dimetruk
dimetruk collected 680 from pot
dimetruk: doesn't show hand
*** SUMMARY ***
Total pot 680 | Rake 0
Board [3s Kh 2s]
Seat 1: mr.Unezh (big blind) folded on the Flop
Seat 6: dimetruk (button) (small blind) collected (680)


PokerStars Hand #226572683376: Tournament #3189227656, $27.40+$2.60 USD Hold'em No Limit - Level VI (80/160) - 2021/05/08 18:21:05 MSK [2021/05/08 11:21:05 ET]
Table '3189227656 1' 9-max Seat #6 is the button
Seat 1: mr.Unezh (3134 in chips)
Seat 6: dimetruk (10366 in chips)
mr.Unezh: posts the ante 20
dimetruk: posts the ante 20
dimetruk: posts small blind 80
mr.Unezh: posts big blind 160
*** HOLE CARDS ***
Dealt to dimetruk [6c Jc]
dimetruk: raises 160 to 320
mr.Unezh: calls 160
*** FLOP *** [3c 9c 3s]
mr.Unezh: checks
dimetruk: bets 592
mr.Unezh: folds
Uncalled bet (592) returned to dimetruk
dimetruk collected 680 from pot
dimetruk: doesn't show hand
*** SUMMARY ***
Total pot 680 | Rake 0
Board [3c 9c 3s]
Seat 1: mr.Unezh (big blind) folded on the Flop
Seat 6: dimetruk (button) (small blind) collected (680)


PokerStars Hand #226572687915: Tournament #3189227656, $27.40+$2.60 USD Hold'em No Limit - Level VI (80/160) - 2021/05/08 18:21:16 MSK [2021/05/08 11:21:16 ET]
Table '3189227656 1' 9-max Seat #1 is the button
Seat 1: mr.Unezh (2794 in chips)
Seat 6: dimetruk (10706 in chips)
mr.Unezh: posts the ante 20
dimetruk: posts the ante 20
mr.Unezh: posts small blind 80
dimetruk: posts big blind 160
*** HOLE CARDS ***
Dealt to dimetruk [9d Js]
mr.Unezh: raises 160 to 320
dimetruk: calls 160
*** FLOP *** [Qh 8d Jh]
dimetruk: checks
mr.Unezh: bets 340
dimetruk: calls 340
*** TURN *** [Qh 8d Jh] [Kc]
dimetruk: checks
mr.Unezh: bets 680
dimetruk: calls 680
*** RIVER *** [Qh 8d Jh Kc] [8h]
dimetruk: checks
mr.Unezh: bets 1434 and is all-in
dimetruk: folds
Uncalled bet (1434) returned to mr.Unezh
mr.Unezh collected 2720 from pot
mr.Unezh: doesn't show hand
*** SUMMARY ***
Total pot 2720 | Rake 0
Board [Qh 8d Jh Kc 8h]
Seat 1: mr.Unezh (button) (small blind) collected (2720)
Seat 6: dimetruk (big blind) folded on the River


PokerStars Hand #226572705888: Tournament #3189227656, $27.40+$2.60 USD Hold'em No Limit - Level VI (80/160) - 2021/05/08 18:21:57 MSK [2021/05/08 11:21:57 ET]
Table '3189227656 1' 9-max Seat #1 is the button
Seat 1: mr.Unezh (4494 in chips)
Seat 6: dimetruk (9006 in chips)
mr.Unezh: posts the ante 20
dimetruk: posts the ante 20
mr.Unezh: posts small blind 80
dimetruk: posts big blind 160
*** HOLE CARDS ***
Dealt to dimetruk [Qs Kc]
mr.Unezh: raises 160 to 320
dimetruk: calls 160
*** FLOP *** [Qh 2d 2c]
dimetruk: checks
mr.Unezh: bets 224
dimetruk: raises 564 to 788
mr.Unezh: folds
Uncalled bet (564) returned to dimetruk
dimetruk collected 1128 from pot
dimetruk: doesn't show hand
*** SUMMARY ***
Total pot 1128 | Rake 0
Board [Qh 2d 2c]
Seat 1: mr.Unezh (button) (small blind) folded on the Flop
Seat 6: dimetruk (big blind) collected (1128)


PokerStars Hand #226572725166: Tournament #3189227656, $27.40+$2.60 USD Hold'em No Limit - Level VI (80/160) - 2021/05/08 18:22:42 MSK [2021/05/08 11:22:42 ET]
Table '3189227656 1' 9-max Seat #6 is the button
Seat 1: mr.Unezh (3930 in chips)
Seat 6: dimetruk (9570 in chips)
mr.Unezh: posts the ante 20
dimetruk: posts the ante 20
dimetruk: posts small blind 80
mr.Unezh: posts big blind 160
*** HOLE CARDS ***
Dealt to dimetruk [3d Ad]
dimetruk: calls 80
mr.Unezh said, "predlogenie v sile )"
mr.Unezh: raises 320 to 480
dimetruk: raises 9070 to 9550 and is all-in
mr.Unezh: calls 3430 and is all-in
Uncalled bet (5640) returned to dimetruk
*** FLOP *** [Kh 4s 5d]
*** TURN *** [Kh 4s 5d] [Tc]
*** RIVER *** [Kh 4s 5d Tc] [8h]
*** SHOW DOWN ***
mr.Unezh: shows [Jd Kd] (a pair of Kings)
dimetruk: shows [3d Ad] (high card Ace)
mr.Unezh collected 7860 from pot
*** SUMMARY ***
Total pot 7860 | Rake 0
Board [Kh 4s 5d Tc 8h]
Seat 1: mr.Unezh (big blind) showed [Jd Kd] and won (7860) with a pair of Kings
Seat 6: dimetruk (button) (small blind) showed [3d Ad] and lost with high card Ace


PokerStars Hand #226572738242: Tournament #3189227656, $27.40+$2.60 USD Hold'em No Limit - Level VI (80/160) - 2021/05/08 18:23:13 MSK [2021/05/08 11:23:13 ET]
Table '3189227656 1' 9-max Seat #1 is the button
Seat 1: mr.Unezh (7860 in chips)
Seat 6: dimetruk (5640 in chips)
mr.Unezh: posts the ante 20
dimetruk: posts the ante 20
mr.Unezh: posts small blind 80
dimetruk: posts big blind 160
*** HOLE CARDS ***
Dealt to dimetruk [5d 8d]
mr.Unezh: raises 160 to 320
dimetruk: calls 160
*** FLOP *** [Qh 3s As]
dimetruk: checks
mr.Unezh: bets 224
dimetruk: folds
Uncalled bet (224) returned to mr.Unezh
mr.Unezh collected 680 from pot
mr.Unezh: doesn't show hand
*** SUMMARY ***
Total pot 680 | Rake 0
Board [Qh 3s As]
Seat 1: mr.Unezh (button) (small blind) collected (680)
Seat 6: dimetruk (big blind) folded on the Flop


PokerStars Hand #226572745411: Tournament #3189227656, $27.40+$2.60 USD Hold'em No Limit - Level VI (80/160) - 2021/05/08 18:23:29 MSK [2021/05/08 11:23:29 ET]
Table '3189227656 1' 9-max Seat #6 is the button
Seat 1: mr.Unezh (8200 in chips)
Seat 6: dimetruk (5300 in chips)
mr.Unezh: posts the ante 20
dimetruk: posts the ante 20
dimetruk: posts small blind 80
mr.Unezh: posts big blind 160
*** HOLE CARDS ***
Dealt to dimetruk [Jh 5d]
dimetruk: raises 160 to 320
mr.Unezh: calls 160
*** FLOP *** [2h Tc Qd]
mr.Unezh: checks
dimetruk: checks
*** TURN *** [2h Tc Qd] [Kh]
mr.Unezh: bets 340
dimetruk: calls 340
*** RIVER *** [2h Tc Qd Kh] [8d]
mr.Unezh: bets 680
dimetruk: folds
Uncalled bet (680) returned to mr.Unezh
mr.Unezh collected 1360 from pot
mr.Unezh: doesn't show hand
*** SUMMARY ***
Total pot 1360 | Rake 0
Board [2h Tc Qd Kh 8d]
Seat 1: mr.Unezh (big blind) collected (1360)
Seat 6: dimetruk (button) (small blind) folded on the River


PokerStars Hand #226572757367: Tournament #3189227656, $27.40+$2.60 USD Hold'em No Limit - Level VI (80/160) - 2021/05/08 18:23:57 MSK [2021/05/08 11:23:57 ET]
Table '3189227656 1' 9-max Seat #6 is the button
Seat 1: mr.Unezh (9060 in chips)
Seat 6: dimetruk (4440 in chips)
mr.Unezh: posts the ante 20
dimetruk: posts the ante 20
dimetruk: posts small blind 80
mr.Unezh: posts big blind 160
*** HOLE CARDS ***
Dealt to dimetruk [Qc 6s]
dimetruk: calls 80
mr.Unezh: checks
*** FLOP *** [2s 4d 7h]
mr.Unezh: checks
dimetruk: bets 160
mr.Unezh: folds
Uncalled bet (160) returned to dimetruk
dimetruk collected 360 from pot
dimetruk: doesn't show hand
*** SUMMARY ***
Total pot 360 | Rake 0
Board [2s 4d 7h]
Seat 1: mr.Unezh (big blind) folded on the Flop
Seat 6: dimetruk (button) (small blind) collected (360)


PokerStars Hand #226572767572: Tournament #3189227656, $27.40+$2.60 USD Hold'em No Limit - Level VI (80/160) - 2021/05/08 18:24:21 MSK [2021/05/08 11:24:21 ET]
Table '3189227656 1' 9-max Seat #1 is the button
Seat 1: mr.Unezh (9400 in chips)
Seat 6: dimetruk (4100 in chips)
mr.Unezh: posts the ante 20
dimetruk: posts the ante 20
mr.Unezh: posts small blind 80
dimetruk: posts big blind 160
*** HOLE CARDS ***
Dealt to dimetruk [9s Jc]
mr.Unezh: raises 160 to 320
dimetruk: calls 160
*** FLOP *** [Tc 7d 3s]
dimetruk: checks
mr.Unezh: bets 340
dimetruk: calls 340
*** TURN *** [Tc 7d 3s] [Ah]
dimetruk: checks
mr.Unezh: bets 680
dimetruk: folds
Uncalled bet (680) returned to mr.Unezh
mr.Unezh collected 1360 from pot
mr.Unezh: doesn't show hand
*** SUMMARY ***
Total pot 1360 | Rake 0
Board [Tc 7d 3s Ah]
Seat 1: mr.Unezh (button) (small blind) collected (1360)
Seat 6: dimetruk (big blind) folded on the Turn


PokerStars Hand #226572775965: Tournament #3189227656, $27.40+$2.60 USD Hold'em No Limit - Level VI (80/160) - 2021/05/08 18:24:40 MSK [2021/05/08 11:24:40 ET]
Table '3189227656 1' 9-max Seat #6 is the button
Seat 1: mr.Unezh (10080 in chips)
Seat 6: dimetruk (3420 in chips)
mr.Unezh: posts the ante 20
dimetruk: posts the ante 20
dimetruk: posts small blind 80
mr.Unezh: posts big blind 160
*** HOLE CARDS ***
Dealt to dimetruk [7c Qh]
dimetruk: raises 160 to 320
mr.Unezh: calls 160
*** FLOP *** [9d Qd Td]
mr.Unezh: checks
dimetruk: checks
*** TURN *** [9d Qd Td] [Kh]
mr.Unezh: bets 340
dimetruk: calls 340
*** RIVER *** [9d Qd Td Kh] [Ts]
mr.Unezh: checks
dimetruk: checks
*** SHOW DOWN ***
mr.Unezh: shows [Kd Qc] (two pair, Kings and Queens)
dimetruk: mucks hand
mr.Unezh collected 1360 from pot
*** SUMMARY ***
Total pot 1360 | Rake 0
Board [9d Qd Td Kh Ts]
Seat 1: mr.Unezh (big blind) showed [Kd Qc] and won (1360) with two pair, Kings and Queens
Seat 6: dimetruk (button) (small blind) mucked [7c Qh]


PokerStars Hand #226572792279: Tournament #3189227656, $27.40+$2.60 USD Hold'em No Limit - Level VI (80/160) - 2021/05/08 18:25:18 MSK [2021/05/08 11:25:18 ET]
Table '3189227656 1' 9-max Seat #6 is the button
Seat 1: mr.Unezh (10940 in chips)
Seat 6: dimetruk (2560 in chips)
mr.Unezh: posts the ante 20
dimetruk: posts the ante 20
dimetruk: posts small blind 80
mr.Unezh: posts big blind 160
*** HOLE CARDS ***
Dealt to dimetruk [Ac Ad]
dimetruk: calls 80
mr.Unezh: checks
*** FLOP *** [7s Qh 8c]
mr.Unezh: checks
dimetruk: checks
*** TURN *** [7s Qh 8c] [4s]
mr.Unezh: bets 180
dimetruk: raises 2200 to 2380 and is all-in
mr.Unezh: calls 2200
*** RIVER *** [7s Qh 8c 4s] [6s]
*** SHOW DOWN ***
mr.Unezh: shows [Qc 4c] (two pair, Queens and Fours)
dimetruk: shows [Ac Ad] (a pair of Aces)
mr.Unezh collected 5120 from pot
dimetruk finished the tournament in 2nd place and received $73.98.
mr.Unezh wins the tournament and receives $123.30 - congratulations!
*** SUMMARY ***
Total pot 5120 | Rake 0
Board [7s Qh 8c 4s 6s]
Seat 1: mr.Unezh (big blind) showed [Qc 4c] and won (5120) with two pair, Queens and Fours
Seat 6: dimetruk (button) (small blind) showed [Ac Ad] and lost with a pair of Aces


PokerStars Hand #226570810190: Tournament #3189369567, $27.58+$2.42 USD Hold'em No Limit - Level I (10/20) - 2021/05/08 17:01:50 MSK [2021/05/08 10:01:50 ET]
Table '3189369567 1' 6-max Seat #5 is the button
Seat 1: mishanya_pim (941 in chips)
Seat 3: Pricewise500 (904 in chips)
Seat 4: DaMaLaNa (4520 in chips)
Seat 5: dimetruk (1461 in chips)
Seat 6: imantr24 (1174 in chips)
mishanya_pim: posts the ante 3
Pricewise500: posts the ante 3
DaMaLaNa: posts the ante 3
dimetruk: posts the ante 3
imantr24: posts the ante 3
imantr24: posts small blind 10
mishanya_pim: posts big blind 20
*** HOLE CARDS ***
Dealt to dimetruk [Th Ac]
Pricewise500: calls 20
DaMaLaNa: calls 20
dimetruk: raises 45 to 65
imantr24: folds
mishanya_pim: folds
Pricewise500: folds
DaMaLaNa: calls 45
*** FLOP *** [Js Ah 8c]
DaMaLaNa: checks
dimetruk: bets 68
DaMaLaNa: folds
Uncalled bet (68) returned to dimetruk
dimetruk collected 195 from pot
dimetruk: doesn't show hand
*** SUMMARY ***
Total pot 195 | Rake 0
Board [Js Ah 8c]
Seat 1: mishanya_pim (big blind) folded before Flop
Seat 3: Pricewise500 folded before Flop
Seat 4: DaMaLaNa folded on the Flop
Seat 5: dimetruk (button) collected (195)
Seat 6: imantr24 (small blind) folded before Flop


PokerStars Hand #226570846216: Tournament #3189369567, $27.58+$2.42 USD Hold'em No Limit - Level I (10/20) - 2021/05/08 17:03:29 MSK [2021/05/08 10:03:29 ET]
Table '3189369567 1' 6-max Seat #1 is the button
Seat 1: mishanya_pim (905 in chips)
Seat 3: Pricewise500 (958 in chips)
Seat 4: DaMaLaNa (4394 in chips)
Seat 5: dimetruk (1585 in chips)
Seat 6: imantr24 (1158 in chips)
mishanya_pim: posts the ante 3
Pricewise500: posts the ante 3
DaMaLaNa: posts the ante 3
dimetruk: posts the ante 3
imantr24: posts the ante 3
Pricewise500: posts small blind 10
DaMaLaNa: posts big blind 20
*** HOLE CARDS ***
Dealt to dimetruk [As Ad]
dimetruk: raises 20 to 40
imantr24: folds
mishanya_pim: folds
Pricewise500: folds
DaMaLaNa: calls 20
*** FLOP *** [Qh Kc 2c]
DaMaLaNa: checks
dimetruk: bets 53
DaMaLaNa: folds
Uncalled bet (53) returned to dimetruk
dimetruk collected 105 from pot
dimetruk: doesn't show hand
*** SUMMARY ***
Total pot 105 | Rake 0
Board [Qh Kc 2c]
Seat 1: mishanya_pim (button) folded before Flop (didn't bet)
Seat 3: Pricewise500 (small blind) folded before Flop
Seat 4: DaMaLaNa (big blind) folded on the Flop
Seat 5: dimetruk collected (105)
Seat 6: imantr24 folded before Flop (didn't bet)


PokerStars Hand #226570899149: Tournament #3189369567, $27.58+$2.42 USD Hold'em No Limit - Level I (10/20) - 2021/05/08 17:05:54 MSK [2021/05/08 10:05:54 ET]
Table '3189369567 1' 6-max Seat #3 is the button
Seat 1: mishanya_pim (942 in chips)
Seat 3: Pricewise500 (1840 in chips)
Seat 4: DaMaLaNa (3367 in chips)
Seat 5: dimetruk (1547 in chips)
Seat 6: imantr24 (1304 in chips)
mishanya_pim: posts the ante 3
Pricewise500: posts the ante 3
DaMaLaNa: posts the ante 3
dimetruk: posts the ante 3
imantr24: posts the ante 3
DaMaLaNa: posts small blind 10
dimetruk: posts big blind 20
*** HOLE CARDS ***
Dealt to dimetruk [2c Tc]
imantr24: raises 24 to 44
mishanya_pim: folds
Pricewise500: folds
DaMaLaNa: folds
dimetruk: calls 24
*** FLOP *** [4h As Td]
dimetruk: checks
imantr24: bets 37
dimetruk: calls 37
*** TURN *** [4h As Td] [7c]
dimetruk: checks
imantr24: checks
*** RIVER *** [4h As Td 7c] [5c]
dimetruk: bets 65
imantr24: folds
Uncalled bet (65) returned to dimetruk
dimetruk collected 187 from pot
dimetruk: doesn't show hand
*** SUMMARY ***
Total pot 187 | Rake 0
Board [4h As Td 7c 5c]
Seat 1: mishanya_pim folded before Flop (didn't bet)
Seat 3: Pricewise500 (button) folded before Flop (didn't bet)
Seat 4: DaMaLaNa (small blind) folded before Flop
Seat 5: dimetruk (big blind) collected (187)
Seat 6: imantr24 folded on the River


PokerStars Hand #226570938792: Tournament #3189369567, $27.58+$2.42 USD Hold'em No Limit - Level II (15/30) - 2021/05/08 17:07:42 MSK [2021/05/08 10:07:42 ET]
Table '3189369567 1' 6-max Seat #3 is the button
Seat 1: mishanya_pim (878 in chips)
Seat 3: Pricewise500 (1841 in chips)
Seat 4: DaMaLaNa (3539 in chips)
Seat 5: dimetruk (1619 in chips)
Seat 6: imantr24 (1123 in chips)
mishanya_pim: posts the ante 4
Pricewise500: posts the ante 4
DaMaLaNa: posts the ante 4
dimetruk: posts the ante 4
imantr24: posts the ante 4
DaMaLaNa: posts small blind 15
dimetruk: posts big blind 30
*** HOLE CARDS ***
Dealt to dimetruk [9h 2c]
imantr24: folds
mishanya_pim: raises 30 to 60
Pricewise500: folds
DaMaLaNa: folds
dimetruk: calls 30
*** FLOP *** [8s 5d Jd]
dimetruk: checks
mishanya_pim: bets 48
dimetruk: folds
Uncalled bet (48) returned to mishanya_pim
mishanya_pim collected 155 from pot
mishanya_pim: doesn't show hand
*** SUMMARY ***
Total pot 155 | Rake 0
Board [8s 5d Jd]
Seat 1: mishanya_pim collected (155)
Seat 3: Pricewise500 (button) folded before Flop (didn't bet)
Seat 4: DaMaLaNa (small blind) folded before Flop
Seat 5: dimetruk (big blind) folded on the Flop
Seat 6: imantr24 folded before Flop (didn't bet)


PokerStars Hand #226570991878: Tournament #3189369567, $27.58+$2.42 USD Hold'em No Limit - Level II (15/30) - 2021/05/08 17:10:06 MSK [2021/05/08 10:10:06 ET]
Table '3189369567 1' 6-max Seat #3 is the button
Seat 1: mishanya_pim (908 in chips)
Seat 3: Pricewise500 (2062 in chips)
Seat 4: DaMaLaNa (3444 in chips)
Seat 5: dimetruk (1524 in chips)
Seat 6: imantr24 (1062 in chips)
mishanya_pim: posts the ante 4
Pricewise500: posts the ante 4
DaMaLaNa: posts the ante 4
dimetruk: posts the ante 4
imantr24: posts the ante 4
DaMaLaNa: posts small blind 15
dimetruk: posts big blind 30
*** HOLE CARDS ***
Dealt to dimetruk [Qc 9d]
imantr24: raises 30 to 60
mishanya_pim: calls 60
Pricewise500: folds
DaMaLaNa: calls 45
dimetruk: calls 30
*** FLOP *** [Ks 4c 2c]
DaMaLaNa: checks
dimetruk: checks
imantr24: bets 86
mishanya_pim: folds
DaMaLaNa: folds
dimetruk: folds
Uncalled bet (86) returned to imantr24
imantr24 collected 260 from pot
imantr24: doesn't show hand
*** SUMMARY ***
Total pot 260 | Rake 0
Board [Ks 4c 2c]
Seat 1: mishanya_pim folded on the Flop
Seat 3: Pricewise500 (button) folded before Flop (didn't bet)
Seat 4: DaMaLaNa (small blind) folded on the Flop
Seat 5: dimetruk (big blind) folded on the Flop
Seat 6: imantr24 collected (260)


PokerStars Hand #226571004868: Tournament #3189369567, $27.58+$2.42 USD Hold'em No Limit - Level II (15/30) - 2021/05/08 17:10:41 MSK [2021/05/08 10:10:41 ET]
Table '3189369567 1' 6-max Seat #4 is the button
Seat 1: mishanya_pim (844 in chips)
Seat 3: Pricewise500 (2058 in chips)
Seat 4: DaMaLaNa (3380 in chips)
Seat 5: dimetruk (1460 in chips)
Seat 6: imantr24 (1258 in chips)
mishanya_pim: posts the ante 4
Pricewise500: posts the ante 4
DaMaLaNa: posts the ante 4
dimetruk: posts the ante 4
imantr24: posts the ante 4
dimetruk: posts small blind 15
imantr24: posts big blind 30
*** HOLE CARDS ***
Dealt to dimetruk [Td Kc]
mishanya_pim: folds
Pricewise500: folds
DaMaLaNa: calls 30
dimetruk: raises 67 to 97
imantr24: folds
DaMaLaNa: calls 67
*** FLOP *** [2d 9s 5c]
dimetruk: bets 122
DaMaLaNa: folds
Uncalled bet (122) returned to dimetruk
dimetruk collected 244 from pot
dimetruk: doesn't show hand
*** SUMMARY ***
Total pot 244 | Rake 0
Board [2d 9s 5c]
Seat 1: mishanya_pim folded before Flop (didn't bet)
Seat 3: Pricewise500 folded before Flop (didn't bet)
Seat 4: DaMaLaNa (button) folded on the Flop
Seat 5: dimetruk (small blind) collected (244)
Seat 6: imantr24 (big blind) folded before Flop


PokerStars Hand #226571015060: Tournament #3189369567, $27.58+$2.42 USD Hold'em No Limit - Level II (15/30) - 2021/05/08 17:11:09 MSK [2021/05/08 10:11:09 ET]
Table '3189369567 1' 6-max Seat #5 is the button
Seat 1: mishanya_pim (840 in chips)
Seat 3: Pricewise500 (2054 in chips)
Seat 4: DaMaLaNa (3279 in chips)
Seat 5: dimetruk (1603 in chips)
Seat 6: imantr24 (1224 in chips)
mishanya_pim: posts the ante 4
Pricewise500: posts the ante 4
DaMaLaNa: posts the ante 4
dimetruk: posts the ante 4
imantr24: posts the ante 4
imantr24: posts small blind 15
mishanya_pim: posts big blind 30
*** HOLE CARDS ***
Dealt to dimetruk [3s 3h]
Pricewise500: folds
DaMaLaNa: calls 30
dimetruk: raises 67 to 97
imantr24: folds
mishanya_pim: folds
DaMaLaNa: calls 67
*** FLOP *** [9s Kh Kc]
DaMaLaNa: bets 259
dimetruk: folds
Uncalled bet (259) returned to DaMaLaNa
DaMaLaNa collected 259 from pot
*** SUMMARY ***
Total pot 259 | Rake 0
Board [9s Kh Kc]
Seat 1: mishanya_pim (big blind) folded before Flop
Seat 3: Pricewise500 folded before Flop (didn't bet)
Seat 4: DaMaLaNa collected (259)
Seat 5: dimetruk (button) folded on the Flop
Seat 6: imantr24 (small blind) folded before Flop


PokerStars Hand #226571117193: Tournament #3189369567, $27.58+$2.42 USD Hold'em No Limit - Level II (15/30) - 2021/05/08 17:15:42 MSK [2021/05/08 10:15:42 ET]
Table '3189369567 1' 6-max Seat #3 is the button
Seat 1: mishanya_pim (1035 in chips)
Seat 3: Pricewise500 (1801 in chips)
Seat 4: DaMaLaNa (3530 in chips)
Seat 5: dimetruk (1559 in chips)
Seat 6: imantr24 (1075 in chips)
mishanya_pim: posts the ante 4
Pricewise500: posts the ante 4
DaMaLaNa: posts the ante 4
dimetruk: posts the ante 4
imantr24: posts the ante 4
DaMaLaNa: posts small blind 15
dimetruk: posts big blind 30
*** HOLE CARDS ***
Dealt to dimetruk [Jc Kd]
imantr24: folds
mishanya_pim: folds
Pricewise500: folds
DaMaLaNa: raises 30 to 60
dimetruk: calls 30
*** FLOP *** [Ts Th 3s]
DaMaLaNa: checks
dimetruk: bets 70
DaMaLaNa: calls 70
*** TURN *** [Ts Th 3s] [5h]
DaMaLaNa: checks
dimetruk: bets 140
DaMaLaNa: calls 140
*** RIVER *** [Ts Th 3s 5h] [8c]
DaMaLaNa: checks
dimetruk: checks
*** SHOW DOWN ***
DaMaLaNa: shows [As Js] (a pair of Tens)
dimetruk: mucks hand
DaMaLaNa collected 560 from pot
*** SUMMARY ***
Total pot 560 | Rake 0
Board [Ts Th 3s 5h 8c]
Seat 1: mishanya_pim folded before Flop (didn't bet)
Seat 3: Pricewise500 (button) folded before Flop (didn't bet)
Seat 4: DaMaLaNa (small blind) showed [As Js] and won (560) with a pair of Tens
Seat 5: dimetruk (big blind) mucked [Jc Kd]
Seat 6: imantr24 folded before Flop (didn't bet)


PokerStars Hand #226571131712: Tournament #3189369567, $27.58+$2.42 USD Hold'em No Limit - Level III (25/50) - 2021/05/08 17:16:21 MSK [2021/05/08 10:16:21 ET]
Table '3189369567 1' 6-max Seat #4 is the button
Seat 1: mishanya_pim (1031 in chips)
Seat 3: Pricewise500 (1797 in chips)
Seat 4: DaMaLaNa (3816 in chips)
Seat 5: dimetruk (1285 in chips)
Seat 6: imantr24 (1071 in chips)
mishanya_pim: posts the ante 6
Pricewise500: posts the ante 6
DaMaLaNa: posts the ante 6
dimetruk: posts the ante 6
imantr24: posts the ante 6
dimetruk: posts small blind 25
imantr24: posts big blind 50
*** HOLE CARDS ***
Dealt to dimetruk [3c Ad]
mishanya_pim: folds
Pricewise500: folds
DaMaLaNa: calls 50
dimetruk: calls 25
imantr24: checks
*** FLOP *** [Jd 7s 5s]
dimetruk: checks
imantr24: checks
DaMaLaNa: checks
*** TURN *** [Jd 7s 5s] [Kc]
dimetruk: checks
imantr24: bets 100
DaMaLaNa: folds
dimetruk: folds
Uncalled bet (100) returned to imantr24
imantr24 collected 180 from pot
imantr24: doesn't show hand
*** SUMMARY ***
Total pot 180 | Rake 0
Board [Jd 7s 5s Kc]
Seat 1: mishanya_pim folded before Flop (didn't bet)
Seat 3: Pricewise500 folded before Flop (didn't bet)
Seat 4: DaMaLaNa (button) folded on the Turn
Seat 5: dimetruk (small blind) folded on the Turn
Seat 6: imantr24 (big blind) collected (180)


PokerStars Hand #226571145633: Tournament #3189369567, $27.58+$2.42 USD Hold'em No Limit - Level III (25/50) - 2021/05/08 17:16:58 MSK [2021/05/08 10:16:58 ET]
Table '3189369567 1' 6-max Seat #5 is the button
Seat 1: mishanya_pim (1025 in chips)
Seat 3: Pricewise500 (1791 in chips)
Seat 4: DaMaLaNa (3760 in chips)
Seat 5: dimetruk (1229 in chips)
Seat 6: imantr24 (1195 in chips)
mishanya_pim: posts the ante 6
Pricewise500: posts the ante 6
DaMaLaNa: posts the ante 6
dimetruk: posts the ante 6
imantr24: posts the ante 6
imantr24: posts small blind 25
mishanya_pim: posts big blind 50
*** HOLE CARDS ***
Dealt to dimetruk [9h Js]
Pricewise500: folds
DaMaLaNa: folds
dimetruk: raises 50 to 100
imantr24: folds
mishanya_pim: calls 50
*** FLOP *** [2c 7s Ks]
mishanya_pim: checks
dimetruk: bets 89
mishanya_pim: folds
Uncalled bet (89) returned to dimetruk
dimetruk collected 255 from pot
dimetruk: doesn't show hand
*** SUMMARY ***
Total pot 255 | Rake 0
Board [2c 7s Ks]
Seat 1: mishanya_pim (big blind) folded on the Flop
Seat 3: Pricewise500 folded before Flop (didn't bet)
Seat 4: DaMaLaNa folded before Flop (didn't bet)
Seat 5: dimetruk (button) collected (255)
Seat 6: imantr24 (small blind) folded before Flop


PokerStars Hand #226571159820: Tournament #3189369567, $27.58+$2.42 USD Hold'em No Limit - Level III (25/50) - 2021/05/08 17:17:36 MSK [2021/05/08 10:17:36 ET]
Table '3189369567 1' 6-max Seat #6 is the button
Seat 1: mishanya_pim (919 in chips)
Seat 3: Pricewise500 (1785 in chips)
Seat 4: DaMaLaNa (3754 in chips)
Seat 5: dimetruk (1378 in chips)
Seat 6: imantr24 (1164 in chips)
mishanya_pim: posts the ante 6
Pricewise500: posts the ante 6
DaMaLaNa: posts the ante 6
dimetruk: posts the ante 6
imantr24: posts the ante 6
mishanya_pim: posts small blind 25
Pricewise500: posts big blind 50
*** HOLE CARDS ***
Dealt to dimetruk [Jc Ah]
DaMaLaNa: calls 50
dimetruk: raises 100 to 150
imantr24: folds
mishanya_pim: folds
Pricewise500: folds
DaMaLaNa: calls 100
*** FLOP *** [6d Js 9h]
DaMaLaNa: bets 203
dimetruk: raises 1019 to 1222 and is all-in
DaMaLaNa: folds
Uncalled bet (1019) returned to dimetruk
dimetruk collected 811 from pot
dimetruk: doesn't show hand
*** SUMMARY ***
Total pot 811 | Rake 0
Board [6d Js 9h]
Seat 1: mishanya_pim (small blind) folded before Flop
Seat 3: Pricewise500 (big blind) folded before Flop
Seat 4: DaMaLaNa folded on the Flop
Seat 5: dimetruk collected (811)
Seat 6: imantr24 (button) folded before Flop (didn't bet)


PokerStars Hand #226571214965: Tournament #3189369567, $27.58+$2.42 USD Hold'em No Limit - Level III (25/50) - 2021/05/08 17:19:39 MSK [2021/05/08 10:19:39 ET]
Table '3189369567 1' 6-max Seat #4 is the button
Seat 1: mishanya_pim (876 in chips)
Seat 3: Pricewise500 (2324 in chips)
Seat 4: DaMaLaNa (1510 in chips)
Seat 5: dimetruk (1768 in chips)
Seat 6: imantr24 (2522 in chips)
mishanya_pim: posts the ante 6
Pricewise500: posts the ante 6
DaMaLaNa: posts the ante 6
dimetruk: posts the ante 6
imantr24: posts the ante 6
dimetruk: posts small blind 25
imantr24: posts big blind 50
*** HOLE CARDS ***
Dealt to dimetruk [Ac 8d]
mishanya_pim: folds
Pricewise500: folds
DaMaLaNa: folds
dimetruk: raises 50 to 100
imantr24: calls 50
*** FLOP *** [Ad 5s As]
dimetruk: bets 81
imantr24: folds
Uncalled bet (81) returned to dimetruk
dimetruk collected 230 from pot
dimetruk: doesn't show hand
*** SUMMARY ***
Total pot 230 | Rake 0
Board [Ad 5s As]
Seat 1: mishanya_pim folded before Flop (didn't bet)
Seat 3: Pricewise500 folded before Flop (didn't bet)
Seat 4: DaMaLaNa (button) folded before Flop (didn't bet)
Seat 5: dimetruk (small blind) collected (230)
Seat 6: imantr24 (big blind) folded on the Flop


PokerStars Hand #226571261991: Tournament #3189369567, $27.58+$2.42 USD Hold'em No Limit - Level III (25/50) - 2021/05/08 17:21:45 MSK [2021/05/08 10:21:45 ET]
Table '3189369567 1' 6-max Seat #3 is the button
Seat 1: mishanya_pim (1152 in chips)
Seat 3: Pricewise500 (2265 in chips)
Seat 4: DaMaLaNa (1436 in chips)
Seat 5: dimetruk (1874 in chips)
Seat 6: imantr24 (2273 in chips)
mishanya_pim: posts the ante 6
Pricewise500: posts the ante 6
DaMaLaNa: posts the ante 6
dimetruk: posts the ante 6
imantr24: posts the ante 6
DaMaLaNa: posts small blind 25
dimetruk: posts big blind 50
*** HOLE CARDS ***
Dealt to dimetruk [Ah 6h]
imantr24: raises 50 to 100
mishanya_pim: calls 100
Pricewise500: folds
DaMaLaNa: folds
dimetruk: calls 50
*** FLOP *** [Ts 8d Qd]
dimetruk: checks
imantr24: bets 117
mishanya_pim: calls 117
dimetruk: folds
*** TURN *** [Ts 8d Qd] [5c]
imantr24: bets 300
mishanya_pim: folds
Uncalled bet (300) returned to imantr24
imantr24 collected 589 from pot
imantr24: doesn't show hand
*** SUMMARY ***
Total pot 589 | Rake 0
Board [Ts 8d Qd 5c]
Seat 1: mishanya_pim folded on the Turn
Seat 3: Pricewise500 (button) folded before Flop (didn't bet)
Seat 4: DaMaLaNa (small blind) folded before Flop
Seat 5: dimetruk (big blind) folded on the Flop
Seat 6: imantr24 collected (589)


PokerStars Hand #226571350529: Tournament #3189369567, $27.58+$2.42 USD Hold'em No Limit - Level III (25/50) - 2021/05/08 17:25:40 MSK [2021/05/08 10:25:40 ET]
Table '3189369567 1' 6-max Seat #1 is the button
Seat 1: mishanya_pim (731 in chips)
Seat 3: Pricewise500 (2401 in chips)
Seat 4: DaMaLaNa (962 in chips)
Seat 5: dimetruk (1880 in chips)
Seat 6: imantr24 (3026 in chips)
mishanya_pim: posts the ante 6
Pricewise500: posts the ante 6
DaMaLaNa: posts the ante 6
dimetruk: posts the ante 6
imantr24: posts the ante 6
Pricewise500: posts small blind 25
DaMaLaNa: posts big blind 50
*** HOLE CARDS ***
Dealt to dimetruk [Th Jc]
dimetruk: raises 50 to 100
imantr24: calls 100
mishanya_pim: folds
Pricewise500: folds
DaMaLaNa: folds
*** FLOP *** [Qd 2s 2h]
dimetruk: bets 153
imantr24: calls 153
*** TURN *** [Qd 2s 2h] [Kd]
dimetruk: bets 306
imantr24: folds
Uncalled bet (306) returned to dimetruk
dimetruk collected 611 from pot
dimetruk: doesn't show hand
*** SUMMARY ***
Total pot 611 | Rake 0
Board [Qd 2s 2h Kd]
Seat 1: mishanya_pim (button) folded before Flop (didn't bet)
Seat 3: Pricewise500 (small blind) folded before Flop
Seat 4: DaMaLaNa (big blind) folded before Flop
Seat 5: dimetruk collected (611)
Seat 6: imantr24 folded on the Turn


PokerStars Hand #226571363388: Tournament #3189369567, $27.58+$2.42 USD Hold'em No Limit - Level III (25/50) - 2021/05/08 17:26:14 MSK [2021/05/08 10:26:14 ET]
Table '3189369567 1' 6-max Seat #3 is the button
Seat 1: mishanya_pim (725 in chips)
Seat 3: Pricewise500 (2370 in chips)
Seat 4: DaMaLaNa (906 in chips)
Seat 5: dimetruk (2232 in chips)
Seat 6: imantr24 (2767 in chips)
mishanya_pim: posts the ante 6
Pricewise500: posts the ante 6
DaMaLaNa: posts the ante 6
dimetruk: posts the ante 6
imantr24: posts the ante 6
DaMaLaNa: posts small blind 25
dimetruk: posts big blind 50
*** HOLE CARDS ***
Dealt to dimetruk [Ac 7h]
imantr24: folds
mishanya_pim: folds
Pricewise500: raises 50 to 100
DaMaLaNa: folds
dimetruk: calls 50
*** FLOP *** [Kc 6d 2d]
dimetruk: checks
Pricewise500: bets 128
dimetruk: folds
Uncalled bet (128) returned to Pricewise500
Pricewise500 collected 255 from pot
Pricewise500: doesn't show hand
*** SUMMARY ***
Total pot 255 | Rake 0
Board [Kc 6d 2d]
Seat 1: mishanya_pim folded before Flop (didn't bet)
Seat 3: Pricewise500 (button) collected (255)
Seat 4: DaMaLaNa (small blind) folded before Flop
Seat 5: dimetruk (big blind) folded on the Flop
Seat 6: imantr24 folded before Flop (didn't bet)


PokerStars Hand #226571426134: Tournament #3189369567, $27.58+$2.42 USD Hold'em No Limit - Level IV (40/80) - 2021/05/08 17:28:47 MSK [2021/05/08 10:28:47 ET]
Table '3189369567 1' 6-max Seat #4 is the button
Seat 1: mishanya_pim (889 in chips)
Seat 3: Pricewise500 (2359 in chips)
Seat 4: DaMaLaNa (1205 in chips)
Seat 5: dimetruk (1956 in chips)
Seat 6: imantr24 (2591 in chips)
mishanya_pim: posts the ante 10
Pricewise500: posts the ante 10
DaMaLaNa: posts the ante 10
dimetruk: posts the ante 10
imantr24: posts the ante 10
dimetruk: posts small blind 40
imantr24: posts big blind 80
*** HOLE CARDS ***
Dealt to dimetruk [3s 6s]
mishanya_pim: folds
Pricewise500: folds
DaMaLaNa: calls 80
dimetruk: calls 40
imantr24: checks
*** FLOP *** [Kc As 3c]
dimetruk: checks
imantr24: checks
DaMaLaNa: checks
*** TURN *** [Kc As 3c] [Qh]
dimetruk: bets 102
imantr24: folds
DaMaLaNa: folds
Uncalled bet (102) returned to dimetruk
dimetruk collected 290 from pot
dimetruk: doesn't show hand
*** SUMMARY ***
Total pot 290 | Rake 0
Board [Kc As 3c Qh]
Seat 1: mishanya_pim folded before Flop (didn't bet)
Seat 3: Pricewise500 folded before Flop (didn't bet)
Seat 4: DaMaLaNa (button) folded on the Turn
Seat 5: dimetruk (small blind) collected (290)
Seat 6: imantr24 (big blind) folded on the Turn


PokerStars Hand #226571464047: Tournament #3189369567, $27.58+$2.42 USD Hold'em No Limit - Level IV (40/80) - 2021/05/08 17:30:27 MSK [2021/05/08 10:30:27 ET]
Table '3189369567 1' 6-max Seat #3 is the button
Seat 1: mishanya_pim (1059 in chips)
Seat 3: Pricewise500 (2199 in chips)
Seat 4: DaMaLaNa (2260 in chips)
Seat 5: dimetruk (1966 in chips)
Seat 6: imantr24 (1516 in chips)
mishanya_pim: posts the ante 10
Pricewise500: posts the ante 10
DaMaLaNa: posts the ante 10
dimetruk: posts the ante 10
imantr24: posts the ante 10
DaMaLaNa: posts small blind 40
dimetruk: posts big blind 80
*** HOLE CARDS ***
Dealt to dimetruk [8h 9s]
imantr24: folds
mishanya_pim: folds
Pricewise500: folds
DaMaLaNa: calls 40
dimetruk: checks
*** FLOP *** [Js 7c 7h]
DaMaLaNa: bets 160
dimetruk: calls 160
*** TURN *** [Js 7c 7h] [Qs]
DaMaLaNa: bets 160
dimetruk: folds
Uncalled bet (160) returned to DaMaLaNa
DaMaLaNa collected 530 from pot
*** SUMMARY ***
Total pot 530 | Rake 0
Board [Js 7c 7h Qs]
Seat 1: mishanya_pim folded before Flop (didn't bet)
Seat 3: Pricewise500 (button) folded before Flop (didn't bet)
Seat 4: DaMaLaNa (small blind) collected (530)
Seat 5: dimetruk (big blind) folded on the Turn
Seat 6: imantr24 folded before Flop (didn't bet)


PokerStars Hand #226571521384: Tournament #3189369567, $27.58+$2.42 USD Hold'em No Limit - Level IV (40/80) - 2021/05/08 17:32:56 MSK [2021/05/08 10:32:56 ET]
Table '3189369567 1' 6-max Seat #3 is the button
Seat 1: mishanya_pim (849 in chips)
Seat 3: Pricewise500 (2369 in chips)
Seat 4: DaMaLaNa (2630 in chips)
Seat 5: dimetruk (1636 in chips)
Seat 6: imantr24 (1516 in chips)
mishanya_pim: posts the ante 10
Pricewise500: posts the ante 10
DaMaLaNa: posts the ante 10
dimetruk: posts the ante 10
imantr24: posts the ante 10
DaMaLaNa: posts small blind 40
dimetruk: posts big blind 80
*** HOLE CARDS ***
Dealt to dimetruk [Js 3s]
imantr24: folds
mishanya_pim: folds
Pricewise500: folds
DaMaLaNa: raises 80 to 160
dimetruk: calls 80
*** FLOP *** [8s 2c 2s]
DaMaLaNa: bets 185
dimetruk: calls 185
*** TURN *** [8s 2c 2s] [6s]
DaMaLaNa: bets 205
dimetruk: raises 1076 to 1281 and is all-in
DaMaLaNa: folds
Uncalled bet (1076) returned to dimetruk
dimetruk collected 1150 from pot
dimetruk: doesn't show hand
*** SUMMARY ***
Total pot 1150 | Rake 0
Board [8s 2c 2s 6s]
Seat 1: mishanya_pim folded before Flop (didn't bet)
Seat 3: Pricewise500 (button) folded before Flop (didn't bet)
Seat 4: DaMaLaNa (small blind) folded on the Turn
Seat 5: dimetruk (big blind) collected (1150)
Seat 6: imantr24 folded before Flop (didn't bet)


PokerStars Hand #226571561085: Tournament #3189369567, $27.58+$2.42 USD Hold'em No Limit - Level IV (40/80) - 2021/05/08 17:34:38 MSK [2021/05/08 10:34:38 ET]
Table '3189369567 1' 6-max Seat #5 is the button
Seat 3: Pricewise500 (3348 in chips)
Seat 4: DaMaLaNa (2060 in chips)
Seat 5: dimetruk (2176 in chips)
Seat 6: imantr24 (1416 in chips)
Pricewise500: posts the ante 10
DaMaLaNa: posts the ante 10
dimetruk: posts the ante 10
imantr24: posts the ante 10
imantr24: posts small blind 40
Pricewise500: posts big blind 80
*** HOLE CARDS ***
Dealt to dimetruk [4d Kh]
DaMaLaNa: folds
dimetruk: raises 80 to 160
imantr24: folds
Pricewise500: calls 80
*** FLOP *** [4h 9d 6s]
Pricewise500: checks
dimetruk: bets 200
Pricewise500: folds
Uncalled bet (200) returned to dimetruk
dimetruk collected 400 from pot
dimetruk: doesn't show hand
*** SUMMARY ***
Total pot 400 | Rake 0
Board [4h 9d 6s]
Seat 3: Pricewise500 (big blind) folded on the Flop
Seat 4: DaMaLaNa folded before Flop (didn't bet)
Seat 5: dimetruk (button) collected (400)
Seat 6: imantr24 (small blind) folded before Flop


PokerStars Hand #226571574762: Tournament #3189369567, $27.58+$2.42 USD Hold'em No Limit - Level IV (40/80) - 2021/05/08 17:35:13 MSK [2021/05/08 10:35:13 ET]
Table '3189369567 1' 6-max Seat #6 is the button
Seat 3: Pricewise500 (3178 in chips)
Seat 4: DaMaLaNa (2050 in chips)
Seat 5: dimetruk (2406 in chips)
Seat 6: imantr24 (1366 in chips)
Pricewise500: posts the ante 10
DaMaLaNa: posts the ante 10
dimetruk: posts the ante 10
imantr24: posts the ante 10
Pricewise500: posts small blind 40
DaMaLaNa: posts big blind 80
*** HOLE CARDS ***
Dealt to dimetruk [Kd Th]
dimetruk: raises 80 to 160
imantr24: folds
Pricewise500: folds
DaMaLaNa: calls 80
*** FLOP *** [3s 5c Ah]
DaMaLaNa: checks
dimetruk: bets 140
DaMaLaNa: raises 180 to 320
dimetruk: folds
Uncalled bet (180) returned to DaMaLaNa
DaMaLaNa collected 680 from pot
*** SUMMARY ***
Total pot 680 | Rake 0
Board [3s 5c Ah]
Seat 3: Pricewise500 (small blind) folded before Flop
Seat 4: DaMaLaNa (big blind) collected (680)
Seat 5: dimetruk folded on the Flop
Seat 6: imantr24 (button) folded before Flop (didn't bet)


PokerStars Hand #226571582270: Tournament #3189369567, $27.58+$2.42 USD Hold'em No Limit - Level IV (40/80) - 2021/05/08 17:35:32 MSK [2021/05/08 10:35:32 ET]
Table '3189369567 1' 6-max Seat #3 is the button
Seat 3: Pricewise500 (3128 in chips)
Seat 4: DaMaLaNa (2420 in chips)
Seat 5: dimetruk (2096 in chips)
Seat 6: imantr24 (1356 in chips)
Pricewise500: posts the ante 10
DaMaLaNa: posts the ante 10
dimetruk: posts the ante 10
imantr24: posts the ante 10
DaMaLaNa: posts small blind 40
dimetruk: posts big blind 80
*** HOLE CARDS ***
Dealt to dimetruk [2s 5h]
imantr24: raises 80 to 160
Pricewise500: calls 160
DaMaLaNa: folds
dimetruk: calls 80
*** FLOP *** [8h 4h Jh]
dimetruk: checks
imantr24: checks
Pricewise500: checks
*** TURN *** [8h 4h Jh] [7s]
dimetruk: bets 280
imantr24: folds
Pricewise500: folds
Uncalled bet (280) returned to dimetruk
dimetruk collected 560 from pot
dimetruk: doesn't show hand
*** SUMMARY ***
Total pot 560 | Rake 0
Board [8h 4h Jh 7s]
Seat 3: Pricewise500 (button) folded on the Turn
Seat 4: DaMaLaNa (small blind) folded before Flop
Seat 5: dimetruk (big blind) collected (560)
Seat 6: imantr24 folded on the Turn


PokerStars Hand #226571607545: Tournament #3189369567, $27.58+$2.42 USD Hold'em No Limit - Level V (60/120) - 2021/05/08 17:36:37 MSK [2021/05/08 10:36:37 ET]
Table '3189369567 1' 6-max Seat #5 is the button
Seat 3: Pricewise500 (2948 in chips)
Seat 4: DaMaLaNa (2360 in chips)
Seat 5: dimetruk (2316 in chips)
Seat 6: imantr24 (1376 in chips)
Pricewise500: posts the ante 15
DaMaLaNa: posts the ante 15
dimetruk: posts the ante 15
imantr24: posts the ante 15
imantr24: posts small blind 60
Pricewise500: posts big blind 120
*** HOLE CARDS ***
Dealt to dimetruk [Jc Js]
DaMaLaNa: raises 240 to 360
dimetruk: raises 1941 to 2301 and is all-in
imantr24: folds
Pricewise500: folds
DaMaLaNa: calls 1941
*** FLOP *** [7c Qh 5c]
*** TURN *** [7c Qh 5c] [Qd]
*** RIVER *** [7c Qh 5c Qd] [7d]
*** SHOW DOWN ***
DaMaLaNa: shows [As Ts] (two pair, Queens and Sevens)
dimetruk: shows [Jc Js] (two pair, Queens and Jacks)
dimetruk collected 4842 from pot
*** SUMMARY ***
Total pot 4842 | Rake 0
Board [7c Qh 5c Qd 7d]
Seat 3: Pricewise500 (big blind) folded before Flop
Seat 4: DaMaLaNa showed [As Ts] and lost with two pair, Queens and Sevens
Seat 5: dimetruk (button) showed [Jc Js] and won (4842) with two pair, Queens and Jacks
Seat 6: imantr24 (small blind) folded before Flop


PokerStars Hand #226571619959: Tournament #3189369567, $27.58+$2.42 USD Hold'em No Limit - Level V (60/120) - 2021/05/08 17:37:09 MSK [2021/05/08 10:37:09 ET]
Table '3189369567 1' 6-max Seat #6 is the button
Seat 3: Pricewise500 (2813 in chips)
Seat 4: DaMaLaNa (44 in chips)
Seat 5: dimetruk (4842 in chips)
Seat 6: imantr24 (1301 in chips)
Pricewise500: posts the ante 15
DaMaLaNa: posts the ante 15
dimetruk: posts the ante 15
imantr24: posts the ante 15
Pricewise500: posts small blind 60
DaMaLaNa: posts big blind 29 and is all-in
*** HOLE CARDS ***
Dealt to dimetruk [8h 5c]
dimetruk: raises 180 to 240
imantr24: folds
Pricewise500: calls 180
*** FLOP *** [Kd 7d 2c]
Pricewise500: checks
dimetruk: bets 199
Pricewise500: calls 199
*** TURN *** [Kd 7d 2c] [Ah]
Pricewise500: checks
dimetruk: checks
*** RIVER *** [Kd 7d 2c Ah] [7s]
Pricewise500: bets 484
dimetruk: folds
Uncalled bet (484) returned to Pricewise500
*** SHOW DOWN ***
Pricewise500: shows [7h Ac] (a full house, Sevens full of Aces)
Pricewise500 collected 820 from side pot
DaMaLaNa: shows [Kc Ad] (two pair, Aces and Kings)
Pricewise500 collected 147 from main pot
DaMaLaNa finished the tournament in 4th place
*** SUMMARY ***
Total pot 967 Main pot 147. Side pot 820. | Rake 0
Board [Kd 7d 2c Ah 7s]
Seat 3: Pricewise500 (small blind) showed [7h Ac] and won (967) with a full house, Sevens full of Aces
Seat 4: DaMaLaNa (big blind) showed [Kc Ad] and lost with two pair, Aces and Kings
Seat 5: dimetruk folded on the River
Seat 6: imantr24 (button) folded before Flop (didn't bet)


PokerStars Hand #226571645360: Tournament #3189369567, $27.58+$2.42 USD Hold'em No Limit - Level V (60/120) - 2021/05/08 17:38:14 MSK [2021/05/08 10:38:14 ET]
Table '3189369567 1' 6-max Seat #5 is the button
Seat 3: Pricewise500 (3311 in chips)
Seat 5: dimetruk (4538 in chips)
Seat 6: imantr24 (1151 in chips)
Pricewise500: posts the ante 15
dimetruk: posts the ante 15
imantr24: posts the ante 15
imantr24: posts small blind 60
Pricewise500: posts big blind 120
*** HOLE CARDS ***
Dealt to dimetruk [7c Ac]
dimetruk: raises 120 to 240
imantr24: folds
Pricewise500: calls 120
*** FLOP *** [5s Tc 2h]
Pricewise500: checks
dimetruk: bets 439
Pricewise500: raises 1463 to 1902
dimetruk: folds
Uncalled bet (1463) returned to Pricewise500
Pricewise500 collected 1463 from pot
Pricewise500: doesn't show hand
*** SUMMARY ***
Total pot 1463 | Rake 0
Board [5s Tc 2h]
Seat 3: Pricewise500 (big blind) collected (1463)
Seat 5: dimetruk (button) folded on the Flop
Seat 6: imantr24 (small blind) folded before Flop


PokerStars Hand #226571670826: Tournament #3189369567, $27.58+$2.42 USD Hold'em No Limit - Level V (60/120) - 2021/05/08 17:39:19 MSK [2021/05/08 10:39:19 ET]
Table '3189369567 1' 6-max Seat #5 is the button
Seat 3: Pricewise500 (5291 in chips)
Seat 5: dimetruk (3709 in chips)
Pricewise500: posts the ante 15
dimetruk: posts the ante 15
dimetruk: posts small blind 60
Pricewise500: posts big blind 120
*** HOLE CARDS ***
Dealt to dimetruk [Ks Kh]
dimetruk: raises 120 to 240
Pricewise500: calls 120
*** FLOP *** [2h Kc 3d]
Pricewise500: bets 255
dimetruk: calls 255
*** TURN *** [2h Kc 3d] [6s]
Pricewise500: bets 120
dimetruk: raises 441 to 561
Pricewise500: folds
Uncalled bet (441) returned to dimetruk
dimetruk collected 1260 from pot
dimetruk: doesn't show hand
*** SUMMARY ***
Total pot 1260 | Rake 0
Board [2h Kc 3d 6s]
Seat 3: Pricewise500 (big blind) folded on the Turn
Seat 5: dimetruk (button) (small blind) collected (1260)


PokerStars Hand #226571682460: Tournament #3189369567, $27.58+$2.42 USD Hold'em No Limit - Level V (60/120) - 2021/05/08 17:39:48 MSK [2021/05/08 10:39:48 ET]
Table '3189369567 1' 6-max Seat #3 is the button
Seat 3: Pricewise500 (4661 in chips)
Seat 5: dimetruk (4339 in chips)
Pricewise500: posts the ante 15
dimetruk: posts the ante 15
Pricewise500: posts small blind 60
dimetruk: posts big blind 120
*** HOLE CARDS ***
Dealt to dimetruk [Qs Jd]
Pricewise500: raises 120 to 240
dimetruk: calls 120
*** FLOP *** [Js Tc 2s]
dimetruk: checks
Pricewise500: bets 255
dimetruk: calls 255
*** TURN *** [Js Tc 2s] [4h]
dimetruk: checks
Pricewise500: bets 1020
dimetruk: raises 2809 to 3829 and is all-in
Pricewise500: calls 2809
*** RIVER *** [Js Tc 2s 4h] [Td]
*** SHOW DOWN ***
dimetruk: shows [Qs Jd] (two pair, Jacks and Tens)
Pricewise500: shows [Qd Qc] (two pair, Queens and Tens)
Pricewise500 collected 8678 from pot
dimetruk finished the tournament in 2nd place and received $57.91.
Pricewise500 wins the tournament and receives $107.57 - congratulations!
*** SUMMARY ***
Total pot 8678 | Rake 0
Board [Js Tc 2s 4h Td]
Seat 3: Pricewise500 (button) (small blind) showed [Qd Qc] and won (8678) with two pair, Queens and Tens
Seat 5: dimetruk (big blind) showed [Qs Jd] and lost with two pair, Jacks and Tens


PokerStars Hand #226570314097: Tournament #3189414322, $13.79+$1.21 USD Hold'em No Limit - Level I (10/20) - 2021/05/08 16:38:31 MSK [2021/05/08 9:38:31 ET]
Table '3189414322 1' 6-max Seat #4 is the button
Seat 1: 1sT.NexTee (3019 in chips)
Seat 2: guprozaBRA (1361 in chips)
Seat 4: dimetruk (1484 in chips)
Seat 5: nasir99 (1568 in chips)
Seat 6: mishanya_pim (1568 in chips)
1sT.NexTee: posts the ante 3
guprozaBRA: posts the ante 3
dimetruk: posts the ante 3
nasir99: posts the ante 3
mishanya_pim: posts the ante 3
nasir99: posts small blind 10
mishanya_pim: posts big blind 20
*** HOLE CARDS ***
Dealt to dimetruk [Qs Qc]
1sT.NexTee: folds
guprozaBRA: raises 40 to 60
dimetruk: raises 90 to 150
nasir99: folds
mishanya_pim: folds
guprozaBRA: calls 90
*** FLOP *** [Kh 5h 4h]
guprozaBRA: checks
dimetruk: bets 121
guprozaBRA: calls 121
*** TURN *** [Kh 5h 4h] [5d]
guprozaBRA: checks
dimetruk: bets 294
guprozaBRA: raises 793 to 1087 and is all-in
dimetruk: folds
Uncalled bet (793) returned to guprozaBRA
guprozaBRA collected 1175 from pot
guprozaBRA: doesn't show hand
*** SUMMARY ***
Total pot 1175 | Rake 0
Board [Kh 5h 4h 5d]
Seat 1: 1sT.NexTee folded before Flop (didn't bet)
Seat 2: guprozaBRA collected (1175)
Seat 4: dimetruk (button) folded on the Turn
Seat 5: nasir99 (small blind) folded before Flop
Seat 6: mishanya_pim (big blind) folded before Flop


PokerStars Hand #226570354997: Tournament #3189414322, $13.79+$1.21 USD Hold'em No Limit - Level I (10/20) - 2021/05/08 16:40:27 MSK [2021/05/08 9:40:27 ET]
Table '3189414322 1' 6-max Seat #1 is the button
Seat 1: 1sT.NexTee (3319 in chips)
Seat 2: guprozaBRA (1693 in chips)
Seat 4: dimetruk (910 in chips)
Seat 5: nasir99 (1549 in chips)
Seat 6: mishanya_pim (1529 in chips)
1sT.NexTee: posts the ante 3
guprozaBRA: posts the ante 3
dimetruk: posts the ante 3
nasir99: posts the ante 3
mishanya_pim: posts the ante 3
guprozaBRA: posts small blind 10
dimetruk: posts big blind 20
*** HOLE CARDS ***
Dealt to dimetruk [Ad Jc]
nasir99: folds
mishanya_pim: raises 40 to 60
1sT.NexTee: folds
guprozaBRA: folds
dimetruk: calls 40
*** FLOP *** [Qh 7h 9h]
dimetruk: checks
mishanya_pim: bets 87
dimetruk: folds
Uncalled bet (87) returned to mishanya_pim
mishanya_pim collected 145 from pot
mishanya_pim: doesn't show hand
*** SUMMARY ***
Total pot 145 | Rake 0
Board [Qh 7h 9h]
Seat 1: 1sT.NexTee (button) folded before Flop (didn't bet)
Seat 2: guprozaBRA (small blind) folded before Flop
Seat 4: dimetruk (big blind) folded on the Flop
Seat 5: nasir99 folded before Flop (didn't bet)
Seat 6: mishanya_pim collected (145)


PokerStars Hand #226570406004: Tournament #3189414322, $13.79+$1.21 USD Hold'em No Limit - Level I (10/20) - 2021/05/08 16:42:50 MSK [2021/05/08 9:42:50 ET]
Table '3189414322 1' 6-max Seat #1 is the button
Seat 1: 1sT.NexTee (3319 in chips)
Seat 2: guprozaBRA (186 in chips)
Seat 4: dimetruk (825 in chips)
Seat 5: nasir99 (3056 in chips)
Seat 6: mishanya_pim (1614 in chips)
1sT.NexTee: posts the ante 3
guprozaBRA: posts the ante 3
dimetruk: posts the ante 3
nasir99: posts the ante 3
mishanya_pim: posts the ante 3
guprozaBRA: posts small blind 10
dimetruk: posts big blind 20
*** HOLE CARDS ***
Dealt to dimetruk [8d 4d]
nasir99: folds
mishanya_pim: raises 24 to 44
1sT.NexTee: folds
guprozaBRA said, "<'))><<'))><<'))><<'))><"
guprozaBRA: folds
dimetruk: calls 24
*** FLOP *** [5c 6s 7c]
dimetruk: checks
guprozaBRA said, "zero sense call"
guprozaBRA said, "re tarded"
mishanya_pim: checks
*** TURN *** [5c 6s 7c] [Tc]
guprozaBRA said, "stupid"
dimetruk: bets 57
mishanya_pim: folds
Uncalled bet (57) returned to dimetruk
nasir99 said, "cry more"
dimetruk collected 113 from pot
dimetruk: doesn't show hand
*** SUMMARY ***
Total pot 113 | Rake 0
Board [5c 6s 7c Tc]
Seat 1: 1sT.NexTee (button) folded before Flop (didn't bet)
Seat 2: guprozaBRA (small blind) folded before Flop
Seat 4: dimetruk (big blind) collected (113)
Seat 5: nasir99 folded before Flop (didn't bet)
Seat 6: mishanya_pim folded on the Turn


PokerStars Hand #226570422051: Tournament #3189414322, $13.79+$1.21 USD Hold'em No Limit - Level I (10/20) - 2021/05/08 16:43:30 MSK [2021/05/08 9:43:30 ET]
Table '3189414322 1' 6-max Seat #2 is the button
Seat 1: 1sT.NexTee (3316 in chips)
Seat 2: guprozaBRA (173 in chips)
Seat 4: dimetruk (891 in chips)
Seat 5: nasir99 (3053 in chips)
Seat 6: mishanya_pim (1567 in chips)
1sT.NexTee: posts the ante 3
guprozaBRA: posts the ante 3
dimetruk: posts the ante 3
nasir99: posts the ante 3
mishanya_pim: posts the ante 3
dimetruk: posts small blind 10
nasir99: posts big blind 20
*** HOLE CARDS ***
Dealt to dimetruk [5s Kc]
mishanya_pim: folds
guprozaBRA said, "zero sense"
1sT.NexTee: folds
guprozaBRA: folds
dimetruk: raises 20 to 40
guprozaBRA said, "like a HUGE FISH"
nasir99: calls 20
*** FLOP *** [4h Ad 9d]
dimetruk: bets 30
nasir99: calls 30
*** TURN *** [4h Ad 9d] [2s]
dimetruk: bets 116
nasir99: calls 116
*** RIVER *** [4h Ad 9d 2s] [7c]
dimetruk: checks
nasir99: bets 255
dimetruk: folds
Uncalled bet (255) returned to nasir99
nasir99 collected 387 from pot
*** SUMMARY ***
Total pot 387 | Rake 0
Board [4h Ad 9d 2s 7c]
Seat 1: 1sT.NexTee folded before Flop (didn't bet)
Seat 2: guprozaBRA (button) folded before Flop (didn't bet)
Seat 4: dimetruk (small blind) folded on the River
Seat 5: nasir99 (big blind) collected (387)
Seat 6: mishanya_pim folded before Flop (didn't bet)


PokerStars Hand #226570439012: Tournament #3189414322, $13.79+$1.21 USD Hold'em No Limit - Level I (10/20) - 2021/05/08 16:44:18 MSK [2021/05/08 9:44:18 ET]
Table '3189414322 1' 6-max Seat #4 is the button
Seat 1: 1sT.NexTee (3313 in chips)
Seat 2: guprozaBRA (170 in chips)
Seat 4: dimetruk (702 in chips)
Seat 5: nasir99 (3251 in chips)
Seat 6: mishanya_pim (1564 in chips)
1sT.NexTee: posts the ante 3
guprozaBRA: posts the ante 3
dimetruk: posts the ante 3
nasir99: posts the ante 3
mishanya_pim: posts the ante 3
nasir99: posts small blind 10
mishanya_pim: posts big blind 20
*** HOLE CARDS ***
Dealt to dimetruk [Ac Qc]
1sT.NexTee: folds
guprozaBRA: raises 147 to 167 and is all-in
dimetruk: raises 532 to 699 and is all-in
nasir99: folds
mishanya_pim: folds
Uncalled bet (532) returned to dimetruk
*** FLOP *** [4h Jd 2s]
*** TURN *** [4h Jd 2s] [Jc]
*** RIVER *** [4h Jd 2s Jc] [Qs]
*** SHOW DOWN ***
guprozaBRA: shows [9s Kh] (a pair of Jacks)
dimetruk: shows [Ac Qc] (two pair, Queens and Jacks)
dimetruk collected 379 from pot
guprozaBRA finished the tournament in 5th place
*** SUMMARY ***
Total pot 379 | Rake 0
Board [4h Jd 2s Jc Qs]
Seat 1: 1sT.NexTee folded before Flop (didn't bet)
Seat 2: guprozaBRA showed [9s Kh] and lost with a pair of Jacks
Seat 4: dimetruk (button) showed [Ac Qc] and won (379) with two pair, Queens and Jacks
Seat 5: nasir99 (small blind) folded before Flop
Seat 6: mishanya_pim (big blind) folded before Flop


PokerStars Hand #226570451257: Tournament #3189414322, $13.79+$1.21 USD Hold'em No Limit - Level I (10/20) - 2021/05/08 16:44:52 MSK [2021/05/08 9:44:52 ET]
Table '3189414322 1' 6-max Seat #6 is the button
Seat 1: 1sT.NexTee (3287 in chips)
Seat 4: dimetruk (950 in chips)
Seat 5: nasir99 (3235 in chips)
Seat 6: mishanya_pim (1528 in chips)
1sT.NexTee: posts the ante 3
dimetruk: posts the ante 3
nasir99: posts the ante 3
mishanya_pim: posts the ante 3
1sT.NexTee: posts small blind 10
dimetruk: posts big blind 20
*** HOLE CARDS ***
Dealt to dimetruk [Qd 5h]
nasir99: folds
mishanya_pim: raises 40 to 60
1sT.NexTee: folds
dimetruk: calls 40
*** FLOP *** [Qs 7h 8s]
dimetruk: checks
mishanya_pim: bets 44
dimetruk: calls 44
*** TURN *** [Qs 7h 8s] [Ah]
dimetruk: checks
mishanya_pim: bets 115
dimetruk: calls 115
*** RIVER *** [Qs 7h 8s Ah] [Kh]
dimetruk: checks
mishanya_pim: bets 143
dimetruk: folds
Uncalled bet (143) returned to mishanya_pim
mishanya_pim collected 460 from pot
mishanya_pim: doesn't show hand
*** SUMMARY ***
Total pot 460 | Rake 0
Board [Qs 7h 8s Ah Kh]
Seat 1: 1sT.NexTee (small blind) folded before Flop
Seat 4: dimetruk (big blind) folded on the River
Seat 5: nasir99 folded before Flop (didn't bet)
Seat 6: mishanya_pim (button) collected (460)


PokerStars Hand #226570503690: Tournament #3189414322, $13.79+$1.21 USD Hold'em No Limit - Level II (15/30) - 2021/05/08 16:47:07 MSK [2021/05/08 9:47:07 ET]
Table '3189414322 1' 6-max Seat #1 is the button
Seat 1: 1sT.NexTee (3214 in chips)
Seat 4: dimetruk (674 in chips)
Seat 5: nasir99 (3340 in chips)
Seat 6: mishanya_pim (1772 in chips)
1sT.NexTee: posts the ante 4
dimetruk: posts the ante 4
nasir99: posts the ante 4
mishanya_pim: posts the ante 4
dimetruk: posts small blind 15
nasir99: posts big blind 30
*** HOLE CARDS ***
Dealt to dimetruk [Th 7c]
mishanya_pim: folds
1sT.NexTee: folds
dimetruk: calls 15
nasir99: checks
*** FLOP *** [4h 6d 5d]
dimetruk: bets 30
nasir99: calls 30
*** TURN *** [4h 6d 5d] [6s]
dimetruk: bets 68
nasir99: folds
Uncalled bet (68) returned to dimetruk
dimetruk collected 136 from pot
dimetruk: doesn't show hand
*** SUMMARY ***
Total pot 136 | Rake 0
Board [4h 6d 5d 6s]
Seat 1: 1sT.NexTee (button) folded before Flop (didn't bet)
Seat 4: dimetruk (small blind) collected (136)
Seat 5: nasir99 (big blind) folded on the Turn
Seat 6: mishanya_pim folded before Flop (didn't bet)


PokerStars Hand #226570513006: Tournament #3189414322, $13.79+$1.21 USD Hold'em No Limit - Level II (15/30) - 2021/05/08 16:47:33 MSK [2021/05/08 9:47:33 ET]
Table '3189414322 1' 6-max Seat #4 is the button
Seat 1: 1sT.NexTee (3210 in chips)
Seat 4: dimetruk (746 in chips)
Seat 5: nasir99 (3276 in chips)
Seat 6: mishanya_pim (1768 in chips)
1sT.NexTee: posts the ante 4
dimetruk: posts the ante 4
nasir99: posts the ante 4
mishanya_pim: posts the ante 4
nasir99: posts small blind 15
mishanya_pim: posts big blind 30
*** HOLE CARDS ***
Dealt to dimetruk [4c Ac]
1sT.NexTee: folds
dimetruk: raises 30 to 60
nasir99: folds
mishanya_pim: calls 30
*** FLOP *** [Qc Js Kc]
mishanya_pim: checks
dimetruk: bets 76
mishanya_pim: folds
Uncalled bet (76) returned to dimetruk
dimetruk collected 151 from pot
dimetruk: doesn't show hand
*** SUMMARY ***
Total pot 151 | Rake 0
Board [Qc Js Kc]
Seat 1: 1sT.NexTee folded before Flop (didn't bet)
Seat 4: dimetruk (button) collected (151)
Seat 5: nasir99 (small blind) folded before Flop
Seat 6: mishanya_pim (big blind) folded on the Flop


PokerStars Hand #226570633511: Tournament #3189414322, $13.79+$1.21 USD Hold'em No Limit - Level II (15/30) - 2021/05/08 16:52:51 MSK [2021/05/08 9:52:51 ET]
Table '3189414322 1' 6-max Seat #1 is the button
Seat 1: 1sT.NexTee (3077 in chips)
Seat 4: dimetruk (734 in chips)
Seat 5: nasir99 (3899 in chips)
Seat 6: mishanya_pim (1290 in chips)
1sT.NexTee: posts the ante 4
dimetruk: posts the ante 4
nasir99: posts the ante 4
mishanya_pim: posts the ante 4
dimetruk: posts small blind 15
nasir99: posts big blind 30
*** HOLE CARDS ***
Dealt to dimetruk [6c Jc]
mishanya_pim: folds
1sT.NexTee: folds
dimetruk: raises 30 to 60
nasir99: calls 30
*** FLOP *** [Js 9h Ah]
dimetruk: bets 48
nasir99: folds
Uncalled bet (48) returned to dimetruk
dimetruk collected 136 from pot
dimetruk: doesn't show hand
*** SUMMARY ***
Total pot 136 | Rake 0
Board [Js 9h Ah]
Seat 1: 1sT.NexTee (button) folded before Flop (didn't bet)
Seat 4: dimetruk (small blind) collected (136)
Seat 5: nasir99 (big blind) folded on the Flop
Seat 6: mishanya_pim folded before Flop (didn't bet)


PokerStars Hand #226570647179: Tournament #3189414322, $13.79+$1.21 USD Hold'em No Limit - Level II (15/30) - 2021/05/08 16:53:29 MSK [2021/05/08 9:53:29 ET]
Table '3189414322 1' 6-max Seat #5 is the button
Seat 1: 1sT.NexTee (3069 in chips)
Seat 4: dimetruk (863 in chips)
Seat 5: nasir99 (3816 in chips)
Seat 6: mishanya_pim (1252 in chips)
1sT.NexTee: posts the ante 4
dimetruk: posts the ante 4
nasir99: posts the ante 4
mishanya_pim: posts the ante 4
mishanya_pim: posts small blind 15
1sT.NexTee: posts big blind 30
*** HOLE CARDS ***
Dealt to dimetruk [Ac Ah]
dimetruk: raises 30 to 60
nasir99: folds
mishanya_pim: folds
1sT.NexTee: raises 135 to 195
dimetruk: calls 135
*** FLOP *** [8c Ks 5c]
1sT.NexTee: bets 139
dimetruk: raises 525 to 664 and is all-in
1sT.NexTee: calls 525
*** TURN *** [8c Ks 5c] [3h]
*** RIVER *** [8c Ks 5c 3h] [2h]
*** SHOW DOWN ***
1sT.NexTee: shows [Kd Kh] (three of a kind, Kings)
dimetruk: shows [Ac Ah] (a pair of Aces)
1sT.NexTee collected 1749 from pot
dimetruk finished the tournament in 4th place
*** SUMMARY ***
Total pot 1749 | Rake 0
Board [8c Ks 5c 3h 2h]
Seat 1: 1sT.NexTee (big blind) showed [Kd Kh] and won (1749) with three of a kind, Kings
Seat 4: dimetruk showed [Ac Ah] and lost with a pair of Aces
Seat 5: nasir99 (button) folded before Flop (didn't bet)
Seat 6: mishanya_pim (small blind) folded before Flop


PokerStars Hand #226570403843: Tournament #3189420361, $13.70+$1.30 USD Hold'em No Limit - Level I (10/20) - 2021/05/08 16:42:44 MSK [2021/05/08 9:42:44 ET]
Table '3189420361 1' 9-max Seat #2 is the button
Seat 1: gonzax (1497 in chips)
Seat 2: R35555 (1487 in chips)
Seat 3: TheHulk7 (1674 in chips)
Seat 4: f506279 (1497 in chips)
Seat 5: jimbobem (1497 in chips)
Seat 6: smootheman03 (1357 in chips)
Seat 7: dimetruk (1497 in chips)
Seat 8: T1mm90 (1497 in chips)
Seat 9: BIGMICKG (1497 in chips)
gonzax: posts the ante 3
R35555: posts the ante 3
TheHulk7: posts the ante 3
f506279: posts the ante 3
jimbobem: posts the ante 3
smootheman03: posts the ante 3
dimetruk: posts the ante 3
T1mm90: posts the ante 3
BIGMICKG: posts the ante 3
TheHulk7: posts small blind 10
f506279: posts big blind 20
*** HOLE CARDS ***
Dealt to dimetruk [Ah Kc]
jimbobem: folds
smootheman03: folds
dimetruk: raises 20 to 40
T1mm90: folds
BIGMICKG: folds
gonzax: raises 100 to 140
R35555: folds
TheHulk7: folds
f506279: folds
dimetruk: calls 100
*** FLOP *** [Ts 2h 7c]
dimetruk: checks
gonzax: bets 169
dimetruk: calls 169
*** TURN *** [Ts 2h 7c] [Ad]
dimetruk: checks
gonzax: checks
*** RIVER *** [Ts 2h 7c Ad] [3d]
dimetruk: checks
gonzax: bets 600
dimetruk: calls 600
*** SHOW DOWN ***
gonzax: shows [Ac 5h] (a pair of Aces)
dimetruk: shows [Ah Kc] (a pair of Aces - King kicker)
dimetruk collected 1875 from pot
*** SUMMARY ***
Total pot 1875 | Rake 0
Board [Ts 2h 7c Ad 3d]
Seat 1: gonzax showed [Ac 5h] and lost with a pair of Aces
Seat 2: R35555 (button) folded before Flop (didn't bet)
Seat 3: TheHulk7 (small blind) folded before Flop
Seat 4: f506279 (big blind) folded before Flop
Seat 5: jimbobem folded before Flop (didn't bet)
Seat 6: smootheman03 folded before Flop (didn't bet)
Seat 7: dimetruk showed [Ah Kc] and won (1875) with a pair of Aces
Seat 8: T1mm90 folded before Flop (didn't bet)
Seat 9: BIGMICKG folded before Flop (didn't bet)


PokerStars Hand #226570562724: Tournament #3189420361, $13.70+$1.30 USD Hold'em No Limit - Level I (10/20) - 2021/05/08 16:49:52 MSK [2021/05/08 9:49:52 ET]
Table '3189420361 1' 9-max Seat #2 is the button
Seat 2: R35555 (2873 in chips)
Seat 3: TheHulk7 (1674 in chips)
Seat 4: f506279 (1443 in chips)
Seat 5: jimbobem (1233 in chips)
Seat 6: smootheman03 (1601 in chips)
Seat 7: dimetruk (2369 in chips)
Seat 8: T1mm90 (1014 in chips)
Seat 9: BIGMICKG (1293 in chips)
R35555: posts the ante 3
TheHulk7: posts the ante 3
f506279: posts the ante 3
jimbobem: posts the ante 3
smootheman03: posts the ante 3
dimetruk: posts the ante 3
T1mm90: posts the ante 3
BIGMICKG: posts the ante 3
TheHulk7: posts small blind 10
f506279: posts big blind 20
*** HOLE CARDS ***
Dealt to dimetruk [Jh 8h]
jimbobem: folds
smootheman03: folds
dimetruk: raises 20 to 40
T1mm90: folds
BIGMICKG: folds
R35555: calls 40
TheHulk7: folds
f506279: folds
*** FLOP *** [Jd Kc Qh]
dimetruk: bets 47
R35555: folds
Uncalled bet (47) returned to dimetruk
dimetruk collected 134 from pot
dimetruk: doesn't show hand
*** SUMMARY ***
Total pot 134 | Rake 0
Board [Jd Kc Qh]
Seat 2: R35555 (button) folded on the Flop
Seat 3: TheHulk7 (small blind) folded before Flop
Seat 4: f506279 (big blind) folded before Flop
Seat 5: jimbobem folded before Flop (didn't bet)
Seat 6: smootheman03 folded before Flop (didn't bet)
Seat 7: dimetruk collected (134)
Seat 8: T1mm90 folded before Flop (didn't bet)
Seat 9: BIGMICKG folded before Flop (didn't bet)


PokerStars Hand #226570598368: Tournament #3189420361, $13.70+$1.30 USD Hold'em No Limit - Level I (10/20) - 2021/05/08 16:51:31 MSK [2021/05/08 9:51:31 ET]
Table '3189420361 1' 9-max Seat #5 is the button
Seat 2: R35555 (2824 in chips)
Seat 3: TheHulk7 (1655 in chips)
Seat 4: f506279 (1458 in chips)
Seat 5: jimbobem (1154 in chips)
Seat 6: smootheman03 (1512 in chips)
Seat 7: dimetruk (2454 in chips)
Seat 8: T1mm90 (1159 in chips)
Seat 9: BIGMICKG (1284 in chips)
R35555: posts the ante 3
TheHulk7: posts the ante 3
f506279: posts the ante 3
jimbobem: posts the ante 3
smootheman03: posts the ante 3
dimetruk: posts the ante 3
T1mm90: posts the ante 3
BIGMICKG: posts the ante 3
smootheman03: posts small blind 10
dimetruk: posts big blind 20
*** HOLE CARDS ***
Dealt to dimetruk [2c 6c]
T1mm90: raises 20 to 40
BIGMICKG: folds
R35555: folds
TheHulk7: folds
f506279: folds
jimbobem: folds
smootheman03: calls 30
dimetruk: calls 20
*** FLOP *** [Ac 3h 9c]
smootheman03: checks
dimetruk: checks
T1mm90: checks
*** TURN *** [Ac 3h 9c] [8s]
smootheman03: checks
dimetruk: bets 50
T1mm90: calls 50
smootheman03: raises 190 to 240
dimetruk: folds
T1mm90: folds
Uncalled bet (190) returned to smootheman03
smootheman03 collected 294 from pot
smootheman03: doesn't show hand
*** SUMMARY ***
Total pot 294 | Rake 0
Board [Ac 3h 9c 8s]
Seat 2: R35555 folded before Flop (didn't bet)
Seat 3: TheHulk7 folded before Flop (didn't bet)
Seat 4: f506279 folded before Flop (didn't bet)
Seat 5: jimbobem (button) folded before Flop (didn't bet)
Seat 6: smootheman03 (small blind) collected (294)
Seat 7: dimetruk (big blind) folded on the Turn
Seat 8: T1mm90 folded on the Turn
Seat 9: BIGMICKG folded before Flop (didn't bet)


PokerStars Hand #226570696126: Tournament #3189420361, $13.70+$1.30 USD Hold'em No Limit - Level II (15/30) - 2021/05/08 16:55:54 MSK [2021/05/08 9:55:54 ET]
Table '3189420361 1' 9-max Seat #4 is the button
Seat 2: R35555 (2816 in chips)
Seat 3: TheHulk7 (1660 in chips)
Seat 4: f506279 (1373 in chips)
Seat 5: jimbobem (1097 in chips)
Seat 6: smootheman03 (1946 in chips)
Seat 7: dimetruk (2322 in chips)
Seat 8: T1mm90 (371 in chips)
Seat 9: BIGMICKG (1915 in chips)
R35555: posts the ante 4
TheHulk7: posts the ante 4
f506279: posts the ante 4
jimbobem: posts the ante 4
smootheman03: posts the ante 4
dimetruk: posts the ante 4
T1mm90: posts the ante 4
BIGMICKG: posts the ante 4
jimbobem: posts small blind 15
smootheman03: posts big blind 30
*** HOLE CARDS ***
Dealt to dimetruk [3c Ac]
dimetruk: raises 30 to 60
T1mm90: folds
BIGMICKG: folds
R35555: calls 60
TheHulk7: folds
f506279: folds
jimbobem: calls 45
smootheman03: folds
*** FLOP *** [Ah 5d Qd]
jimbobem: checks
dimetruk: checks
R35555: checks
*** TURN *** [Ah 5d Qd] [Kc]
jimbobem: checks
dimetruk: bets 85
R35555: folds
jimbobem: folds
Uncalled bet (85) returned to dimetruk
dimetruk collected 242 from pot
dimetruk: doesn't show hand
*** SUMMARY ***
Total pot 242 | Rake 0
Board [Ah 5d Qd Kc]
Seat 2: R35555 folded on the Turn
Seat 3: TheHulk7 folded before Flop (didn't bet)
Seat 4: f506279 (button) folded before Flop (didn't bet)
Seat 5: jimbobem (small blind) folded on the Turn
Seat 6: smootheman03 (big blind) folded before Flop
Seat 7: dimetruk collected (242)
Seat 8: T1mm90 folded before Flop (didn't bet)
Seat 9: BIGMICKG folded before Flop (didn't bet)


PokerStars Hand #226570708594: Tournament #3189420361, $13.70+$1.30 USD Hold'em No Limit - Level II (15/30) - 2021/05/08 16:56:37 MSK [2021/05/08 9:56:37 ET]
Table '3189420361 1' 9-max Seat #5 is the button
Seat 2: R35555 (2752 in chips)
Seat 3: TheHulk7 (1656 in chips)
Seat 4: f506279 (1369 in chips)
Seat 5: jimbobem (1033 in chips)
Seat 6: smootheman03 (1912 in chips)
Seat 7: dimetruk (2500 in chips)
Seat 8: T1mm90 (367 in chips)
Seat 9: BIGMICKG (1911 in chips)
R35555: posts the ante 4
TheHulk7: posts the ante 4
f506279: posts the ante 4
jimbobem: posts the ante 4
smootheman03: posts the ante 4
dimetruk: posts the ante 4
T1mm90: posts the ante 4
BIGMICKG: posts the ante 4
smootheman03: posts small blind 15
dimetruk: posts big blind 30
*** HOLE CARDS ***
Dealt to dimetruk [4c Ac]
T1mm90: folds
BIGMICKG: folds
R35555: folds
TheHulk7: raises 36 to 66
f506279: folds
jimbobem: folds
smootheman03: calls 51
dimetruk: calls 36
*** FLOP *** [7d 6h Td]
smootheman03: checks
dimetruk: checks
TheHulk7: checks
*** TURN *** [7d 6h Td] [As]
smootheman03: checks
dimetruk: bets 81
TheHulk7: raises 137 to 218
smootheman03: folds
dimetruk: calls 137
*** RIVER *** [7d 6h Td As] [7c]
dimetruk: checks
TheHulk7: checks
*** SHOW DOWN ***
dimetruk: shows [4c Ac] (two pair, Aces and Sevens)
TheHulk7: mucks hand
dimetruk collected 666 from pot
*** SUMMARY ***
Total pot 666 | Rake 0
Board [7d 6h Td As 7c]
Seat 2: R35555 folded before Flop (didn't bet)
Seat 3: TheHulk7 mucked [Kd Qs]
Seat 4: f506279 folded before Flop (didn't bet)
Seat 5: jimbobem (button) folded before Flop (didn't bet)
Seat 6: smootheman03 (small blind) folded on the Turn
Seat 7: dimetruk (big blind) showed [4c Ac] and won (666) with two pair, Aces and Sevens
Seat 8: T1mm90 folded before Flop (didn't bet)
Seat 9: BIGMICKG folded before Flop (didn't bet)


PokerStars Hand #226570779787: Tournament #3189420361, $13.70+$1.30 USD Hold'em No Limit - Level II (15/30) - 2021/05/08 17:00:18 MSK [2021/05/08 10:00:18 ET]
Table '3189420361 1' 9-max Seat #3 is the button
Seat 2: R35555 (3122 in chips)
Seat 3: TheHulk7 (1303 in chips)
Seat 4: f506279 (956 in chips)
Seat 5: jimbobem (889 in chips)
Seat 6: smootheman03 (1809 in chips)
Seat 7: dimetruk (2843 in chips)
Seat 8: T1mm90 (811 in chips)
Seat 9: BIGMICKG (1767 in chips)
R35555: posts the ante 4
TheHulk7: posts the ante 4
f506279: posts the ante 4
jimbobem: posts the ante 4
smootheman03: posts the ante 4
dimetruk: posts the ante 4
T1mm90: posts the ante 4
BIGMICKG: posts the ante 4
f506279: posts small blind 15
jimbobem: posts big blind 30
*** HOLE CARDS ***
Dealt to dimetruk [Jc Ah]
smootheman03: calls 30
dimetruk: raises 60 to 90
T1mm90: folds
BIGMICKG: folds
R35555: calls 90
TheHulk7: folds
f506279: folds
jimbobem: calls 60
smootheman03: calls 60
*** FLOP *** [9c Ks Js]
jimbobem: bets 180
smootheman03: folds
dimetruk: calls 180
R35555: raises 240 to 420
jimbobem: raises 240 to 660
dimetruk: folds
R35555: raises 2368 to 3028 and is all-in
jimbobem: calls 135 and is all-in
Uncalled bet (2233) returned to R35555
*** TURN *** [9c Ks Js] [3d]
*** RIVER *** [9c Ks Js 3d] [8d]
*** SHOW DOWN ***
jimbobem: shows [Kh 9h] (two pair, Kings and Nines)
R35555: shows [9d 9s] (three of a kind, Nines)
R35555 collected 2177 from pot
jimbobem finished the tournament in 8th place
*** SUMMARY ***
Total pot 2177 | Rake 0
Board [9c Ks Js 3d 8d]
Seat 2: R35555 showed [9d 9s] and won (2177) with three of a kind, Nines
Seat 3: TheHulk7 (button) folded before Flop (didn't bet)
Seat 4: f506279 (small blind) folded before Flop
Seat 5: jimbobem (big blind) showed [Kh 9h] and lost with two pair, Kings and Nines
Seat 6: smootheman03 folded on the Flop
Seat 7: dimetruk folded on the Flop
Seat 8: T1mm90 folded before Flop (didn't bet)
Seat 9: BIGMICKG folded before Flop (didn't bet)


PokerStars Hand #226570803432: Tournament #3189420361, $13.70+$1.30 USD Hold'em No Limit - Level II (15/30) - 2021/05/08 17:01:30 MSK [2021/05/08 10:01:30 ET]
Table '3189420361 1' 9-max Seat #4 is the button
Seat 2: R35555 (4410 in chips)
Seat 3: TheHulk7 (1299 in chips)
Seat 4: f506279 (937 in chips)
Seat 6: smootheman03 (1715 in chips)
Seat 7: dimetruk (2569 in chips)
Seat 8: T1mm90 (807 in chips)
Seat 9: BIGMICKG (1763 in chips)
R35555: posts the ante 4
TheHulk7: posts the ante 4
f506279: posts the ante 4
smootheman03: posts the ante 4
dimetruk: posts the ante 4
T1mm90: posts the ante 4
BIGMICKG: posts the ante 4
smootheman03: posts small blind 15
dimetruk: posts big blind 30
*** HOLE CARDS ***
Dealt to dimetruk [Qs Tc]
T1mm90: folds
BIGMICKG: folds
R35555: raises 30 to 60
TheHulk7: folds
f506279: folds
smootheman03: calls 45
dimetruk: calls 30
*** FLOP *** [5s 3c Jd]
smootheman03: checks
dimetruk: checks
R35555: bets 120
smootheman03: folds
dimetruk: folds
Uncalled bet (120) returned to R35555
R35555 collected 208 from pot
R35555: doesn't show hand
*** SUMMARY ***
Total pot 208 | Rake 0
Board [5s 3c Jd]
Seat 2: R35555 collected (208)
Seat 3: TheHulk7 folded before Flop (didn't bet)
Seat 4: f506279 (button) folded before Flop (didn't bet)
Seat 6: smootheman03 (small blind) folded on the Flop
Seat 7: dimetruk (big blind) folded on the Flop
Seat 8: T1mm90 folded before Flop (didn't bet)
Seat 9: BIGMICKG folded before Flop (didn't bet)


PokerStars Hand #226570923296: Tournament #3189420361, $13.70+$1.30 USD Hold'em No Limit - Level III (25/50) - 2021/05/08 17:07:00 MSK [2021/05/08 10:07:00 ET]
Table '3189420361 1' 9-max Seat #6 is the button
Seat 2: R35555 (5437 in chips)
Seat 3: TheHulk7 (1866 in chips)
Seat 6: smootheman03 (1976 in chips)
Seat 7: dimetruk (2319 in chips)
Seat 9: BIGMICKG (1902 in chips)
R35555: posts the ante 6
TheHulk7: posts the ante 6
smootheman03: posts the ante 6
dimetruk: posts the ante 6
BIGMICKG: posts the ante 6
dimetruk: posts small blind 25
BIGMICKG: posts big blind 50
*** HOLE CARDS ***
Dealt to dimetruk [Jd 5d]
R35555: folds
TheHulk7: folds
smootheman03: folds
dimetruk: raises 50 to 100
BIGMICKG: calls 50
*** FLOP *** [4d 3d Jh]
dimetruk: checks
BIGMICKG: bets 115
dimetruk: raises 2098 to 2213 and is all-in
BIGMICKG: calls 1681 and is all-in
Uncalled bet (417) returned to dimetruk
*** TURN *** [4d 3d Jh] [Qs]
*** RIVER *** [4d 3d Jh Qs] [2s]
*** SHOW DOWN ***
dimetruk: shows [Jd 5d] (a pair of Jacks)
BIGMICKG: shows [Ad 2d] (a pair of Deuces)
dimetruk collected 3822 from pot
BIGMICKG finished the tournament in 5th place
*** SUMMARY ***
Total pot 3822 | Rake 0
Board [4d 3d Jh Qs 2s]
Seat 2: R35555 folded before Flop (didn't bet)
Seat 3: TheHulk7 folded before Flop (didn't bet)
Seat 6: smootheman03 (button) folded before Flop (didn't bet)
Seat 7: dimetruk (small blind) showed [Jd 5d] and won (3822) with a pair of Jacks
Seat 9: BIGMICKG (big blind) showed [Ad 2d] and lost with a pair of Deuces


PokerStars Hand #226570940984: Tournament #3189420361, $13.70+$1.30 USD Hold'em No Limit - Level III (25/50) - 2021/05/08 17:07:48 MSK [2021/05/08 10:07:48 ET]
Table '3189420361 1' 9-max Seat #7 is the button
Seat 2: R35555 (5431 in chips)
Seat 3: TheHulk7 (1860 in chips)
Seat 6: smootheman03 (1970 in chips)
Seat 7: dimetruk (4239 in chips)
R35555: posts the ante 6
TheHulk7: posts the ante 6
smootheman03: posts the ante 6
dimetruk: posts the ante 6
R35555: posts small blind 25
TheHulk7: posts big blind 50
*** HOLE CARDS ***
Dealt to dimetruk [7d Qh]
smootheman03: folds
dimetruk: raises 50 to 100
R35555: calls 75
TheHulk7: calls 50
*** FLOP *** [3s 6s Ah]
R35555: checks
TheHulk7: checks
dimetruk: checks
*** TURN *** [3s 6s Ah] [Js]
R35555: bets 162
TheHulk7: calls 162
dimetruk: folds
*** RIVER *** [3s 6s Ah Js] [Kd]
R35555: bets 324
TheHulk7: folds
Uncalled bet (324) returned to R35555
R35555 collected 648 from pot
R35555: doesn't show hand
*** SUMMARY ***
Total pot 648 | Rake 0
Board [3s 6s Ah Js Kd]
Seat 2: R35555 (small blind) collected (648)
Seat 3: TheHulk7 (big blind) folded on the River
Seat 6: smootheman03 folded before Flop (didn't bet)
Seat 7: dimetruk (button) folded on the Turn


PokerStars Hand #226570969536: Tournament #3189420361, $13.70+$1.30 USD Hold'em No Limit - Level III (25/50) - 2021/05/08 17:09:06 MSK [2021/05/08 10:09:06 ET]
Table '3189420361 1' 9-max Seat #3 is the button
Seat 2: R35555 (5805 in chips)
Seat 3: TheHulk7 (1561 in chips)
Seat 6: smootheman03 (2007 in chips)
Seat 7: dimetruk (4127 in chips)
R35555: posts the ante 6
TheHulk7: posts the ante 6
smootheman03: posts the ante 6
dimetruk: posts the ante 6
smootheman03: posts small blind 25
dimetruk: posts big blind 50
*** HOLE CARDS ***
Dealt to dimetruk [6d 9c]
R35555: folds
TheHulk7: folds
smootheman03: calls 25
dimetruk: checks
*** FLOP *** [6c Ah Qs]
smootheman03: bets 62
dimetruk: calls 62
*** TURN *** [6c Ah Qs] [8s]
smootheman03: bets 150
dimetruk: folds
Uncalled bet (150) returned to smootheman03
smootheman03 collected 248 from pot
smootheman03: doesn't show hand
*** SUMMARY ***
Total pot 248 | Rake 0
Board [6c Ah Qs 8s]
Seat 2: R35555 folded before Flop (didn't bet)
Seat 3: TheHulk7 (button) folded before Flop (didn't bet)
Seat 6: smootheman03 (small blind) collected (248)
Seat 7: dimetruk (big blind) folded on the Turn


PokerStars Hand #226571036040: Tournament #3189420361, $13.70+$1.30 USD Hold'em No Limit - Level IV (40/80) - 2021/05/08 17:12:05 MSK [2021/05/08 10:12:05 ET]
Table '3189420361 1' 9-max Seat #7 is the button
Seat 2: R35555 (6176 in chips)
Seat 3: TheHulk7 (1713 in chips)
Seat 6: smootheman03 (1732 in chips)
Seat 7: dimetruk (3879 in chips)
R35555: posts the ante 10
TheHulk7: posts the ante 10
smootheman03: posts the ante 10
dimetruk: posts the ante 10
R35555: posts small blind 40
TheHulk7: posts big blind 80
*** HOLE CARDS ***
Dealt to dimetruk [6h As]
smootheman03: folds
dimetruk: raises 80 to 160
R35555: folds
TheHulk7: calls 80
*** FLOP *** [Jc Kd 2h]
TheHulk7: checks
dimetruk: checks
*** TURN *** [Jc Kd 2h] [9d]
TheHulk7: checks
dimetruk: bets 200
TheHulk7: folds
Uncalled bet (200) returned to dimetruk
dimetruk collected 400 from pot
dimetruk: doesn't show hand
*** SUMMARY ***
Total pot 400 | Rake 0
Board [Jc Kd 2h 9d]
Seat 2: R35555 (small blind) folded before Flop
Seat 3: TheHulk7 (big blind) folded on the Turn
Seat 6: smootheman03 folded before Flop (didn't bet)
Seat 7: dimetruk (button) collected (400)


PokerStars Hand #226571062045: Tournament #3189420361, $13.70+$1.30 USD Hold'em No Limit - Level IV (40/80) - 2021/05/08 17:13:15 MSK [2021/05/08 10:13:15 ET]
Table '3189420361 1' 9-max Seat #3 is the button
Seat 2: R35555 (6276 in chips)
Seat 3: TheHulk7 (1493 in chips)
Seat 6: smootheman03 (1632 in chips)
Seat 7: dimetruk (4099 in chips)
R35555: posts the ante 10
TheHulk7: posts the ante 10
smootheman03: posts the ante 10
dimetruk: posts the ante 10
smootheman03: posts small blind 40
dimetruk: posts big blind 80
*** HOLE CARDS ***
Dealt to dimetruk [7d 9c]
R35555: folds
TheHulk7: folds
smootheman03: calls 40
dimetruk: raises 80 to 160
smootheman03: calls 80
*** FLOP *** [Kc 3s Jc]
smootheman03: checks
dimetruk: bets 180
smootheman03: folds
Uncalled bet (180) returned to dimetruk
dimetruk collected 360 from pot
dimetruk: doesn't show hand
*** SUMMARY ***
Total pot 360 | Rake 0
Board [Kc 3s Jc]
Seat 2: R35555 folded before Flop (didn't bet)
Seat 3: TheHulk7 (button) folded before Flop (didn't bet)
Seat 6: smootheman03 (small blind) folded on the Flop
Seat 7: dimetruk (big blind) collected (360)


PokerStars Hand #226571107087: Tournament #3189420361, $13.70+$1.30 USD Hold'em No Limit - Level IV (40/80) - 2021/05/08 17:15:15 MSK [2021/05/08 10:15:15 ET]
Table '3189420361 1' 9-max Seat #3 is the button
Seat 2: R35555 (6116 in chips)
Seat 3: TheHulk7 (2935 in chips)
Seat 7: dimetruk (4449 in chips)
R35555: posts the ante 10
TheHulk7: posts the ante 10
dimetruk: posts the ante 10
dimetruk: posts small blind 40
R35555: posts big blind 80
*** HOLE CARDS ***
Dealt to dimetruk [4d Qs]
TheHulk7: folds
dimetruk: calls 40
R35555: checks
*** FLOP *** [6h Ah Jh]
dimetruk: bets 80
R35555: calls 80
*** TURN *** [6h Ah Jh] [Js]
dimetruk: bets 305
R35555: calls 305
*** RIVER *** [6h Ah Jh Js] [9d]
dimetruk: checks
R35555: bets 480
dimetruk: folds
Uncalled bet (480) returned to R35555
R35555 collected 960 from pot
R35555: doesn't show hand
*** SUMMARY ***
Total pot 960 | Rake 0
Board [6h Ah Jh Js 9d]
Seat 2: R35555 (big blind) collected (960)
Seat 3: TheHulk7 (button) folded before Flop (didn't bet)
Seat 7: dimetruk (small blind) folded on the River


PokerStars Hand #226571123016: Tournament #3189420361, $13.70+$1.30 USD Hold'em No Limit - Level IV (40/80) - 2021/05/08 17:15:57 MSK [2021/05/08 10:15:57 ET]
Table '3189420361 1' 9-max Seat #2 is the button
Seat 2: R35555 (6701 in chips)
Seat 3: TheHulk7 (2835 in chips)
Seat 7: dimetruk (3964 in chips)
R35555: posts the ante 10
TheHulk7: posts the ante 10
dimetruk: posts the ante 10
TheHulk7: posts small blind 40
dimetruk: posts big blind 80
*** HOLE CARDS ***
Dealt to dimetruk [7c 2c]
R35555: folds
TheHulk7: raises 80 to 160
dimetruk: calls 80
*** FLOP *** [7h 8d 9d]
TheHulk7: checks
dimetruk: checks
*** TURN *** [7h 8d 9d] [2h]
TheHulk7: checks
dimetruk: bets 175
TheHulk7: calls 175
*** RIVER *** [7h 8d 9d 2h] [Td]
TheHulk7: checks
dimetruk: checks
*** SHOW DOWN ***
TheHulk7: shows [Kc 8h] (a pair of Eights)
dimetruk: shows [7c 2c] (two pair, Sevens and Deuces)
dimetruk collected 700 from pot
*** SUMMARY ***
Total pot 700 | Rake 0
Board [7h 8d 9d 2h Td]
Seat 2: R35555 (button) folded before Flop (didn't bet)
Seat 3: TheHulk7 (small blind) showed [Kc 8h] and lost with a pair of Eights
Seat 7: dimetruk (big blind) showed [7c 2c] and won (700) with two pair, Sevens and Deuces


PokerStars Hand #226571152983: Tournament #3189420361, $13.70+$1.30 USD Hold'em No Limit - Level IV (40/80) - 2021/05/08 17:17:17 MSK [2021/05/08 10:17:17 ET]
Table '3189420361 1' 9-max Seat #2 is the button
Seat 2: R35555 (4623 in chips)
Seat 3: TheHulk7 (4618 in chips)
Seat 7: dimetruk (4259 in chips)
R35555: posts the ante 10
TheHulk7: posts the ante 10
dimetruk: posts the ante 10
TheHulk7: posts small blind 40
dimetruk: posts big blind 80
*** HOLE CARDS ***
Dealt to dimetruk [3c Tc]
R35555: folds
TheHulk7: raises 160 to 240
dimetruk: calls 160
*** FLOP *** [Qc 5h 5d]
TheHulk7: bets 255
dimetruk: folds
Uncalled bet (255) returned to TheHulk7
TheHulk7 collected 510 from pot
TheHulk7: doesn't show hand
*** SUMMARY ***
Total pot 510 | Rake 0
Board [Qc 5h 5d]
Seat 2: R35555 (button) folded before Flop (didn't bet)
Seat 3: TheHulk7 (small blind) collected (510)
Seat 7: dimetruk (big blind) folded on the Flop


PokerStars Hand #226571217927: Tournament #3189420361, $13.70+$1.30 USD Hold'em No Limit - Level IV (40/80) - 2021/05/08 17:19:47 MSK [2021/05/08 10:19:47 ET]
Table '3189420361 1' 9-max Seat #2 is the button
Seat 2: R35555 (3048 in chips)
Seat 3: TheHulk7 (6823 in chips)
Seat 7: dimetruk (3629 in chips)
R35555: posts the ante 10
TheHulk7: posts the ante 10
dimetruk: posts the ante 10
TheHulk7: posts small blind 40
dimetruk: posts big blind 80
*** HOLE CARDS ***
Dealt to dimetruk [4d 6s]
R35555: folds
TheHulk7: calls 40
dimetruk: checks
*** FLOP *** [3d 8s Jd]
TheHulk7: bets 95
dimetruk: folds
Uncalled bet (95) returned to TheHulk7
TheHulk7 collected 190 from pot
*** SUMMARY ***
Total pot 190 | Rake 0
Board [3d 8s Jd]
Seat 2: R35555 (button) folded before Flop (didn't bet)
Seat 3: TheHulk7 (small blind) collected (190)
Seat 7: dimetruk (big blind) folded on the Flop


PokerStars Hand #226571231659: Tournament #3189420361, $13.70+$1.30 USD Hold'em No Limit - Level IV (40/80) - 2021/05/08 17:20:24 MSK [2021/05/08 10:20:24 ET]
Table '3189420361 1' 9-max Seat #3 is the button
Seat 2: R35555 (3038 in chips)
Seat 3: TheHulk7 (6923 in chips)
Seat 7: dimetruk (3539 in chips)
R35555: posts the ante 10
TheHulk7: posts the ante 10
dimetruk: posts the ante 10
dimetruk: posts small blind 40
R35555: posts big blind 80
*** HOLE CARDS ***
Dealt to dimetruk [Kc 9h]
TheHulk7: folds
dimetruk: raises 80 to 160
R35555: calls 80
*** FLOP *** [Ac 5c 4s]
dimetruk: bets 123
R35555: raises 2745 to 2868 and is all-in
dimetruk: folds
Uncalled bet (2745) returned to R35555
R35555 collected 596 from pot
R35555: doesn't show hand
*** SUMMARY ***
Total pot 596 | Rake 0
Board [Ac 5c 4s]
Seat 2: R35555 (big blind) collected (596)
Seat 3: TheHulk7 (button) folded before Flop (didn't bet)
Seat 7: dimetruk (small blind) folded on the Flop


PokerStars Hand #226571320833: Tournament #3189420361, $13.70+$1.30 USD Hold'em No Limit - Level V (60/120) - 2021/05/08 17:24:21 MSK [2021/05/08 10:24:21 ET]
Table '3189420361 1' 9-max Seat #7 is the button
Seat 2: R35555 (6163 in chips)
Seat 3: TheHulk7 (4466 in chips)
Seat 7: dimetruk (2871 in chips)
R35555: posts the ante 15
TheHulk7: posts the ante 15
dimetruk: posts the ante 15
R35555: posts small blind 60
TheHulk7: posts big blind 120
*** HOLE CARDS ***
Dealt to dimetruk [8d Kc]
dimetruk: raises 120 to 240
R35555: folds
TheHulk7: calls 120
*** FLOP *** [5d 9s 7d]
TheHulk7: checks
dimetruk: bets 293
TheHulk7: raises 586 to 879
dimetruk: folds
Uncalled bet (586) returned to TheHulk7
TheHulk7 collected 1171 from pot
TheHulk7: doesn't show hand
*** SUMMARY ***
Total pot 1171 | Rake 0
Board [5d 9s 7d]
Seat 2: R35555 (small blind) folded before Flop
Seat 3: TheHulk7 (big blind) collected (1171)
Seat 7: dimetruk (button) folded on the Flop


PokerStars Hand #226571348826: Tournament #3189420361, $13.70+$1.30 USD Hold'em No Limit - Level V (60/120) - 2021/05/08 17:25:35 MSK [2021/05/08 10:25:35 ET]
Table '3189420361 1' 9-max Seat #2 is the button
Seat 2: R35555 (6088 in chips)
Seat 3: TheHulk7 (5314 in chips)
Seat 7: dimetruk (2098 in chips)
R35555: posts the ante 15
TheHulk7: posts the ante 15
dimetruk: posts the ante 15
TheHulk7: posts small blind 60
dimetruk: posts big blind 120
*** HOLE CARDS ***
Dealt to dimetruk [8s Kd]
R35555: raises 120 to 240
TheHulk7: folds
dimetruk: calls 120
*** FLOP *** [Ts 5d Qh]
dimetruk: checks
R35555: bets 240
dimetruk: folds
Uncalled bet (240) returned to R35555
R35555 collected 585 from pot
R35555: doesn't show hand
*** SUMMARY ***
Total pot 585 | Rake 0
Board [Ts 5d Qh]
Seat 2: R35555 (button) collected (585)
Seat 3: TheHulk7 (small blind) folded before Flop
Seat 7: dimetruk (big blind) folded on the Flop


PokerStars Hand #226571371586: Tournament #3189420361, $13.70+$1.30 USD Hold'em No Limit - Level V (60/120) - 2021/05/08 17:26:36 MSK [2021/05/08 10:26:36 ET]
Table '3189420361 1' 9-max Seat #2 is the button
Seat 2: R35555 (6208 in chips)
Seat 3: TheHulk7 (4825 in chips)
Seat 7: dimetruk (2467 in chips)
R35555: posts the ante 15
TheHulk7: posts the ante 15
dimetruk: posts the ante 15
TheHulk7: posts small blind 60
dimetruk: posts big blind 120
*** HOLE CARDS ***
Dealt to dimetruk [7d Td]
R35555: folds
TheHulk7: raises 240 to 360
dimetruk: calls 240
*** FLOP *** [Js 8s 2c]
TheHulk7: bets 383
dimetruk: calls 383
*** TURN *** [Js 8s 2c] [Ad]
TheHulk7: checks
dimetruk: bets 1709 and is all-in
TheHulk7: calls 1709
*** RIVER *** [Js 8s 2c Ad] [Ac]
*** SHOW DOWN ***
TheHulk7: shows [Jh 8c] (two pair, Aces and Jacks)
dimetruk: shows [7d Td] (a pair of Aces)
TheHulk7 collected 4949 from pot
dimetruk finished the tournament in 3rd place and received $24.66.
*** SUMMARY ***
Total pot 4949 | Rake 0
Board [Js 8s 2c Ad Ac]
Seat 2: R35555 (button) folded before Flop (didn't bet)
Seat 3: TheHulk7 (small blind) showed [Jh 8c] and won (4949) with two pair, Aces and Jacks
Seat 7: dimetruk (big blind) showed [7d Td] and lost with a pair of Aces


PokerStars Hand #226594685763: Tournament #3189917591, $27.40+$2.60 USD Hold'em No Limit - Level II (15/30) - 2021/05/09 8:19:21 MSK [2021/05/09 1:19:21 ET]
Table '3189917591 1' 9-max Seat #3 is the button
Seat 1: dimetruk (1460 in chips)
Seat 2: raone veras (1651 in chips)
Seat 3: platosha666 (1527 in chips)
Seat 4: Titties5150 (3084 in chips)
Seat 5: deadyoga (1292 in chips)
Seat 6: julinhobrazu (1552 in chips)
Seat 7: ShaiC`akes (1440 in chips)
Seat 8: el guru 088 (1494 in chips)
dimetruk: posts the ante 4
raone veras: posts the ante 4
platosha666: posts the ante 4
Titties5150: posts the ante 4
deadyoga: posts the ante 4
julinhobrazu: posts the ante 4
ShaiC`akes: posts the ante 4
el guru 088: posts the ante 4
Titties5150: posts small blind 15
deadyoga: posts big blind 30
*** HOLE CARDS ***
Dealt to dimetruk [Ah 5h]
julinhobrazu: folds
ShaiC`akes: folds
el guru 088: folds
dimetruk: raises 30 to 60
raone veras: folds
platosha666: folds
Titties5150: folds
deadyoga: calls 30
*** FLOP *** [Ac Jh 8d]
deadyoga: checks
dimetruk: bets 58
deadyoga: folds
Uncalled bet (58) returned to dimetruk
dimetruk collected 167 from pot
dimetruk: doesn't show hand
*** SUMMARY ***
Total pot 167 | Rake 0
Board [Ac Jh 8d]
Seat 1: dimetruk collected (167)
Seat 2: raone veras folded before Flop (didn't bet)
Seat 3: platosha666 (button) folded before Flop (didn't bet)
Seat 4: Titties5150 (small blind) folded before Flop
Seat 5: deadyoga (big blind) folded on the Flop
Seat 6: julinhobrazu folded before Flop (didn't bet)
Seat 7: ShaiC`akes folded before Flop (didn't bet)
Seat 8: el guru 088 folded before Flop (didn't bet)


PokerStars Hand #226594740774: Tournament #3189917591, $27.40+$2.60 USD Hold'em No Limit - Level II (15/30) - 2021/05/09 8:23:27 MSK [2021/05/09 1:23:27 ET]
Table '3189917591 1' 9-max Seat #7 is the button
Seat 1: dimetruk (1491 in chips)
Seat 2: raone veras (1757 in chips)
Seat 3: platosha666 (1511 in chips)
Seat 4: Titties5150 (3190 in chips)
Seat 5: deadyoga (1548 in chips)
Seat 6: julinhobrazu (1311 in chips)
Seat 7: ShaiC`akes (1364 in chips)
Seat 8: el guru 088 (1328 in chips)
dimetruk: posts the ante 4
raone veras: posts the ante 4
platosha666: posts the ante 4
Titties5150: posts the ante 4
deadyoga: posts the ante 4
julinhobrazu: posts the ante 4
ShaiC`akes: posts the ante 4
el guru 088: posts the ante 4
el guru 088: posts small blind 15
dimetruk: posts big blind 30
*** HOLE CARDS ***
Dealt to dimetruk [Kd Js]
raone veras: folds
platosha666: folds
Titties5150: calls 30
deadyoga: folds
julinhobrazu: folds
ShaiC`akes: folds
el guru 088: folds
dimetruk: checks
*** FLOP *** [Kc 3d Qh]
dimetruk: checks
Titties5150: checks
*** TURN *** [Kc 3d Qh] [9h]
dimetruk: bets 30
Titties5150: folds
Uncalled bet (30) returned to dimetruk
dimetruk collected 107 from pot
dimetruk: doesn't show hand
*** SUMMARY ***
Total pot 107 | Rake 0
Board [Kc 3d Qh 9h]
Seat 1: dimetruk (big blind) collected (107)
Seat 2: raone veras folded before Flop (didn't bet)
Seat 3: platosha666 folded before Flop (didn't bet)
Seat 4: Titties5150 folded on the Turn
Seat 5: deadyoga folded before Flop (didn't bet)
Seat 6: julinhobrazu folded before Flop (didn't bet)
Seat 7: ShaiC`akes (button) folded before Flop (didn't bet)
Seat 8: el guru 088 (small blind) folded before Flop


PokerStars Hand #226594748424: Tournament #3189917591, $27.40+$2.60 USD Hold'em No Limit - Level II (15/30) - 2021/05/09 8:24:08 MSK [2021/05/09 1:24:08 ET]
Table '3189917591 1' 9-max Seat #8 is the button
Seat 1: dimetruk (1564 in chips)
Seat 2: raone veras (1753 in chips)
Seat 3: platosha666 (1507 in chips)
Seat 4: Titties5150 (3156 in chips)
Seat 5: deadyoga (1544 in chips)
Seat 6: julinhobrazu (1307 in chips)
Seat 7: ShaiC`akes (1360 in chips)
Seat 8: el guru 088 (1309 in chips)
dimetruk: posts the ante 4
raone veras: posts the ante 4
platosha666: posts the ante 4
Titties5150: posts the ante 4
deadyoga: posts the ante 4
julinhobrazu: posts the ante 4
ShaiC`akes: posts the ante 4
el guru 088: posts the ante 4
dimetruk: posts small blind 15
raone veras: posts big blind 30
*** HOLE CARDS ***
Dealt to dimetruk [Jd Ad]
platosha666: folds
Titties5150: folds
deadyoga: folds
julinhobrazu: folds
ShaiC`akes: folds
el guru 088: folds
dimetruk: raises 30 to 60
raone veras: calls 30
*** FLOP *** [As Ks Jh]
dimetruk: checks
raone veras: checks
*** TURN *** [As Ks Jh] [2s]
dimetruk: bets 76
raone veras: raises 146 to 222
dimetruk: calls 146
*** RIVER *** [As Ks Jh 2s] [8c]
dimetruk: checks
raone veras: checks
*** SHOW DOWN ***
dimetruk: shows [Jd Ad] (two pair, Aces and Jacks)
raone veras: mucks hand
dimetruk collected 596 from pot
*** SUMMARY ***
Total pot 596 | Rake 0
Board [As Ks Jh 2s 8c]
Seat 1: dimetruk (small blind) showed [Jd Ad] and won (596) with two pair, Aces and Jacks
Seat 2: raone veras (big blind) mucked [8d 9h]
Seat 3: platosha666 folded before Flop (didn't bet)
Seat 4: Titties5150 folded before Flop (didn't bet)
Seat 5: deadyoga folded before Flop (didn't bet)
Seat 6: julinhobrazu folded before Flop (didn't bet)
Seat 7: ShaiC`akes folded before Flop (didn't bet)
Seat 8: el guru 088 (button) folded before Flop (didn't bet)


PokerStars Hand #226594837044: Tournament #3189917591, $27.40+$2.60 USD Hold'em No Limit - Level III (25/50) - 2021/05/09 8:32:04 MSK [2021/05/09 1:32:04 ET]
Table '3189917591 1' 9-max Seat #3 is the button
Seat 1: dimetruk (1755 in chips)
Seat 3: platosha666 (1339 in chips)
Seat 4: Titties5150 (3202 in chips)
Seat 5: deadyoga (1301 in chips)
Seat 6: julinhobrazu (3093 in chips)
Seat 7: ShaiC`akes (1714 in chips)
Seat 8: el guru 088 (1096 in chips)
dimetruk: posts the ante 6
platosha666: posts the ante 6
Titties5150: posts the ante 6
deadyoga: posts the ante 6
julinhobrazu: posts the ante 6
ShaiC`akes: posts the ante 6
el guru 088: posts the ante 6
Titties5150: posts small blind 25
deadyoga: posts big blind 50
*** HOLE CARDS ***
Dealt to dimetruk [9c As]
julinhobrazu: folds
ShaiC`akes: folds
el guru 088: folds
dimetruk: raises 50 to 100
platosha666: folds
Titties5150: calls 75
deadyoga: calls 50
*** FLOP *** [Kd 8c Jc]
Titties5150: checks
deadyoga: checks
dimetruk: checks
*** TURN *** [Kd 8c Jc] [Tc]
Titties5150: checks
deadyoga: checks
dimetruk: bets 171
Titties5150: calls 171
deadyoga: calls 171
*** RIVER *** [Kd 8c Jc Tc] [Qh]
Titties5150: bets 150
deadyoga: calls 150
dimetruk: calls 150
*** SHOW DOWN ***
Titties5150: shows [6s 9s] (a straight, Nine to King)
deadyoga: shows [9d Ad] (a straight, Ten to Ace)
dimetruk: shows [9c As] (a straight, Ten to Ace)
deadyoga collected 653 from pot
dimetruk collected 652 from pot
*** SUMMARY ***
Total pot 1305 | Rake 0
Board [Kd 8c Jc Tc Qh]
Seat 1: dimetruk showed [9c As] and won (652) with a straight, Ten to Ace
Seat 3: platosha666 (button) folded before Flop (didn't bet)
Seat 4: Titties5150 (small blind) showed [6s 9s] and lost with a straight, Nine to King
Seat 5: deadyoga (big blind) showed [9d Ad] and won (653) with a straight, Ten to Ace
Seat 6: julinhobrazu folded before Flop (didn't bet)
Seat 7: ShaiC`akes folded before Flop (didn't bet)
Seat 8: el guru 088 folded before Flop (didn't bet)


PokerStars Hand #226594875350: Tournament #3189917591, $27.40+$2.60 USD Hold'em No Limit - Level III (25/50) - 2021/05/09 8:35:34 MSK [2021/05/09 1:35:34 ET]
Table '3189917591 1' 9-max Seat #7 is the button
Seat 1: dimetruk (1962 in chips)
Seat 3: platosha666 (1315 in chips)
Seat 4: Titties5150 (2507 in chips)
Seat 5: deadyoga (1234 in chips)
Seat 6: julinhobrazu (3863 in chips)
Seat 7: ShaiC`akes (1415 in chips)
Seat 8: el guru 088 (1204 in chips)
dimetruk: posts the ante 6
platosha666: posts the ante 6
Titties5150: posts the ante 6
deadyoga: posts the ante 6
julinhobrazu: posts the ante 6
ShaiC`akes: posts the ante 6
el guru 088: posts the ante 6
el guru 088: posts small blind 25
dimetruk: posts big blind 50
*** HOLE CARDS ***
Dealt to dimetruk [5h 5c]
platosha666: folds
Titties5150: folds
deadyoga: folds
julinhobrazu: folds
ShaiC`akes: folds
el guru 088: calls 25
dimetruk: raises 1906 to 1956 and is all-in
el guru 088: calls 1148 and is all-in
Uncalled bet (758) returned to dimetruk
*** FLOP *** [Ac As 9d]
*** TURN *** [Ac As 9d] [8s]
*** RIVER *** [Ac As 9d 8s] [4h]
*** SHOW DOWN ***
el guru 088: shows [Jh Ad] (three of a kind, Aces)
dimetruk: shows [5h 5c] (two pair, Aces and Fives)
el guru 088 collected 2438 from pot
*** SUMMARY ***
Total pot 2438 | Rake 0
Board [Ac As 9d 8s 4h]
Seat 1: dimetruk (big blind) showed [5h 5c] and lost with two pair, Aces and Fives
Seat 3: platosha666 folded before Flop (didn't bet)
Seat 4: Titties5150 folded before Flop (didn't bet)
Seat 5: deadyoga folded before Flop (didn't bet)
Seat 6: julinhobrazu folded before Flop (didn't bet)
Seat 7: ShaiC`akes (button) folded before Flop (didn't bet)
Seat 8: el guru 088 (small blind) showed [Jh Ad] and won (2438) with three of a kind, Aces


PokerStars Hand #226594916967: Tournament #3189917591, $27.40+$2.60 USD Hold'em No Limit - Level III (25/50) - 2021/05/09 8:39:05 MSK [2021/05/09 1:39:05 ET]
Table '3189917591 1' 9-max Seat #7 is the button
Seat 1: dimetruk (703 in chips)
Seat 3: platosha666 (1315 in chips)
Seat 4: Titties5150 (3444 in chips)
Seat 6: julinhobrazu (4426 in chips)
Seat 7: ShaiC`akes (1304 in chips)
Seat 8: el guru 088 (2308 in chips)
dimetruk: posts the ante 6
platosha666: posts the ante 6
Titties5150: posts the ante 6
julinhobrazu: posts the ante 6
ShaiC`akes: posts the ante 6
el guru 088: posts the ante 6
el guru 088: posts small blind 25
dimetruk: posts big blind 50
*** HOLE CARDS ***
Dealt to dimetruk [Kd 7c]
platosha666: folds
Titties5150: calls 50
julinhobrazu: folds
ShaiC`akes: folds
el guru 088: calls 25
dimetruk: checks
*** FLOP *** [9d 8c 9c]
el guru 088: bets 50
dimetruk: folds
Titties5150: raises 286 to 336
el guru 088: calls 286
*** TURN *** [9d 8c 9c] [4c]
el guru 088: checks
Titties5150: checks
*** RIVER *** [9d 8c 9c 4c] [5h]
el guru 088: checks
Titties5150: checks
*** SHOW DOWN ***
el guru 088: shows [6d 8d] (two pair, Nines and Eights)
Titties5150: shows [8s Ks] (two pair, Nines and Eights - King kicker)
Titties5150 collected 858 from pot
*** SUMMARY ***
Total pot 858 | Rake 0
Board [9d 8c 9c 4c 5h]
Seat 1: dimetruk (big blind) folded on the Flop
Seat 3: platosha666 folded before Flop (didn't bet)
Seat 4: Titties5150 showed [8s Ks] and won (858) with two pair, Nines and Eights
Seat 6: julinhobrazu folded before Flop (didn't bet)
Seat 7: ShaiC`akes (button) folded before Flop (didn't bet)
Seat 8: el guru 088 (small blind) showed [6d 8d] and lost with two pair, Nines and Eights


PokerStars Hand #226594943144: Tournament #3189917591, $27.40+$2.60 USD Hold'em No Limit - Level IV (40/80) - 2021/05/09 8:41:29 MSK [2021/05/09 1:41:29 ET]
Table '3189917591 1' 9-max Seat #6 is the button
Seat 1: dimetruk (567 in chips)
Seat 3: platosha666 (1589 in chips)
Seat 4: Titties5150 (3850 in chips)
Seat 6: julinhobrazu (4260 in chips)
Seat 7: ShaiC`akes (1438 in chips)
Seat 8: el guru 088 (1796 in chips)
dimetruk: posts the ante 10
platosha666: posts the ante 10
Titties5150: posts the ante 10
julinhobrazu: posts the ante 10
ShaiC`akes: posts the ante 10
el guru 088: posts the ante 10
ShaiC`akes: posts small blind 40
el guru 088: posts big blind 80
*** HOLE CARDS ***
Dealt to dimetruk [Ad Ks]
dimetruk: raises 477 to 557 and is all-in
platosha666: raises 1022 to 1579 and is all-in
Titties5150: folds
julinhobrazu: folds
ShaiC`akes: folds
el guru 088: folds
Uncalled bet (1022) returned to platosha666
*** FLOP *** [4c 6h Kh]
*** TURN *** [4c 6h Kh] [Jh]
*** RIVER *** [4c 6h Kh Jh] [Qs]
*** SHOW DOWN ***
dimetruk: shows [Ad Ks] (a pair of Kings)
platosha666: shows [6d 6s] (three of a kind, Sixes)
platosha666 collected 1294 from pot
dimetruk finished the tournament in 6th place
*** SUMMARY ***
Total pot 1294 | Rake 0
Board [4c 6h Kh Jh Qs]
Seat 1: dimetruk showed [Ad Ks] and lost with a pair of Kings
Seat 3: platosha666 showed [6d 6s] and won (1294) with three of a kind, Sixes
Seat 4: Titties5150 folded before Flop (didn't bet)
Seat 6: julinhobrazu (button) folded before Flop (didn't bet)
Seat 7: ShaiC`akes (small blind) folded before Flop
Seat 8: el guru 088 (big blind) folded before Flop


PokerStars Hand #226595057731: Tournament #3189938750, $13.70+$1.30 USD Hold'em No Limit - Level I (10/20) - 2021/05/09 8:51:58 MSK [2021/05/09 1:51:58 ET]
Table '3189938750 1' 9-max Seat #9 is the button
Seat 1: fattburner (1441 in chips)
Seat 2: platosha666 (1523 in chips)
Seat 3: mt99808 (831 in chips)
Seat 4: dimetruk (1446 in chips)
Seat 5: thedisik (1634 in chips)
Seat 6: looser3000 (1660 in chips)
Seat 7: terr888 (1386 in chips)
Seat 8: maggie magootze (2360 in chips)
Seat 9: Koder_23 (1219 in chips)
fattburner: posts the ante 3
platosha666: posts the ante 3
mt99808: posts the ante 3
dimetruk: posts the ante 3
thedisik: posts the ante 3
looser3000: posts the ante 3
terr888: posts the ante 3
maggie magootze: posts the ante 3
Koder_23: posts the ante 3
fattburner: posts small blind 10
platosha666: posts big blind 20
*** HOLE CARDS ***
Dealt to dimetruk [Jh Kh]
mt99808: folds
dimetruk: raises 20 to 40
thedisik: folds
looser3000: folds
terr888: folds
maggie magootze: calls 40
Koder_23: folds
fattburner: calls 30
platosha666: calls 20
*** FLOP *** [Tc 2h Qd]
fattburner: checks
platosha666: checks
dimetruk: checks
maggie magootze: checks
*** TURN *** [Tc 2h Qd] [Td]
fattburner: checks
platosha666: checks
dimetruk: bets 65
maggie magootze: folds
fattburner: calls 65
platosha666: calls 65
*** RIVER *** [Tc 2h Qd Td] [3c]
fattburner: checks
platosha666: checks
dimetruk: bets 260
fattburner: folds
platosha666: folds
Uncalled bet (260) returned to dimetruk
dimetruk collected 382 from pot
dimetruk: doesn't show hand
*** SUMMARY ***
Total pot 382 | Rake 0
Board [Tc 2h Qd Td 3c]
Seat 1: fattburner (small blind) folded on the River
Seat 2: platosha666 (big blind) folded on the River
Seat 3: mt99808 folded before Flop (didn't bet)
Seat 4: dimetruk collected (382)
Seat 5: thedisik folded before Flop (didn't bet)
Seat 6: looser3000 folded before Flop (didn't bet)
Seat 7: terr888 folded before Flop (didn't bet)
Seat 8: maggie magootze folded on the Turn
Seat 9: Koder_23 (button) folded before Flop (didn't bet)


PokerStars Hand #226595093788: Tournament #3189938750, $13.70+$1.30 USD Hold'em No Limit - Level II (15/30) - 2021/05/09 8:54:29 MSK [2021/05/09 1:54:29 ET]
Table '3189938750 1' 9-max Seat #2 is the button
Seat 1: fattburner (1329 in chips)
Seat 2: platosha666 (1507 in chips)
Seat 3: mt99808 (764 in chips)
Seat 4: dimetruk (1716 in chips)
Seat 5: thedisik (1627 in chips)
Seat 6: looser3000 (1653 in chips)
Seat 7: terr888 (1379 in chips)
Seat 8: maggie magootze (2313 in chips)
Seat 9: Koder_23 (1212 in chips)
fattburner: posts the ante 4
platosha666: posts the ante 4
mt99808: posts the ante 4
dimetruk: posts the ante 4
thedisik: posts the ante 4
looser3000: posts the ante 4
terr888: posts the ante 4
maggie magootze: posts the ante 4
Koder_23: posts the ante 4
mt99808: posts small blind 15
dimetruk: posts big blind 30
*** HOLE CARDS ***
Dealt to dimetruk [Qs 9d]
thedisik: folds
looser3000: folds
terr888: folds
maggie magootze: folds
Koder_23: folds
fattburner: raises 42 to 72
platosha666: folds
mt99808: folds
dimetruk: calls 42
*** FLOP *** [8d Ks 6h]
dimetruk: checks
fattburner: bets 120
dimetruk: folds
Uncalled bet (120) returned to fattburner
fattburner collected 195 from pot
fattburner: doesn't show hand
*** SUMMARY ***
Total pot 195 | Rake 0
Board [8d Ks 6h]
Seat 1: fattburner collected (195)
Seat 2: platosha666 (button) folded before Flop (didn't bet)
Seat 3: mt99808 (small blind) folded before Flop
Seat 4: dimetruk (big blind) folded on the Flop
Seat 5: thedisik folded before Flop (didn't bet)
Seat 6: looser3000 folded before Flop (didn't bet)
Seat 7: terr888 folded before Flop (didn't bet)
Seat 8: maggie magootze folded before Flop (didn't bet)
Seat 9: Koder_23 folded before Flop (didn't bet)


PokerStars Hand #226595100762: Tournament #3189938750, $13.70+$1.30 USD Hold'em No Limit - Level II (15/30) - 2021/05/09 8:55:07 MSK [2021/05/09 1:55:07 ET]
Table '3189938750 1' 9-max Seat #3 is the button
Seat 1: fattburner (1448 in chips)
Seat 2: platosha666 (1503 in chips)
Seat 3: mt99808 (745 in chips)
Seat 4: dimetruk (1640 in chips)
Seat 5: thedisik (1623 in chips)
Seat 6: looser3000 (1649 in chips)
Seat 7: terr888 (1375 in chips)
Seat 8: maggie magootze (2309 in chips)
Seat 9: Koder_23 (1208 in chips)
fattburner: posts the ante 4
platosha666: posts the ante 4
mt99808: posts the ante 4
dimetruk: posts the ante 4
thedisik: posts the ante 4
looser3000: posts the ante 4
terr888: posts the ante 4
maggie magootze: posts the ante 4
Koder_23: posts the ante 4
dimetruk: posts small blind 15
thedisik: posts big blind 30
*** HOLE CARDS ***
Dealt to dimetruk [Kh 9h]
looser3000: folds
terr888: folds
maggie magootze: folds
Koder_23: folds
fattburner: raises 42 to 72
platosha666: folds
mt99808: folds
dimetruk: calls 57
thedisik: calls 42
*** FLOP *** [4h Tc Kc]
dimetruk: checks
thedisik: checks
fattburner: bets 189
dimetruk: calls 189
thedisik: calls 189
*** TURN *** [4h Tc Kc] [5h]
dimetruk: checks
thedisik: checks
fattburner: checks
*** RIVER *** [4h Tc Kc 5h] [4s]
dimetruk: checks
thedisik: checks
fattburner: checks
*** SHOW DOWN ***
dimetruk: shows [Kh 9h] (two pair, Kings and Fours)
thedisik: mucks hand
fattburner: mucks hand
dimetruk collected 819 from pot
*** SUMMARY ***
Total pot 819 | Rake 0
Board [4h Tc Kc 5h 4s]
Seat 1: fattburner mucked [6d Ad]
Seat 2: platosha666 folded before Flop (didn't bet)
Seat 3: mt99808 (button) folded before Flop (didn't bet)
Seat 4: dimetruk (small blind) showed [Kh 9h] and won (819) with two pair, Kings and Fours
Seat 5: thedisik (big blind) mucked [9c Ac]
Seat 6: looser3000 folded before Flop (didn't bet)
Seat 7: terr888 folded before Flop (didn't bet)
Seat 8: maggie magootze folded before Flop (didn't bet)
Seat 9: Koder_23 folded before Flop (didn't bet)


PokerStars Hand #226595138054: Tournament #3189938750, $13.70+$1.30 USD Hold'em No Limit - Level II (15/30) - 2021/05/09 8:59:13 MSK [2021/05/09 1:59:13 ET]
Table '3189938750 1' 9-max Seat #7 is the button
Seat 1: fattburner (590 in chips)
Seat 2: platosha666 (1487 in chips)
Seat 3: mt99808 (1895 in chips)
Seat 4: dimetruk (2182 in chips)
Seat 5: thedisik (1154 in chips)
Seat 6: looser3000 (1588 in chips)
Seat 7: terr888 (1284 in chips)
Seat 8: maggie magootze (2233 in chips)
Seat 9: Koder_23 (1087 in chips)
fattburner: posts the ante 4
platosha666: posts the ante 4
mt99808: posts the ante 4
dimetruk: posts the ante 4
thedisik: posts the ante 4
looser3000: posts the ante 4
terr888: posts the ante 4
maggie magootze: posts the ante 4
Koder_23: posts the ante 4
maggie magootze: posts small blind 15
Koder_23: posts big blind 30
*** HOLE CARDS ***
Dealt to dimetruk [5s 5c]
fattburner: folds
platosha666: folds
mt99808: folds
dimetruk: calls 30
thedisik: folds
looser3000: folds
terr888: folds
maggie magootze: calls 15
Koder_23: raises 75 to 105
dimetruk: calls 75
maggie magootze: calls 75
*** FLOP *** [2h 8d 2s]
maggie magootze: checks
Koder_23: bets 176
dimetruk: calls 176
maggie magootze: folds
*** TURN *** [2h 8d 2s] [Qd]
Koder_23: checks
dimetruk: checks
*** RIVER *** [2h 8d 2s Qd] [Qh]
Koder_23: checks
dimetruk: checks
*** SHOW DOWN ***
Koder_23: shows [As 9h] (two pair, Queens and Deuces)
dimetruk: shows [5s 5c] (two pair, Queens and Fives)
dimetruk collected 703 from pot
*** SUMMARY ***
Total pot 703 | Rake 0
Board [2h 8d 2s Qd Qh]
Seat 1: fattburner folded before Flop (didn't bet)
Seat 2: platosha666 folded before Flop (didn't bet)
Seat 3: mt99808 folded before Flop (didn't bet)
Seat 4: dimetruk showed [5s 5c] and won (703) with two pair, Queens and Fives
Seat 5: thedisik folded before Flop (didn't bet)
Seat 6: looser3000 folded before Flop (didn't bet)
Seat 7: terr888 (button) folded before Flop (didn't bet)
Seat 8: maggie magootze (small blind) folded on the Flop
Seat 9: Koder_23 (big blind) showed [As 9h] and lost with two pair, Queens and Deuces


PokerStars Hand #226595258406: Tournament #3189938750, $13.70+$1.30 USD Hold'em No Limit - Level III (25/50) - 2021/05/09 9:10:04 MSK [2021/05/09 2:10:04 ET]
Table '3189938750 1' 9-max Seat #3 is the button
Seat 2: platosha666 (2081 in chips)
Seat 3: mt99808 (1861 in chips)
Seat 4: dimetruk (2532 in chips)
Seat 5: thedisik (1009 in chips)
Seat 6: looser3000 (2026 in chips)
Seat 7: terr888 (1721 in chips)
Seat 8: maggie magootze (1501 in chips)
Seat 9: Koder_23 (769 in chips)
platosha666: posts the ante 6
mt99808: posts the ante 6
dimetruk: posts the ante 6
thedisik: posts the ante 6
looser3000: posts the ante 6
terr888: posts the ante 6
maggie magootze: posts the ante 6
Koder_23: posts the ante 6
dimetruk: posts small blind 25
thedisik: posts big blind 50
*** HOLE CARDS ***
Dealt to dimetruk [9h Td]
looser3000: folds
terr888: folds
maggie magootze: folds
Koder_23: folds
platosha666: folds
mt99808: folds
dimetruk: raises 50 to 100
thedisik: calls 50
*** FLOP *** [Js 8c 4s]
dimetruk: bets 87
thedisik: folds
Uncalled bet (87) returned to dimetruk
dimetruk collected 248 from pot
dimetruk: doesn't show hand
*** SUMMARY ***
Total pot 248 | Rake 0
Board [Js 8c 4s]
Seat 2: platosha666 folded before Flop (didn't bet)
Seat 3: mt99808 (button) folded before Flop (didn't bet)
Seat 4: dimetruk (small blind) collected (248)
Seat 5: thedisik (big blind) folded on the Flop
Seat 6: looser3000 folded before Flop (didn't bet)
Seat 7: terr888 folded before Flop (didn't bet)
Seat 8: maggie magootze folded before Flop (didn't bet)
Seat 9: Koder_23 folded before Flop (didn't bet)


PokerStars Hand #226595271011: Tournament #3189938750, $13.70+$1.30 USD Hold'em No Limit - Level III (25/50) - 2021/05/09 9:11:16 MSK [2021/05/09 2:11:16 ET]
Table '3189938750 1' 9-max Seat #5 is the button
Seat 2: platosha666 (2069 in chips)
Seat 3: mt99808 (1849 in chips)
Seat 4: dimetruk (2791 in chips)
Seat 5: thedisik (872 in chips)
Seat 6: looser3000 (1964 in chips)
Seat 7: terr888 (1709 in chips)
Seat 8: maggie magootze (1489 in chips)
Seat 9: Koder_23 (757 in chips)
platosha666: posts the ante 6
mt99808: posts the ante 6
dimetruk: posts the ante 6
thedisik: posts the ante 6
looser3000: posts the ante 6
terr888: posts the ante 6
maggie magootze: posts the ante 6
Koder_23: posts the ante 6
looser3000: posts small blind 25
terr888: posts big blind 50
*** HOLE CARDS ***
Dealt to dimetruk [Ac Ah]
maggie magootze: folds
Koder_23: raises 701 to 751 and is all-in
platosha666: folds
mt99808: folds
dimetruk: calls 751
thedisik: folds
looser3000: folds
terr888: folds
*** FLOP *** [8d Kh 9s]
*** TURN *** [8d Kh 9s] [7s]
*** RIVER *** [8d Kh 9s 7s] [5d]
*** SHOW DOWN ***
Koder_23: shows [Jd Jh] (a pair of Jacks)
dimetruk: shows [Ac Ah] (a pair of Aces)
dimetruk collected 1625 from pot
Koder_23 finished the tournament in 8th place
*** SUMMARY ***
Total pot 1625 | Rake 0
Board [8d Kh 9s 7s 5d]
Seat 2: platosha666 folded before Flop (didn't bet)
Seat 3: mt99808 folded before Flop (didn't bet)
Seat 4: dimetruk showed [Ac Ah] and won (1625) with a pair of Aces
Seat 5: thedisik (button) folded before Flop (didn't bet)
Seat 6: looser3000 (small blind) folded before Flop
Seat 7: terr888 (big blind) folded before Flop
Seat 8: maggie magootze folded before Flop (didn't bet)
Seat 9: Koder_23 showed [Jd Jh] and lost with a pair of Jacks


PokerStars Hand #226595337536: Tournament #3189938750, $13.70+$1.30 USD Hold'em No Limit - Level IV (40/80) - 2021/05/09 9:17:31 MSK [2021/05/09 2:17:31 ET]
Table '3189938750 1' 9-max Seat #2 is the button
Seat 2: platosha666 (1951 in chips)
Seat 3: mt99808 (1968 in chips)
Seat 4: dimetruk (3827 in chips)
Seat 5: thedisik (1004 in chips)
Seat 6: looser3000 (1421 in chips)
Seat 7: terr888 (1606 in chips)
Seat 8: maggie magootze (1723 in chips)
platosha666: posts the ante 10
mt99808: posts the ante 10
dimetruk: posts the ante 10
thedisik: posts the ante 10
looser3000: posts the ante 10
terr888: posts the ante 10
maggie magootze: posts the ante 10
mt99808: posts small blind 40
dimetruk: posts big blind 80
*** HOLE CARDS ***
Dealt to dimetruk [4h 2h]
thedisik: folds
looser3000: folds
terr888: folds
maggie magootze: raises 160 to 240
platosha666: folds
mt99808: calls 200
dimetruk: calls 160
*** FLOP *** [Jh Ac Th]
mt99808: checks
dimetruk: checks
maggie magootze: bets 1473 and is all-in
mt99808: folds
dimetruk: folds
Uncalled bet (1473) returned to maggie magootze
maggie magootze collected 790 from pot
*** SUMMARY ***
Total pot 790 | Rake 0
Board [Jh Ac Th]
Seat 2: platosha666 (button) folded before Flop (didn't bet)
Seat 3: mt99808 (small blind) folded on the Flop
Seat 4: dimetruk (big blind) folded on the Flop
Seat 5: thedisik folded before Flop (didn't bet)
Seat 6: looser3000 folded before Flop (didn't bet)
Seat 7: terr888 folded before Flop (didn't bet)
Seat 8: maggie magootze collected (790)


PokerStars Hand #226595349973: Tournament #3189938750, $13.70+$1.30 USD Hold'em No Limit - Level IV (40/80) - 2021/05/09 9:18:41 MSK [2021/05/09 2:18:41 ET]
Table '3189938750 1' 9-max Seat #3 is the button
Seat 2: platosha666 (1941 in chips)
Seat 3: mt99808 (1718 in chips)
Seat 4: dimetruk (3577 in chips)
Seat 5: thedisik (994 in chips)
Seat 6: looser3000 (1411 in chips)
Seat 7: terr888 (1596 in chips)
Seat 8: maggie magootze (2263 in chips)
platosha666: posts the ante 10
mt99808: posts the ante 10
dimetruk: posts the ante 10
thedisik: posts the ante 10
looser3000: posts the ante 10
terr888: posts the ante 10
maggie magootze: posts the ante 10
dimetruk: posts small blind 40
thedisik: posts big blind 80
*** HOLE CARDS ***
Dealt to dimetruk [4c Qc]
looser3000: folds
terr888: folds
maggie magootze: calls 80
platosha666: folds
mt99808: calls 80
dimetruk: calls 40
thedisik: checks
*** FLOP *** [Jc Qd 5s]
dimetruk: checks
thedisik: checks
maggie magootze: bets 80
mt99808: folds
dimetruk: calls 80
thedisik: folds
*** TURN *** [Jc Qd 5s] [2d]
dimetruk: checks
maggie magootze: checks
*** RIVER *** [Jc Qd 5s 2d] [8d]
dimetruk: bets 275
maggie magootze: calls 275
*** SHOW DOWN ***
dimetruk: shows [4c Qc] (a pair of Queens)
maggie magootze: mucks hand
dimetruk collected 1100 from pot
*** SUMMARY ***
Total pot 1100 | Rake 0
Board [Jc Qd 5s 2d 8d]
Seat 2: platosha666 folded before Flop (didn't bet)
Seat 3: mt99808 (button) folded on the Flop
Seat 4: dimetruk (small blind) showed [4c Qc] and won (1100) with a pair of Queens
Seat 5: thedisik (big blind) folded on the Flop
Seat 6: looser3000 folded before Flop (didn't bet)
Seat 7: terr888 folded before Flop (didn't bet)
Seat 8: maggie magootze mucked [Ts Jd]


PokerStars Hand #226595410621: Tournament #3189938750, $13.70+$1.30 USD Hold'em No Limit - Level V (60/120) - 2021/05/09 9:24:26 MSK [2021/05/09 2:24:26 ET]
Table '3189938750 1' 9-max Seat #4 is the button
Seat 2: platosha666 (1731 in chips)
Seat 4: dimetruk (4257 in chips)
Seat 5: thedisik (1204 in chips)
Seat 6: looser3000 (1821 in chips)
Seat 7: terr888 (1576 in chips)
Seat 8: maggie magootze (2911 in chips)
platosha666: posts the ante 15
dimetruk: posts the ante 15
thedisik: posts the ante 15
looser3000: posts the ante 15
terr888: posts the ante 15
maggie magootze: posts the ante 15
thedisik: posts small blind 60
looser3000: posts big blind 120
*** HOLE CARDS ***
Dealt to dimetruk [Qh Qc]
terr888: folds
maggie magootze: folds
platosha666: raises 120 to 240
dimetruk: raises 4002 to 4242 and is all-in
thedisik: folds
looser3000: folds
platosha666: calls 1476 and is all-in
Uncalled bet (2526) returned to dimetruk
*** FLOP *** [5h Td 9s]
*** TURN *** [5h Td 9s] [3c]
*** RIVER *** [5h Td 9s 3c] [Jh]
*** SHOW DOWN ***
platosha666: shows [Kh Ad] (high card Ace)
dimetruk: shows [Qh Qc] (a pair of Queens)
dimetruk collected 3702 from pot
platosha666 finished the tournament in 6th place
*** SUMMARY ***
Total pot 3702 | Rake 0
Board [5h Td 9s 3c Jh]
Seat 2: platosha666 showed [Kh Ad] and lost with high card Ace
Seat 4: dimetruk (button) showed [Qh Qc] and won (3702) with a pair of Queens
Seat 5: thedisik (small blind) folded before Flop
Seat 6: looser3000 (big blind) folded before Flop
Seat 7: terr888 folded before Flop (didn't bet)
Seat 8: maggie magootze folded before Flop (didn't bet)


PokerStars Hand #226595427205: Tournament #3189938750, $13.70+$1.30 USD Hold'em No Limit - Level V (60/120) - 2021/05/09 9:26:01 MSK [2021/05/09 2:26:01 ET]
Table '3189938750 1' 9-max Seat #7 is the button
Seat 4: dimetruk (6198 in chips)
Seat 5: thedisik (1099 in chips)
Seat 6: looser3000 (2226 in chips)
Seat 7: terr888 (1351 in chips)
Seat 8: maggie magootze (2626 in chips)
dimetruk: posts the ante 15
thedisik: posts the ante 15
looser3000: posts the ante 15
terr888: posts the ante 15
maggie magootze: posts the ante 15
maggie magootze: posts small blind 60
dimetruk: posts big blind 120
*** HOLE CARDS ***
Dealt to dimetruk [8c 5c]
thedisik: folds
looser3000: folds
terr888: folds
maggie magootze: calls 60
dimetruk: checks
*** FLOP *** [Ah Jd 4h]
maggie magootze: bets 120
dimetruk: folds
Uncalled bet (120) returned to maggie magootze
maggie magootze collected 315 from pot
*** SUMMARY ***
Total pot 315 | Rake 0
Board [Ah Jd 4h]
Seat 4: dimetruk (big blind) folded on the Flop
Seat 5: thedisik folded before Flop (didn't bet)
Seat 6: looser3000 folded before Flop (didn't bet)
Seat 7: terr888 (button) folded before Flop (didn't bet)
Seat 8: maggie magootze (small blind) collected (315)


PokerStars Hand #226595431328: Tournament #3189938750, $13.70+$1.30 USD Hold'em No Limit - Level V (60/120) - 2021/05/09 9:26:24 MSK [2021/05/09 2:26:24 ET]
Table '3189938750 1' 9-max Seat #8 is the button
Seat 4: dimetruk (6063 in chips)
Seat 5: thedisik (1084 in chips)
Seat 6: looser3000 (2211 in chips)
Seat 7: terr888 (1336 in chips)
Seat 8: maggie magootze (2806 in chips)
dimetruk: posts the ante 15
thedisik: posts the ante 15
looser3000: posts the ante 15
terr888: posts the ante 15
maggie magootze: posts the ante 15
dimetruk: posts small blind 60
thedisik: posts big blind 120
*** HOLE CARDS ***
Dealt to dimetruk [6s 8d]
looser3000: folds
terr888: folds
maggie magootze: folds
dimetruk: raises 5928 to 6048 and is all-in
thedisik: calls 949 and is all-in
Uncalled bet (4979) returned to dimetruk
*** FLOP *** [3h 4c Qd]
*** TURN *** [3h 4c Qd] [7c]
*** RIVER *** [3h 4c Qd 7c] [5s]
*** SHOW DOWN ***
dimetruk: shows [6s 8d] (a straight, Four to Eight)
thedisik: shows [Ac Ah] (a pair of Aces)
dimetruk collected 2213 from pot
thedisik finished the tournament in 5th place
*** SUMMARY ***
Total pot 2213 | Rake 0
Board [3h 4c Qd 7c 5s]
Seat 4: dimetruk (small blind) showed [6s 8d] and won (2213) with a straight, Four to Eight
Seat 5: thedisik (big blind) showed [Ac Ah] and lost with a pair of Aces
Seat 6: looser3000 folded before Flop (didn't bet)
Seat 7: terr888 folded before Flop (didn't bet)
Seat 8: maggie magootze (button) folded before Flop (didn't bet)


PokerStars Hand #226595440964: Tournament #3189938750, $13.70+$1.30 USD Hold'em No Limit - Level V (60/120) - 2021/05/09 9:27:19 MSK [2021/05/09 2:27:19 ET]
Table '3189938750 1' 9-max Seat #7 is the button
Seat 4: dimetruk (7162 in chips)
Seat 6: looser3000 (2106 in chips)
Seat 7: terr888 (1351 in chips)
Seat 8: maggie magootze (2881 in chips)
dimetruk: posts the ante 15
looser3000: posts the ante 15
terr888: posts the ante 15
maggie magootze: posts the ante 15
maggie magootze: posts small blind 60
dimetruk: posts big blind 120
*** HOLE CARDS ***
Dealt to dimetruk [Kh 3c]
looser3000: folds
terr888: folds
maggie magootze: calls 60
dimetruk: raises 120 to 240
maggie magootze: calls 120
*** FLOP *** [Ts 9d Ah]
maggie magootze: checks
dimetruk: bets 189
maggie magootze: folds
Uncalled bet (189) returned to dimetruk
dimetruk collected 540 from pot
dimetruk: doesn't show hand
*** SUMMARY ***
Total pot 540 | Rake 0
Board [Ts 9d Ah]
Seat 4: dimetruk (big blind) collected (540)
Seat 6: looser3000 folded before Flop (didn't bet)
Seat 7: terr888 (button) folded before Flop (didn't bet)
Seat 8: maggie magootze (small blind) folded on the Flop


PokerStars Hand #226595457014: Tournament #3189938750, $13.70+$1.30 USD Hold'em No Limit - Level V (60/120) - 2021/05/09 9:28:51 MSK [2021/05/09 2:28:51 ET]
Table '3189938750 1' 9-max Seat #7 is the button
Seat 4: dimetruk (7822 in chips)
Seat 6: looser3000 (1866 in chips)
Seat 7: terr888 (1711 in chips)
Seat 8: maggie magootze (2101 in chips)
dimetruk: posts the ante 15
looser3000: posts the ante 15
terr888: posts the ante 15
maggie magootze: posts the ante 15
maggie magootze: posts small blind 60
dimetruk: posts big blind 120
*** HOLE CARDS ***
Dealt to dimetruk [6d Qc]
looser3000: folds
terr888: folds
maggie magootze: calls 60
dimetruk: checks
*** FLOP *** [3d 4c 3c]
maggie magootze: checks
dimetruk: bets 180
maggie magootze: calls 180
*** TURN *** [3d 4c 3c] [Kh]
maggie magootze: checks
dimetruk: bets 330
maggie magootze: folds
Uncalled bet (330) returned to dimetruk
dimetruk collected 660 from pot
dimetruk: doesn't show hand
*** SUMMARY ***
Total pot 660 | Rake 0
Board [3d 4c 3c Kh]
Seat 4: dimetruk (big blind) collected (660)
Seat 6: looser3000 folded before Flop (didn't bet)
Seat 7: terr888 (button) folded before Flop (didn't bet)
Seat 8: maggie magootze (small blind) folded on the Turn


PokerStars Hand #226595491916: Tournament #3189938750, $13.70+$1.30 USD Hold'em No Limit - Level V (60/120) - 2021/05/09 9:32:11 MSK [2021/05/09 2:32:11 ET]
Table '3189938750 1' 9-max Seat #4 is the button
Seat 4: dimetruk (7852 in chips)
Seat 6: looser3000 (695 in chips)
Seat 7: terr888 (1921 in chips)
Seat 8: maggie magootze (3032 in chips)
dimetruk: posts the ante 15
looser3000: posts the ante 15
terr888: posts the ante 15
maggie magootze: posts the ante 15
looser3000: posts small blind 60
terr888: posts big blind 120
*** HOLE CARDS ***
Dealt to dimetruk [7h 8c]
maggie magootze: folds
dimetruk: raises 120 to 240
looser3000: raises 440 to 680 and is all-in
terr888: folds
dimetruk: calls 440
*** FLOP *** [Ad Kc Td]
*** TURN *** [Ad Kc Td] [As]
*** RIVER *** [Ad Kc Td As] [Kd]
*** SHOW DOWN ***
looser3000: shows [Ah 2d] (a full house, Aces full of Kings)
dimetruk: shows [7h 8c] (two pair, Aces and Kings)
looser3000 collected 1540 from pot
*** SUMMARY ***
Total pot 1540 | Rake 0
Board [Ad Kc Td As Kd]
Seat 4: dimetruk (button) showed [7h 8c] and lost with two pair, Aces and Kings
Seat 6: looser3000 (small blind) showed [Ah 2d] and won (1540) with a full house, Aces full of Kings
Seat 7: terr888 (big blind) folded before Flop
Seat 8: maggie magootze folded before Flop (didn't bet)


PokerStars Hand #226595513283: Tournament #3189938750, $13.70+$1.30 USD Hold'em No Limit - Level VI (80/160) - 2021/05/09 9:34:12 MSK [2021/05/09 2:34:12 ET]
Table '3189938750 1' 9-max Seat #7 is the button
Seat 4: dimetruk (7142 in chips)
Seat 6: looser3000 (1845 in chips)
Seat 7: terr888 (1711 in chips)
Seat 8: maggie magootze (2802 in chips)
dimetruk: posts the ante 20
looser3000: posts the ante 20
terr888: posts the ante 20
maggie magootze: posts the ante 20
maggie magootze: posts small blind 80
dimetruk: posts big blind 160
*** HOLE CARDS ***
Dealt to dimetruk [8d 2c]
looser3000: folds
terr888: folds
maggie magootze: calls 80
dimetruk: checks
*** FLOP *** [Td 7h 8c]
maggie magootze: bets 160
dimetruk: calls 160
*** TURN *** [Td 7h 8c] [Ac]
maggie magootze: bets 160
dimetruk: calls 160
*** RIVER *** [Td 7h 8c Ac] [2d]
maggie magootze: bets 160
dimetruk: raises 6482 to 6642 and is all-in
maggie magootze: folds
Uncalled bet (6482) returned to dimetruk
dimetruk collected 1360 from pot
dimetruk: doesn't show hand
*** SUMMARY ***
Total pot 1360 | Rake 0
Board [Td 7h 8c Ac 2d]
Seat 4: dimetruk (big blind) collected (1360)
Seat 6: looser3000 folded before Flop (didn't bet)
Seat 7: terr888 (button) folded before Flop (didn't bet)
Seat 8: maggie magootze (small blind) folded on the River


PokerStars Hand #226595524730: Tournament #3189938750, $13.70+$1.30 USD Hold'em No Limit - Level VI (80/160) - 2021/05/09 9:35:16 MSK [2021/05/09 2:35:16 ET]
Table '3189938750 1' 9-max Seat #4 is the button
Seat 4: dimetruk (8062 in chips)
Seat 6: looser3000 (1645 in chips)
Seat 7: terr888 (1671 in chips)
Seat 8: maggie magootze (2122 in chips)
dimetruk: posts the ante 20
looser3000: posts the ante 20
terr888: posts the ante 20
maggie magootze: posts the ante 20
looser3000: posts small blind 80
terr888: posts big blind 160
*** HOLE CARDS ***
Dealt to dimetruk [2h Ad]
maggie magootze: folds
dimetruk: raises 7882 to 8042 and is all-in
looser3000: calls 1545 and is all-in
terr888: folds
Uncalled bet (6417) returned to dimetruk
*** FLOP *** [Js 7h 3s]
*** TURN *** [Js 7h 3s] [8s]
*** RIVER *** [Js 7h 3s 8s] [Qc]
*** SHOW DOWN ***
looser3000: shows [7d 7s] (three of a kind, Sevens)
dimetruk: shows [2h Ad] (high card Ace)
looser3000 collected 3490 from pot
*** SUMMARY ***
Total pot 3490 | Rake 0
Board [Js 7h 3s 8s Qc]
Seat 4: dimetruk (button) showed [2h Ad] and lost with high card Ace
Seat 6: looser3000 (small blind) showed [7d 7s] and won (3490) with three of a kind, Sevens
Seat 7: terr888 (big blind) folded before Flop
Seat 8: maggie magootze folded before Flop (didn't bet)


PokerStars Hand #226595540097: Tournament #3189938750, $13.70+$1.30 USD Hold'em No Limit - Level VI (80/160) - 2021/05/09 9:36:22 MSK [2021/05/09 2:36:22 ET]
Table '3189938750 1' 9-max Seat #8 is the button
Seat 4: dimetruk (6537 in chips)
Seat 6: looser3000 (3450 in chips)
Seat 7: terr888 (1371 in chips) is sitting out
Seat 8: maggie magootze (2142 in chips)
dimetruk: posts the ante 20
looser3000: posts the ante 20
terr888: posts the ante 20
maggie magootze: posts the ante 20
dimetruk: posts small blind 80
looser3000: posts big blind 160
*** HOLE CARDS ***
Dealt to dimetruk [6h Kh]
terr888: folds
terr888 has returned
maggie magootze: folds
dimetruk: raises 160 to 320
looser3000: calls 160
*** FLOP *** [Qc Jc 2d]
dimetruk: bets 252
looser3000: calls 252
*** TURN *** [Qc Jc 2d] [Kd]
dimetruk: bets 612
looser3000: folds
Uncalled bet (612) returned to dimetruk
dimetruk collected 1224 from pot
dimetruk: doesn't show hand
*** SUMMARY ***
Total pot 1224 | Rake 0
Board [Qc Jc 2d Kd]
Seat 4: dimetruk (small blind) collected (1224)
Seat 6: looser3000 (big blind) folded on the Turn
Seat 7: terr888 folded before Flop (didn't bet)
Seat 8: maggie magootze (button) folded before Flop (didn't bet)


PokerStars Hand #226595553449: Tournament #3189938750, $13.70+$1.30 USD Hold'em No Limit - Level VI (80/160) - 2021/05/09 9:37:36 MSK [2021/05/09 2:37:36 ET]
Table '3189938750 1' 9-max Seat #7 is the button
Seat 4: dimetruk (6809 in chips)
Seat 6: looser3000 (3058 in chips)
Seat 7: terr888 (1071 in chips)
Seat 8: maggie magootze (2562 in chips)
dimetruk: posts the ante 20
looser3000: posts the ante 20
terr888: posts the ante 20
maggie magootze: posts the ante 20
maggie magootze: posts small blind 80
dimetruk: posts big blind 160
*** HOLE CARDS ***
Dealt to dimetruk [6d Qh]
looser3000: folds
terr888: folds
maggie magootze: calls 80
dimetruk: checks
*** FLOP *** [Qs 2c Jc]
maggie magootze: checks
dimetruk: bets 160
maggie magootze: folds
Uncalled bet (160) returned to dimetruk
dimetruk collected 400 from pot
dimetruk: doesn't show hand
*** SUMMARY ***
Total pot 400 | Rake 0
Board [Qs 2c Jc]
Seat 4: dimetruk (big blind) collected (400)
Seat 6: looser3000 folded before Flop (didn't bet)
Seat 7: terr888 (button) folded before Flop (didn't bet)
Seat 8: maggie magootze (small blind) folded on the Flop


PokerStars Hand #226595584739: Tournament #3189938750, $13.70+$1.30 USD Hold'em No Limit - Level VI (80/160) - 2021/05/09 9:40:30 MSK [2021/05/09 2:40:30 ET]
Table '3189938750 1' 9-max Seat #4 is the button
Seat 4: dimetruk (6729 in chips)
Seat 6: looser3000 (6771 in chips)
dimetruk: posts the ante 20
looser3000: posts the ante 20
dimetruk: posts small blind 80
looser3000: posts big blind 160
*** HOLE CARDS ***
Dealt to dimetruk [Qh 5s]
dimetruk: raises 160 to 320
looser3000: calls 160
*** FLOP *** [Qs 4s As]
looser3000: checks
dimetruk: bets 238
looser3000: folds
Uncalled bet (238) returned to dimetruk
dimetruk collected 680 from pot
dimetruk: doesn't show hand
*** SUMMARY ***
Total pot 680 | Rake 0
Board [Qs 4s As]
Seat 4: dimetruk (button) (small blind) collected (680)
Seat 6: looser3000 (big blind) folded on the Flop


PokerStars Hand #226595587620: Tournament #3189938750, $13.70+$1.30 USD Hold'em No Limit - Level VI (80/160) - 2021/05/09 9:40:45 MSK [2021/05/09 2:40:45 ET]
Table '3189938750 1' 9-max Seat #6 is the button
Seat 4: dimetruk (7069 in chips)
Seat 6: looser3000 (6431 in chips)
dimetruk: posts the ante 20
looser3000: posts the ante 20
looser3000: posts small blind 80
dimetruk: posts big blind 160
*** HOLE CARDS ***
Dealt to dimetruk [2c Qc]
looser3000: raises 160 to 320
dimetruk: calls 160
*** FLOP *** [Ad Kd Ts]
dimetruk: checks
looser3000: bets 340
dimetruk: calls 340
*** TURN *** [Ad Kd Ts] [Qs]
dimetruk: checks
looser3000: bets 680
dimetruk: folds
Uncalled bet (680) returned to looser3000
looser3000 collected 1360 from pot
looser3000: doesn't show hand
*** SUMMARY ***
Total pot 1360 | Rake 0
Board [Ad Kd Ts Qs]
Seat 4: dimetruk (big blind) folded on the Turn
Seat 6: looser3000 (button) (small blind) collected (1360)


PokerStars Hand #226595591945: Tournament #3189938750, $13.70+$1.30 USD Hold'em No Limit - Level VI (80/160) - 2021/05/09 9:41:10 MSK [2021/05/09 2:41:10 ET]
Table '3189938750 1' 9-max Seat #4 is the button
Seat 4: dimetruk (6389 in chips)
Seat 6: looser3000 (7111 in chips)
dimetruk: posts the ante 20
looser3000: posts the ante 20
dimetruk: posts small blind 80
looser3000: posts big blind 160
*** HOLE CARDS ***
Dealt to dimetruk [2h 7h]
dimetruk: raises 160 to 320
looser3000: calls 160
*** FLOP *** [4s 3d 2s]
looser3000: checks
dimetruk: checks
*** TURN *** [4s 3d 2s] [Jh]
looser3000: bets 340
dimetruk: calls 340
*** RIVER *** [4s 3d 2s Jh] [2c]
looser3000: bets 680
dimetruk: calls 680
*** SHOW DOWN ***
looser3000: shows [Td 7d] (a pair of Deuces)
dimetruk: shows [2h 7h] (three of a kind, Deuces)
dimetruk collected 2720 from pot
*** SUMMARY ***
Total pot 2720 | Rake 0
Board [4s 3d 2s Jh 2c]
Seat 4: dimetruk (button) (small blind) showed [2h 7h] and won (2720) with three of a kind, Deuces
Seat 6: looser3000 (big blind) showed [Td 7d] and lost with a pair of Deuces


PokerStars Hand #226595605734: Tournament #3189938750, $13.70+$1.30 USD Hold'em No Limit - Level VI (80/160) - 2021/05/09 9:41:44 MSK [2021/05/09 2:41:44 ET]
Table '3189938750 1' 9-max Seat #4 is the button
Seat 4: dimetruk (7849 in chips)
Seat 6: looser3000 (5651 in chips)
dimetruk: posts the ante 20
looser3000: posts the ante 20
dimetruk: posts small blind 80
looser3000: posts big blind 160
*** HOLE CARDS ***
Dealt to dimetruk [6s 4s]
dimetruk: raises 160 to 320
looser3000: calls 160
*** FLOP *** [3c Tc Td]
looser3000: checks
dimetruk: checks
*** TURN *** [3c Tc Td] [9s]
looser3000: bets 340
dimetruk: folds
Uncalled bet (340) returned to looser3000
looser3000 collected 680 from pot
looser3000: doesn't show hand
*** SUMMARY ***
Total pot 680 | Rake 0
Board [3c Tc Td 9s]
Seat 4: dimetruk (button) (small blind) folded on the Turn
Seat 6: looser3000 (big blind) collected (680)


PokerStars Hand #226595608728: Tournament #3189938750, $13.70+$1.30 USD Hold'em No Limit - Level VI (80/160) - 2021/05/09 9:42:01 MSK [2021/05/09 2:42:01 ET]
Table '3189938750 1' 9-max Seat #6 is the button
Seat 4: dimetruk (7509 in chips)
Seat 6: looser3000 (5991 in chips)
dimetruk: posts the ante 20
looser3000: posts the ante 20
looser3000: posts small blind 80
dimetruk: posts big blind 160
*** HOLE CARDS ***
Dealt to dimetruk [Ah Tc]
looser3000: raises 160 to 320
dimetruk: calls 160
*** FLOP *** [Qc 2d 5d]
dimetruk: checks
looser3000: checks
*** TURN *** [Qc 2d 5d] [3c]
dimetruk: bets 238
looser3000: raises 402 to 640
dimetruk: folds
Uncalled bet (402) returned to looser3000
looser3000 collected 1156 from pot
looser3000: doesn't show hand
*** SUMMARY ***
Total pot 1156 | Rake 0
Board [Qc 2d 5d 3c]
Seat 4: dimetruk (big blind) folded on the Turn
Seat 6: looser3000 (button) (small blind) collected (1156)


PokerStars Hand #226595613081: Tournament #3189938750, $13.70+$1.30 USD Hold'em No Limit - Level VI (80/160) - 2021/05/09 9:42:25 MSK [2021/05/09 2:42:25 ET]
Table '3189938750 1' 9-max Seat #4 is the button
Seat 4: dimetruk (6931 in chips)
Seat 6: looser3000 (6569 in chips)
dimetruk: posts the ante 20
looser3000: posts the ante 20
dimetruk: posts small blind 80
looser3000: posts big blind 160
*** HOLE CARDS ***
Dealt to dimetruk [Ts Ks]
dimetruk: raises 160 to 320
looser3000: calls 160
*** FLOP *** [5h 8d 3h]
looser3000: bets 340
dimetruk: folds
Uncalled bet (340) returned to looser3000
looser3000 collected 680 from pot
looser3000: doesn't show hand
*** SUMMARY ***
Total pot 680 | Rake 0
Board [5h 8d 3h]
Seat 4: dimetruk (button) (small blind) folded on the Flop
Seat 6: looser3000 (big blind) collected (680)


PokerStars Hand #226595615969: Tournament #3189938750, $13.70+$1.30 USD Hold'em No Limit - Level VI (80/160) - 2021/05/09 9:42:41 MSK [2021/05/09 2:42:41 ET]
Table '3189938750 1' 9-max Seat #6 is the button
Seat 4: dimetruk (6591 in chips)
Seat 6: looser3000 (6909 in chips)
dimetruk: posts the ante 20
looser3000: posts the ante 20
looser3000: posts small blind 80
dimetruk: posts big blind 160
*** HOLE CARDS ***
Dealt to dimetruk [5s 3c]
looser3000: raises 160 to 320
dimetruk: calls 160
*** FLOP *** [8s 9c Ad]
dimetruk: checks
looser3000: bets 340
dimetruk: folds
Uncalled bet (340) returned to looser3000
looser3000 collected 680 from pot
looser3000: doesn't show hand
*** SUMMARY ***
Total pot 680 | Rake 0
Board [8s 9c Ad]
Seat 4: dimetruk (big blind) folded on the Flop
Seat 6: looser3000 (button) (small blind) collected (680)


PokerStars Hand #226595625233: Tournament #3189938750, $13.70+$1.30 USD Hold'em No Limit - Level VII (100/200) - 2021/05/09 9:43:33 MSK [2021/05/09 2:43:33 ET]
Table '3189938750 1' 9-max Seat #6 is the button
Seat 4: dimetruk (5771 in chips)
Seat 6: looser3000 (7729 in chips)
dimetruk: posts the ante 25
looser3000: posts the ante 25
looser3000: posts small blind 100
dimetruk: posts big blind 200
*** HOLE CARDS ***
Dealt to dimetruk [4c Jc]
looser3000: raises 200 to 400
dimetruk: calls 200
*** FLOP *** [Js 7h Kc]
dimetruk: checks
looser3000: bets 425
dimetruk: calls 425
*** TURN *** [Js 7h Kc] [8h]
dimetruk: checks
looser3000: checks
*** RIVER *** [Js 7h Kc 8h] [2h]
dimetruk: checks
looser3000: checks
*** SHOW DOWN ***
dimetruk: shows [4c Jc] (a pair of Jacks)
looser3000: mucks hand
dimetruk collected 1700 from pot
*** SUMMARY ***
Total pot 1700 | Rake 0
Board [Js 7h Kc 8h 2h]
Seat 4: dimetruk (big blind) showed [4c Jc] and won (1700) with a pair of Jacks
Seat 6: looser3000 (button) (small blind) mucked [7c 5c]


PokerStars Hand #226595632847: Tournament #3189938750, $13.70+$1.30 USD Hold'em No Limit - Level VII (100/200) - 2021/05/09 9:44:15 MSK [2021/05/09 2:44:15 ET]
Table '3189938750 1' 9-max Seat #6 is the button
Seat 4: dimetruk (6146 in chips)
Seat 6: looser3000 (7354 in chips)
dimetruk: posts the ante 25
looser3000: posts the ante 25
looser3000: posts small blind 100
dimetruk: posts big blind 200
*** HOLE CARDS ***
Dealt to dimetruk [7s 6d]
looser3000: raises 200 to 400
dimetruk: calls 200
*** FLOP *** [3c 5s 8c]
dimetruk: checks
looser3000: bets 425
dimetruk: calls 425
*** TURN *** [3c 5s 8c] [As]
dimetruk: checks
looser3000: bets 850
dimetruk: folds
Uncalled bet (850) returned to looser3000
looser3000 collected 1700 from pot
looser3000: doesn't show hand
*** SUMMARY ***
Total pot 1700 | Rake 0
Board [3c 5s 8c As]
Seat 4: dimetruk (big blind) folded on the Turn
Seat 6: looser3000 (button) (small blind) collected (1700)


PokerStars Hand #226595639265: Tournament #3189938750, $13.70+$1.30 USD Hold'em No Limit - Level VII (100/200) - 2021/05/09 9:44:51 MSK [2021/05/09 2:44:51 ET]
Table '3189938750 1' 9-max Seat #6 is the button
Seat 4: dimetruk (5071 in chips)
Seat 6: looser3000 (8429 in chips)
dimetruk: posts the ante 25
looser3000: posts the ante 25
looser3000: posts small blind 100
dimetruk: posts big blind 200
*** HOLE CARDS ***
Dealt to dimetruk [6s Qd]
looser3000: raises 200 to 400
dimetruk: calls 200
*** FLOP *** [Jc Ad Th]
dimetruk: checks
looser3000: checks
*** TURN *** [Jc Ad Th] [Tc]
dimetruk: bets 425
looser3000: folds
Uncalled bet (425) returned to dimetruk
dimetruk collected 850 from pot
dimetruk: doesn't show hand
*** SUMMARY ***
Total pot 850 | Rake 0
Board [Jc Ad Th Tc]
Seat 4: dimetruk (big blind) collected (850)
Seat 6: looser3000 (button) (small blind) folded on the Turn


PokerStars Hand #226595647446: Tournament #3189938750, $13.70+$1.30 USD Hold'em No Limit - Level VII (100/200) - 2021/05/09 9:45:37 MSK [2021/05/09 2:45:37 ET]
Table '3189938750 1' 9-max Seat #6 is the button
Seat 4: dimetruk (6021 in chips)
Seat 6: looser3000 (7479 in chips)
dimetruk: posts the ante 25
looser3000: posts the ante 25
looser3000: posts small blind 100
dimetruk: posts big blind 200
*** HOLE CARDS ***
Dealt to dimetruk [Jd Tc]
looser3000: raises 200 to 400
dimetruk: calls 200
*** FLOP *** [Ad 5h 5s]
dimetruk: checks
looser3000: checks
*** TURN *** [Ad 5h 5s] [9h]
dimetruk: bets 425
looser3000: folds
Uncalled bet (425) returned to dimetruk
dimetruk collected 850 from pot
dimetruk: doesn't show hand
*** SUMMARY ***
Total pot 850 | Rake 0
Board [Ad 5h 5s 9h]
Seat 4: dimetruk (big blind) collected (850)
Seat 6: looser3000 (button) (small blind) folded on the Turn


PokerStars Hand #226595652813: Tournament #3189938750, $13.70+$1.30 USD Hold'em No Limit - Level VII (100/200) - 2021/05/09 9:46:07 MSK [2021/05/09 2:46:07 ET]
Table '3189938750 1' 9-max Seat #6 is the button
Seat 4: dimetruk (6671 in chips)
Seat 6: looser3000 (6829 in chips)
dimetruk: posts the ante 25
looser3000: posts the ante 25
looser3000: posts small blind 100
dimetruk: posts big blind 200
*** HOLE CARDS ***
Dealt to dimetruk [Jc Th]
looser3000: raises 200 to 400
dimetruk: calls 200
*** FLOP *** [As Js 9c]
dimetruk: checks
looser3000: bets 425
dimetruk: calls 425
*** TURN *** [As Js 9c] [5h]
dimetruk: checks
looser3000: bets 850
dimetruk: calls 850
*** RIVER *** [As Js 9c 5h] [8d]
dimetruk: checks
looser3000: bets 1700
dimetruk: folds
Uncalled bet (1700) returned to looser3000
looser3000 collected 3400 from pot
looser3000: doesn't show hand
*** SUMMARY ***
Total pot 3400 | Rake 0
Board [As Js 9c 5h 8d]
Seat 4: dimetruk (big blind) folded on the River
Seat 6: looser3000 (button) (small blind) collected (3400)


PokerStars Hand #226595660531: Tournament #3189938750, $13.70+$1.30 USD Hold'em No Limit - Level VII (100/200) - 2021/05/09 9:46:50 MSK [2021/05/09 2:46:50 ET]
Table '3189938750 1' 9-max Seat #6 is the button
Seat 4: dimetruk (4846 in chips)
Seat 6: looser3000 (8654 in chips)
dimetruk: posts the ante 25
looser3000: posts the ante 25
looser3000: posts small blind 100
dimetruk: posts big blind 200
*** HOLE CARDS ***
Dealt to dimetruk [Jc 4h]
looser3000: raises 200 to 400
dimetruk: calls 200
*** FLOP *** [8c 2s 8h]
dimetruk: checks
looser3000: checks
*** TURN *** [8c 2s 8h] [5d]
dimetruk: bets 425
looser3000: calls 425
*** RIVER *** [8c 2s 8h 5d] [Th]
dimetruk: checks
looser3000: bets 850
dimetruk: folds
Uncalled bet (850) returned to looser3000
looser3000 collected 1700 from pot
looser3000: doesn't show hand
*** SUMMARY ***
Total pot 1700 | Rake 0
Board [8c 2s 8h 5d Th]
Seat 4: dimetruk (big blind) folded on the River
Seat 6: looser3000 (button) (small blind) collected (1700)


PokerStars Hand #226595667429: Tournament #3189938750, $13.70+$1.30 USD Hold'em No Limit - Level VII (100/200) - 2021/05/09 9:47:29 MSK [2021/05/09 2:47:29 ET]
Table '3189938750 1' 9-max Seat #6 is the button
Seat 4: dimetruk (3571 in chips)
Seat 6: looser3000 (9929 in chips)
dimetruk: posts the ante 25
looser3000: posts the ante 25
looser3000: posts small blind 100
dimetruk: posts big blind 200
*** HOLE CARDS ***
Dealt to dimetruk [Ad Js]
looser3000: raises 9704 to 9904 and is all-in
dimetruk: calls 3346 and is all-in
Uncalled bet (6358) returned to looser3000
*** FLOP *** [4h 4c 6h]
*** TURN *** [4h 4c 6h] [Kh]
*** RIVER *** [4h 4c 6h Kh] [Th]
*** SHOW DOWN ***
dimetruk: shows [Ad Js] (a pair of Fours)
looser3000: shows [Kc 8h] (a flush, King high)
looser3000 collected 7142 from pot
dimetruk finished the tournament in 2nd place and received $36.99.
looser3000 wins the tournament and receives $61.65 - congratulations!
*** SUMMARY ***
Total pot 7142 | Rake 0
Board [4h 4c 6h Kh Th]
Seat 4: dimetruk (big blind) showed [Ad Js] and lost with a pair of Fours
Seat 6: looser3000 (button) (small blind) showed [Kc 8h] and won (7142) with a flush, King high


PokerStars Hand #226595038727: Tournament #3189943627, $13.79+$1.21 USD Hold'em No Limit - Level I (10/20) - 2021/05/09 8:50:16 MSK [2021/05/09 1:50:16 ET]
Table '3189943627 1' 6-max Seat #1 is the button
Seat 1: SheenWinning42 (1500 in chips)
Seat 2: mt99808 (1500 in chips)
Seat 3: dimetruk (1500 in chips)
Seat 4: Carloss86 (1500 in chips)
Seat 5: gupshow (1500 in chips)
Seat 6: schaef.alex (1500 in chips)
SheenWinning42: posts the ante 3
mt99808: posts the ante 3
dimetruk: posts the ante 3
Carloss86: posts the ante 3
gupshow: posts the ante 3
schaef.alex: posts the ante 3
mt99808: posts small blind 10
dimetruk: posts big blind 20
*** HOLE CARDS ***
Dealt to dimetruk [2c 6s]
Carloss86: folds
gupshow: calls 20
schaef.alex: folds
SheenWinning42: folds
mt99808: calls 10
dimetruk: checks
*** FLOP *** [3c 7d Qd]
mt99808: checks
dimetruk: checks
gupshow: bets 40
mt99808: folds
dimetruk: folds
Uncalled bet (40) returned to gupshow
gupshow collected 78 from pot
gupshow: doesn't show hand
*** SUMMARY ***
Total pot 78 | Rake 0
Board [3c 7d Qd]
Seat 1: SheenWinning42 (button) folded before Flop (didn't bet)
Seat 2: mt99808 (small blind) folded on the Flop
Seat 3: dimetruk (big blind) folded on the Flop
Seat 4: Carloss86 folded before Flop (didn't bet)
Seat 5: gupshow collected (78)
Seat 6: schaef.alex folded before Flop (didn't bet)


PokerStars Hand #226595056227: Tournament #3189943627, $13.79+$1.21 USD Hold'em No Limit - Level I (10/20) - 2021/05/09 8:51:50 MSK [2021/05/09 1:51:50 ET]
Table '3189943627 1' 6-max Seat #3 is the button
Seat 1: SheenWinning42 (1494 in chips)
Seat 2: mt99808 (1474 in chips)
Seat 3: dimetruk (1424 in chips)
Seat 4: Carloss86 (1612 in chips)
Seat 5: gupshow (1552 in chips)
Seat 6: schaef.alex (1444 in chips)
SheenWinning42: posts the ante 3
mt99808: posts the ante 3
dimetruk: posts the ante 3
Carloss86: posts the ante 3
gupshow: posts the ante 3
schaef.alex: posts the ante 3
Carloss86: posts small blind 10
gupshow: posts big blind 20
*** HOLE CARDS ***
Dealt to dimetruk [7d Kd]
schaef.alex: folds
SheenWinning42: folds
mt99808: folds
dimetruk: raises 20 to 40
Carloss86: folds
gupshow: calls 20
*** FLOP *** [Ac 8h Qd]
gupshow: checks
dimetruk: bets 38
gupshow: calls 38
*** TURN *** [Ac 8h Qd] [Qc]
gupshow: checks
dimetruk: checks
*** RIVER *** [Ac 8h Qd Qc] [5s]
gupshow: bets 30
dimetruk: folds
Uncalled bet (30) returned to gupshow
gupshow collected 184 from pot
gupshow: doesn't show hand
*** SUMMARY ***
Total pot 184 | Rake 0
Board [Ac 8h Qd Qc 5s]
Seat 1: SheenWinning42 folded before Flop (didn't bet)
Seat 2: mt99808 folded before Flop (didn't bet)
Seat 3: dimetruk (button) folded on the River
Seat 4: Carloss86 (small blind) folded before Flop
Seat 5: gupshow (big blind) collected (184)
Seat 6: schaef.alex folded before Flop (didn't bet)


PokerStars Hand #226595063869: Tournament #3189943627, $13.79+$1.21 USD Hold'em No Limit - Level I (10/20) - 2021/05/09 8:52:32 MSK [2021/05/09 1:52:32 ET]
Table '3189943627 1' 6-max Seat #4 is the button
Seat 1: SheenWinning42 (1491 in chips)
Seat 2: mt99808 (1471 in chips)
Seat 3: dimetruk (1343 in chips)
Seat 4: Carloss86 (1599 in chips)
Seat 5: gupshow (1655 in chips)
Seat 6: schaef.alex (1441 in chips)
SheenWinning42: posts the ante 3
mt99808: posts the ante 3
dimetruk: posts the ante 3
Carloss86: posts the ante 3
gupshow: posts the ante 3
schaef.alex: posts the ante 3
gupshow: posts small blind 10
schaef.alex: posts big blind 20
*** HOLE CARDS ***
Dealt to dimetruk [Ks As]
SheenWinning42: folds
mt99808: folds
dimetruk: raises 20 to 40
Carloss86: folds
gupshow: folds
schaef.alex: calls 20
*** FLOP *** [5d 9h 8c]
schaef.alex: checks
dimetruk: bets 81
schaef.alex: folds
Uncalled bet (81) returned to dimetruk
dimetruk collected 108 from pot
dimetruk: doesn't show hand
*** SUMMARY ***
Total pot 108 | Rake 0
Board [5d 9h 8c]
Seat 1: SheenWinning42 folded before Flop (didn't bet)
Seat 2: mt99808 folded before Flop (didn't bet)
Seat 3: dimetruk collected (108)
Seat 4: Carloss86 (button) folded before Flop (didn't bet)
Seat 5: gupshow (small blind) folded before Flop
Seat 6: schaef.alex (big blind) folded on the Flop


PokerStars Hand #226595088847: Tournament #3189943627, $13.79+$1.21 USD Hold'em No Limit - Level I (10/20) - 2021/05/09 8:54:01 MSK [2021/05/09 1:54:01 ET]
Table '3189943627 1' 6-max Seat #1 is the button
Seat 1: SheenWinning42 (1452 in chips)
Seat 2: mt99808 (1490 in chips)
Seat 3: dimetruk (1402 in chips)
Seat 4: Carloss86 (1590 in chips)
Seat 5: gupshow (1636 in chips)
Seat 6: schaef.alex (1430 in chips)
SheenWinning42: posts the ante 3
mt99808: posts the ante 3
dimetruk: posts the ante 3
Carloss86: posts the ante 3
gupshow: posts the ante 3
schaef.alex: posts the ante 3
mt99808: posts small blind 10
dimetruk: posts big blind 20
*** HOLE CARDS ***
Dealt to dimetruk [4h 9c]
Carloss86: folds
gupshow: folds
schaef.alex: folds
SheenWinning42: folds
mt99808: calls 10
dimetruk: checks
*** FLOP *** [Kd Jh 6s]
mt99808: checks
dimetruk: checks
*** TURN *** [Kd Jh 6s] [Ac]
mt99808: bets 40
dimetruk: folds
Uncalled bet (40) returned to mt99808
mt99808 collected 58 from pot
mt99808: doesn't show hand
*** SUMMARY ***
Total pot 58 | Rake 0
Board [Kd Jh 6s Ac]
Seat 1: SheenWinning42 (button) folded before Flop (didn't bet)
Seat 2: mt99808 (small blind) collected (58)
Seat 3: dimetruk (big blind) folded on the Turn
Seat 4: Carloss86 folded before Flop (didn't bet)
Seat 5: gupshow folded before Flop (didn't bet)
Seat 6: schaef.alex folded before Flop (didn't bet)


PokerStars Hand #226595100878: Tournament #3189943627, $13.79+$1.21 USD Hold'em No Limit - Level I (10/20) - 2021/05/09 8:55:08 MSK [2021/05/09 1:55:08 ET]
Table '3189943627 1' 6-max Seat #2 is the button
Seat 1: SheenWinning42 (1449 in chips)
Seat 2: mt99808 (1525 in chips)
Seat 3: dimetruk (1379 in chips)
Seat 4: Carloss86 (1587 in chips)
Seat 5: gupshow (1633 in chips)
Seat 6: schaef.alex (1427 in chips)
SheenWinning42: posts the ante 3
mt99808: posts the ante 3
dimetruk: posts the ante 3
Carloss86: posts the ante 3
gupshow: posts the ante 3
schaef.alex: posts the ante 3
dimetruk: posts small blind 10
Carloss86: posts big blind 20
*** HOLE CARDS ***
Dealt to dimetruk [2c 9c]
gupshow: folds
schaef.alex: folds
SheenWinning42: folds
mt99808: folds
dimetruk: raises 20 to 40
Carloss86: calls 20
*** FLOP *** [Tc Jc 3d]
dimetruk: bets 49
Carloss86: calls 49
*** TURN *** [Tc Jc 3d] [Qd]
dimetruk: bets 171
Carloss86: calls 171
*** RIVER *** [Tc Jc 3d Qd] [Ad]
dimetruk: checks
Carloss86: checks
*** SHOW DOWN ***
dimetruk: shows [2c 9c] (high card Ace)
Carloss86: shows [7h Ac] (a pair of Aces)
Carloss86 collected 538 from pot
*** SUMMARY ***
Total pot 538 | Rake 0
Board [Tc Jc 3d Qd Ad]
Seat 1: SheenWinning42 folded before Flop (didn't bet)
Seat 2: mt99808 (button) folded before Flop (didn't bet)
Seat 3: dimetruk (small blind) showed [2c 9c] and lost with high card Ace
Seat 4: Carloss86 (big blind) showed [7h Ac] and won (538) with a pair of Aces
Seat 5: gupshow folded before Flop (didn't bet)
Seat 6: schaef.alex folded before Flop (didn't bet)


PokerStars Hand #226595118653: Tournament #3189943627, $13.79+$1.21 USD Hold'em No Limit - Level I (10/20) - 2021/05/09 8:57:05 MSK [2021/05/09 1:57:05 ET]
Table '3189943627 1' 6-max Seat #4 is the button
Seat 1: SheenWinning42 (1443 in chips)
Seat 2: mt99808 (1567 in chips)
Seat 3: dimetruk (1113 in chips)
Seat 4: Carloss86 (1849 in chips)
Seat 5: gupshow (1607 in chips)
Seat 6: schaef.alex (1421 in chips)
SheenWinning42: posts the ante 3
mt99808: posts the ante 3
dimetruk: posts the ante 3
Carloss86: posts the ante 3
gupshow: posts the ante 3
schaef.alex: posts the ante 3
gupshow: posts small blind 10
schaef.alex: posts big blind 20
*** HOLE CARDS ***
Dealt to dimetruk [8d 8s]
SheenWinning42: raises 20 to 40
mt99808: folds
dimetruk: raises 60 to 100
Carloss86: folds
gupshow: folds
schaef.alex: folds
SheenWinning42: calls 60
*** FLOP *** [Ad 6h 9h]
SheenWinning42: checks
dimetruk: bets 87
SheenWinning42: calls 87
*** TURN *** [Ad 6h 9h] [7c]
SheenWinning42: checks
dimetruk: bets 220
SheenWinning42: calls 220
*** RIVER *** [Ad 6h 9h 7c] [Qh]
SheenWinning42: checks
dimetruk: checks
*** SHOW DOWN ***
SheenWinning42: shows [Js 9s] (a pair of Nines)
dimetruk: mucks hand
SheenWinning42 collected 862 from pot
*** SUMMARY ***
Total pot 862 | Rake 0
Board [Ad 6h 9h 7c Qh]
Seat 1: SheenWinning42 showed [Js 9s] and won (862) with a pair of Nines
Seat 2: mt99808 folded before Flop (didn't bet)
Seat 3: dimetruk mucked [8d 8s]
Seat 4: Carloss86 (button) folded before Flop (didn't bet)
Seat 5: gupshow (small blind) folded before Flop
Seat 6: schaef.alex (big blind) folded before Flop


PokerStars Hand #226595137959: Tournament #3189943627, $13.79+$1.21 USD Hold'em No Limit - Level I (10/20) - 2021/05/09 8:59:13 MSK [2021/05/09 1:59:13 ET]
Table '3189943627 1' 6-max Seat #1 is the button
Seat 1: SheenWinning42 (1955 in chips)
Seat 2: mt99808 (1538 in chips)
Seat 3: dimetruk (697 in chips)
Seat 4: Carloss86 (1840 in chips)
Seat 5: gupshow (1588 in chips)
Seat 6: schaef.alex (1382 in chips)
SheenWinning42: posts the ante 3
mt99808: posts the ante 3
dimetruk: posts the ante 3
Carloss86: posts the ante 3
gupshow: posts the ante 3
schaef.alex: posts the ante 3
mt99808: posts small blind 10
dimetruk: posts big blind 20
*** HOLE CARDS ***
Dealt to dimetruk [6d 9s]
Carloss86: raises 30 to 50
gupshow: folds
schaef.alex: folds
SheenWinning42: folds
mt99808: folds
dimetruk: calls 30
*** FLOP *** [8d Js Th]
dimetruk: checks
Carloss86: bets 42
dimetruk: calls 42
*** TURN *** [8d Js Th] [Jd]
dimetruk: checks
Carloss86: bets 137
dimetruk: folds
Uncalled bet (137) returned to Carloss86
Carloss86 collected 212 from pot
Carloss86: doesn't show hand
*** SUMMARY ***
Total pot 212 | Rake 0
Board [8d Js Th Jd]
Seat 1: SheenWinning42 (button) folded before Flop (didn't bet)
Seat 2: mt99808 (small blind) folded before Flop
Seat 3: dimetruk (big blind) folded on the Turn
Seat 4: Carloss86 collected (212)
Seat 5: gupshow folded before Flop (didn't bet)
Seat 6: schaef.alex folded before Flop (didn't bet)


PokerStars Hand #226595192538: Tournament #3189943627, $13.79+$1.21 USD Hold'em No Limit - Level II (15/30) - 2021/05/09 9:03:58 MSK [2021/05/09 2:03:58 ET]
Table '3189943627 1' 6-max Seat #1 is the button
Seat 1: SheenWinning42 (1812 in chips)
Seat 2: mt99808 (1364 in chips)
Seat 3: dimetruk (567 in chips)
Seat 4: Carloss86 (2051 in chips)
Seat 5: gupshow (1784 in chips)
Seat 6: schaef.alex (1422 in chips)
SheenWinning42: posts the ante 4
mt99808: posts the ante 4
dimetruk: posts the ante 4
Carloss86: posts the ante 4
gupshow: posts the ante 4
schaef.alex: posts the ante 4
mt99808: posts small blind 15
dimetruk: posts big blind 30
*** HOLE CARDS ***
Dealt to dimetruk [Tc 2s]
Carloss86: folds
gupshow: folds
schaef.alex: raises 45 to 75
SheenWinning42: calls 75
mt99808: folds
dimetruk: calls 45
*** FLOP *** [3h 9h Td]
dimetruk: bets 488 and is all-in
schaef.alex: folds
SheenWinning42: folds
Uncalled bet (488) returned to dimetruk
dimetruk collected 264 from pot
dimetruk: doesn't show hand
*** SUMMARY ***
Total pot 264 | Rake 0
Board [3h 9h Td]
Seat 1: SheenWinning42 (button) folded on the Flop
Seat 2: mt99808 (small blind) folded before Flop
Seat 3: dimetruk (big blind) collected (264)
Seat 4: Carloss86 folded before Flop (didn't bet)
Seat 5: gupshow folded before Flop (didn't bet)
Seat 6: schaef.alex folded on the Flop


PokerStars Hand #226595229122: Tournament #3189943627, $13.79+$1.21 USD Hold'em No Limit - Level II (15/30) - 2021/05/09 9:07:21 MSK [2021/05/09 2:07:21 ET]
Table '3189943627 1' 6-max Seat #1 is the button
Seat 1: SheenWinning42 (2123 in chips)
Seat 2: mt99808 (1433 in chips)
Seat 3: dimetruk (657 in chips)
Seat 4: Carloss86 (2036 in chips)
Seat 5: gupshow (1655 in chips)
Seat 6: schaef.alex (1096 in chips)
SheenWinning42: posts the ante 4
mt99808: posts the ante 4
dimetruk: posts the ante 4
Carloss86: posts the ante 4
gupshow: posts the ante 4
schaef.alex: posts the ante 4
mt99808: posts small blind 15
dimetruk: posts big blind 30
*** HOLE CARDS ***
Dealt to dimetruk [6s 3h]
Carloss86: raises 45 to 75
gupshow: folds
schaef.alex: calls 75
SheenWinning42: folds
mt99808: folds
dimetruk: calls 45
*** FLOP *** [Ac 3d 5s]
dimetruk: checks
Carloss86: bets 97
schaef.alex: calls 97
dimetruk: calls 97
*** TURN *** [Ac 3d 5s] [5h]
dimetruk: checks
Carloss86: checks
schaef.alex: checks
*** RIVER *** [Ac 3d 5s 5h] [As]
dimetruk: checks
Carloss86: checks
schaef.alex: bets 178
dimetruk: folds
Carloss86: folds
Uncalled bet (178) returned to schaef.alex
schaef.alex collected 555 from pot
schaef.alex: doesn't show hand
*** SUMMARY ***
Total pot 555 | Rake 0
Board [Ac 3d 5s 5h As]
Seat 1: SheenWinning42 (button) folded before Flop (didn't bet)
Seat 2: mt99808 (small blind) folded before Flop
Seat 3: dimetruk (big blind) folded on the River
Seat 4: Carloss86 folded on the River
Seat 5: gupshow folded before Flop (didn't bet)
Seat 6: schaef.alex collected (555)


PokerStars Hand #226595270560: Tournament #3189943627, $13.79+$1.21 USD Hold'em No Limit - Level III (25/50) - 2021/05/09 9:11:13 MSK [2021/05/09 2:11:13 ET]
Table '3189943627 1' 6-max Seat #1 is the button
Seat 1: SheenWinning42 (1982 in chips)
Seat 2: mt99808 (1657 in chips)
Seat 3: dimetruk (588 in chips)
Seat 4: Carloss86 (1793 in chips)
Seat 5: gupshow (1608 in chips)
Seat 6: schaef.alex (1372 in chips)
SheenWinning42: posts the ante 6
mt99808: posts the ante 6
dimetruk: posts the ante 6
Carloss86: posts the ante 6
gupshow: posts the ante 6
schaef.alex: posts the ante 6
mt99808: posts small blind 25
dimetruk: posts big blind 50
*** HOLE CARDS ***
Dealt to dimetruk [5c 2h]
Carloss86: folds
gupshow: folds
schaef.alex: raises 75 to 125
SheenWinning42: folds
mt99808: folds
dimetruk: calls 75
*** FLOP *** [3d Qh 8d]
dimetruk: checks
schaef.alex: bets 100
dimetruk: folds
Uncalled bet (100) returned to schaef.alex
schaef.alex collected 311 from pot
schaef.alex: doesn't show hand
*** SUMMARY ***
Total pot 311 | Rake 0
Board [3d Qh 8d]
Seat 1: SheenWinning42 (button) folded before Flop (didn't bet)
Seat 2: mt99808 (small blind) folded before Flop
Seat 3: dimetruk (big blind) folded on the Flop
Seat 4: Carloss86 folded before Flop (didn't bet)
Seat 5: gupshow folded before Flop (didn't bet)
Seat 6: schaef.alex collected (311)


PokerStars Hand #226595312232: Tournament #3189943627, $13.79+$1.21 USD Hold'em No Limit - Level III (25/50) - 2021/05/09 9:15:09 MSK [2021/05/09 2:15:09 ET]
Table '3189943627 1' 6-max Seat #1 is the button
Seat 1: SheenWinning42 (1832 in chips)
Seat 2: mt99808 (1657 in chips)
Seat 3: dimetruk (402 in chips)
Seat 4: Carloss86 (1657 in chips)
Seat 5: gupshow (2302 in chips)
Seat 6: schaef.alex (1150 in chips)
SheenWinning42: posts the ante 6
mt99808: posts the ante 6
dimetruk: posts the ante 6
Carloss86: posts the ante 6
gupshow: posts the ante 6
schaef.alex: posts the ante 6
mt99808: posts small blind 25
dimetruk: posts big blind 50
*** HOLE CARDS ***
Dealt to dimetruk [Kc 7h]
Carloss86: folds
gupshow: folds
schaef.alex: folds
SheenWinning42: folds
mt99808: calls 25
dimetruk: raises 346 to 396 and is all-in
mt99808: calls 346
*** FLOP *** [Kd Tc As]
*** TURN *** [Kd Tc As] [Th]
*** RIVER *** [Kd Tc As Th] [9d]
*** SHOW DOWN ***
mt99808: shows [4c 4d] (two pair, Tens and Fours)
dimetruk: shows [Kc 7h] (two pair, Kings and Tens)
dimetruk collected 828 from pot
*** SUMMARY ***
Total pot 828 | Rake 0
Board [Kd Tc As Th 9d]
Seat 1: SheenWinning42 (button) folded before Flop (didn't bet)
Seat 2: mt99808 (small blind) showed [4c 4d] and lost with two pair, Tens and Fours
Seat 3: dimetruk (big blind) showed [Kc 7h] and won (828) with two pair, Kings and Tens
Seat 4: Carloss86 folded before Flop (didn't bet)
Seat 5: gupshow folded before Flop (didn't bet)
Seat 6: schaef.alex folded before Flop (didn't bet)


PokerStars Hand #226595333793: Tournament #3189943627, $13.79+$1.21 USD Hold'em No Limit - Level III (25/50) - 2021/05/09 9:17:10 MSK [2021/05/09 2:17:10 ET]
Table '3189943627 1' 6-max Seat #4 is the button
Seat 1: SheenWinning42 (1814 in chips)
Seat 2: mt99808 (1193 in chips)
Seat 3: dimetruk (952 in chips)
Seat 4: Carloss86 (1539 in chips)
Seat 5: gupshow (2370 in chips)
Seat 6: schaef.alex (1132 in chips)
SheenWinning42: posts the ante 6
mt99808: posts the ante 6
dimetruk: posts the ante 6
Carloss86: posts the ante 6
gupshow: posts the ante 6
schaef.alex: posts the ante 6
gupshow: posts small blind 25
schaef.alex: posts big blind 50
*** HOLE CARDS ***
Dealt to dimetruk [Kh 8c]
SheenWinning42: folds
mt99808: folds
dimetruk: raises 50 to 100
Carloss86: folds
gupshow: folds
schaef.alex: calls 50
*** FLOP *** [Qs 7h 9h]
schaef.alex: checks
dimetruk: bets 131
schaef.alex: calls 131
*** TURN *** [Qs 7h 9h] [3d]
schaef.alex: checks
dimetruk: checks
*** RIVER *** [Qs 7h 9h 3d] [4s]
schaef.alex: bets 251
dimetruk: folds
Uncalled bet (251) returned to schaef.alex
schaef.alex collected 523 from pot
schaef.alex: doesn't show hand
*** SUMMARY ***
Total pot 523 | Rake 0
Board [Qs 7h 9h 3d 4s]
Seat 1: SheenWinning42 folded before Flop (didn't bet)
Seat 2: mt99808 folded before Flop (didn't bet)
Seat 3: dimetruk folded on the River
Seat 4: Carloss86 (button) folded before Flop (didn't bet)
Seat 5: gupshow (small blind) folded before Flop
Seat 6: schaef.alex (big blind) collected (523)


PokerStars Hand #226595356050: Tournament #3189943627, $13.79+$1.21 USD Hold'em No Limit - Level III (25/50) - 2021/05/09 9:19:15 MSK [2021/05/09 2:19:15 ET]
Table '3189943627 1' 6-max Seat #1 is the button
Seat 1: SheenWinning42 (1671 in chips)
Seat 2: mt99808 (1236 in chips)
Seat 3: dimetruk (703 in chips)
Seat 4: Carloss86 (1521 in chips)
Seat 5: gupshow (2488 in chips)
Seat 6: schaef.alex (1381 in chips)
SheenWinning42: posts the ante 6
mt99808: posts the ante 6
dimetruk: posts the ante 6
Carloss86: posts the ante 6
gupshow: posts the ante 6
schaef.alex: posts the ante 6
mt99808: posts small blind 25
dimetruk: posts big blind 50
*** HOLE CARDS ***
Dealt to dimetruk [Ts Kc]
Carloss86: folds
gupshow: folds
schaef.alex: raises 60 to 110
SheenWinning42: calls 110
mt99808: folds
dimetruk: calls 60
*** FLOP *** [2c 4c Ad]
dimetruk: checks
schaef.alex: bets 125
SheenWinning42: folds
dimetruk: folds
Uncalled bet (125) returned to schaef.alex
schaef.alex collected 391 from pot
schaef.alex: doesn't show hand
*** SUMMARY ***
Total pot 391 | Rake 0
Board [2c 4c Ad]
Seat 1: SheenWinning42 (button) folded on the Flop
Seat 2: mt99808 (small blind) folded before Flop
Seat 3: dimetruk (big blind) folded on the Flop
Seat 4: Carloss86 folded before Flop (didn't bet)
Seat 5: gupshow folded before Flop (didn't bet)
Seat 6: schaef.alex collected (391)


PokerStars Hand #226595430550: Tournament #3189943627, $13.79+$1.21 USD Hold'em No Limit - Level IV (40/80) - 2021/05/09 9:26:20 MSK [2021/05/09 2:26:20 ET]
Table '3189943627 1' 6-max Seat #2 is the button
Seat 2: mt99808 (825 in chips)
Seat 3: dimetruk (700 in chips)
Seat 4: Carloss86 (3513 in chips)
Seat 5: gupshow (2418 in chips)
Seat 6: schaef.alex (1544 in chips)
mt99808: posts the ante 10
dimetruk: posts the ante 10
Carloss86: posts the ante 10
gupshow: posts the ante 10
schaef.alex: posts the ante 10
dimetruk: posts small blind 40
Carloss86: posts big blind 80
*** HOLE CARDS ***
Dealt to dimetruk [9s 9c]
gupshow: folds
schaef.alex: folds
mt99808: raises 160 to 240
dimetruk: raises 450 to 690 and is all-in
Carloss86: folds
mt99808: calls 450
*** FLOP *** [Jd 2d Kc]
*** TURN *** [Jd 2d Kc] [2h]
*** RIVER *** [Jd 2d Kc 2h] [9h]
*** SHOW DOWN ***
dimetruk: shows [9s 9c] (a full house, Nines full of Deuces)
mt99808: shows [6d 6c] (two pair, Sixes and Deuces)
dimetruk collected 1510 from pot
*** SUMMARY ***
Total pot 1510 | Rake 0
Board [Jd 2d Kc 2h 9h]
Seat 2: mt99808 (button) showed [6d 6c] and lost with two pair, Sixes and Deuces
Seat 3: dimetruk (small blind) showed [9s 9c] and won (1510) with a full house, Nines full of Deuces
Seat 4: Carloss86 (big blind) folded before Flop
Seat 5: gupshow folded before Flop (didn't bet)
Seat 6: schaef.alex folded before Flop (didn't bet)


PokerStars Hand #226595445390: Tournament #3189943627, $13.79+$1.21 USD Hold'em No Limit - Level IV (40/80) - 2021/05/09 9:27:45 MSK [2021/05/09 2:27:45 ET]
Table '3189943627 1' 6-max Seat #5 is the button
Seat 3: dimetruk (1650 in chips)
Seat 4: Carloss86 (3648 in chips)
Seat 5: gupshow (2268 in chips)
Seat 6: schaef.alex (1434 in chips)
dimetruk: posts the ante 10
Carloss86: posts the ante 10
gupshow: posts the ante 10
schaef.alex: posts the ante 10
schaef.alex: posts small blind 40
dimetruk: posts big blind 80
*** HOLE CARDS ***
Dealt to dimetruk [9d 5h]
Carloss86: folds
gupshow: calls 80
schaef.alex: folds
dimetruk: checks
*** FLOP *** [Qc Qh 4c]
dimetruk: checks
gupshow: bets 120
dimetruk: folds
Uncalled bet (120) returned to gupshow
gupshow collected 240 from pot
gupshow: doesn't show hand
*** SUMMARY ***
Total pot 240 | Rake 0
Board [Qc Qh 4c]
Seat 3: dimetruk (big blind) folded on the Flop
Seat 4: Carloss86 folded before Flop (didn't bet)
Seat 5: gupshow (button) collected (240)
Seat 6: schaef.alex (small blind) folded before Flop


PokerStars Hand #226595465557: Tournament #3189943627, $13.79+$1.21 USD Hold'em No Limit - Level IV (40/80) - 2021/05/09 9:29:40 MSK [2021/05/09 2:29:40 ET]
Table '3189943627 1' 6-max Seat #5 is the button
Seat 3: dimetruk (1650 in chips)
Seat 4: Carloss86 (3488 in chips)
Seat 5: gupshow (2188 in chips)
Seat 6: schaef.alex (1674 in chips)
dimetruk: posts the ante 10
Carloss86: posts the ante 10
gupshow: posts the ante 10
schaef.alex: posts the ante 10
schaef.alex: posts small blind 40
dimetruk: posts big blind 80
*** HOLE CARDS ***
Dealt to dimetruk [Kh 8s]
Carloss86: folds
gupshow: folds
schaef.alex: raises 96 to 176
dimetruk: calls 96
*** FLOP *** [2c 7s 9s]
schaef.alex: bets 188
dimetruk: folds
Uncalled bet (188) returned to schaef.alex
schaef.alex collected 392 from pot
schaef.alex: doesn't show hand
*** SUMMARY ***
Total pot 392 | Rake 0
Board [2c 7s 9s]
Seat 3: dimetruk (big blind) folded on the Flop
Seat 4: Carloss86 folded before Flop (didn't bet)
Seat 5: gupshow (button) folded before Flop (didn't bet)
Seat 6: schaef.alex (small blind) collected (392)


PokerStars Hand #226595512300: Tournament #3189943627, $13.79+$1.21 USD Hold'em No Limit - Level V (60/120) - 2021/05/09 9:34:07 MSK [2021/05/09 2:34:07 ET]
Table '3189943627 1' 6-max Seat #5 is the button
Seat 3: dimetruk (1624 in chips)
Seat 4: Carloss86 (3578 in chips)
Seat 5: gupshow (1838 in chips)
Seat 6: schaef.alex (1960 in chips)
dimetruk: posts the ante 15
Carloss86: posts the ante 15
gupshow: posts the ante 15
schaef.alex: posts the ante 15
schaef.alex: posts small blind 60
dimetruk: posts big blind 120
*** HOLE CARDS ***
Dealt to dimetruk [Th Ah]
Carloss86: folds
gupshow: folds
schaef.alex: raises 1825 to 1945 and is all-in
dimetruk: calls 1489 and is all-in
Uncalled bet (336) returned to schaef.alex
*** FLOP *** [2c 2h Kh]
*** TURN *** [2c 2h Kh] [7s]
*** RIVER *** [2c 2h Kh 7s] [7h]
*** SHOW DOWN ***
schaef.alex: shows [4h 4d] (two pair, Sevens and Fours)
dimetruk: shows [Th Ah] (a flush, Ace high)
dimetruk collected 3278 from pot
*** SUMMARY ***
Total pot 3278 | Rake 0
Board [2c 2h Kh 7s 7h]
Seat 3: dimetruk (big blind) showed [Th Ah] and won (3278) with a flush, Ace high
Seat 4: Carloss86 folded before Flop (didn't bet)
Seat 5: gupshow (button) folded before Flop (didn't bet)
Seat 6: schaef.alex (small blind) showed [4h 4d] and lost with two pair, Sevens and Fours


PokerStars Hand #226595549971: Tournament #3189943627, $13.79+$1.21 USD Hold'em No Limit - Level V (60/120) - 2021/05/09 9:37:17 MSK [2021/05/09 2:37:17 ET]
Table '3189943627 1' 6-max Seat #4 is the button
Seat 3: dimetruk (2648 in chips)
Seat 4: Carloss86 (2061 in chips)
Seat 5: gupshow (4291 in chips)
dimetruk: posts the ante 15
Carloss86: posts the ante 15
gupshow: posts the ante 15
gupshow: posts small blind 60
dimetruk: posts big blind 120
*** HOLE CARDS ***
Dealt to dimetruk [4s Qs]
Carloss86: folds
gupshow: raises 120 to 240
dimetruk: calls 120
*** FLOP *** [8c 9s 4d]
gupshow: bets 262
dimetruk: calls 262
*** TURN *** [8c 9s 4d] [5d]
gupshow: bets 3774 and is all-in
dimetruk: folds
Uncalled bet (3774) returned to gupshow
gupshow collected 1049 from pot
gupshow: doesn't show hand
*** SUMMARY ***
Total pot 1049 | Rake 0
Board [8c 9s 4d 5d]
Seat 3: dimetruk (big blind) folded on the Turn
Seat 4: Carloss86 (button) folded before Flop (didn't bet)
Seat 5: gupshow (small blind) collected (1049)


PokerStars Hand #226595566878: Tournament #3189943627, $13.79+$1.21 USD Hold'em No Limit - Level V (60/120) - 2021/05/09 9:38:50 MSK [2021/05/09 2:38:50 ET]
Table '3189943627 1' 6-max Seat #4 is the button
Seat 3: dimetruk (1741 in chips)
Seat 4: Carloss86 (2811 in chips)
Seat 5: gupshow (4448 in chips)
dimetruk: posts the ante 15
Carloss86: posts the ante 15
gupshow: posts the ante 15
gupshow: posts small blind 60
dimetruk: posts big blind 120
*** HOLE CARDS ***
Dealt to dimetruk [Jd 5h]
Carloss86: folds
gupshow: calls 60
dimetruk: checks
*** FLOP *** [2c 9h Ts]
gupshow: checks
dimetruk: bets 120
gupshow: calls 120
*** TURN *** [2c 9h Ts] [Kh]
gupshow: checks
dimetruk: bets 263
gupshow: folds
Uncalled bet (263) returned to dimetruk
dimetruk collected 525 from pot
dimetruk: doesn't show hand
*** SUMMARY ***
Total pot 525 | Rake 0
Board [2c 9h Ts Kh]
Seat 3: dimetruk (big blind) collected (525)
Seat 4: Carloss86 (button) folded before Flop (didn't bet)
Seat 5: gupshow (small blind) folded on the Turn


PokerStars Hand #226595587032: Tournament #3189943627, $13.79+$1.21 USD Hold'em No Limit - Level VI (80/160) - 2021/05/09 9:40:42 MSK [2021/05/09 2:40:42 ET]
Table '3189943627 1' 6-max Seat #4 is the button
Seat 3: dimetruk (1981 in chips)
Seat 4: Carloss86 (3381 in chips)
Seat 5: gupshow (3638 in chips)
dimetruk: posts the ante 20
Carloss86: posts the ante 20
gupshow: posts the ante 20
gupshow: posts small blind 80
dimetruk: posts big blind 160
*** HOLE CARDS ***
Dealt to dimetruk [6s 7d]
Carloss86: folds
gupshow: calls 80
dimetruk: checks
*** FLOP *** [3s Jc 4h]
gupshow: checks
dimetruk: checks
*** TURN *** [3s Jc 4h] [Qs]
gupshow: bets 240
dimetruk: folds
Uncalled bet (240) returned to gupshow
gupshow collected 380 from pot
gupshow: doesn't show hand
*** SUMMARY ***
Total pot 380 | Rake 0
Board [3s Jc 4h Qs]
Seat 3: dimetruk (big blind) folded on the Turn
Seat 4: Carloss86 (button) folded before Flop (didn't bet)
Seat 5: gupshow (small blind) collected (380)


PokerStars Hand #226595601069: Tournament #3189943627, $13.79+$1.21 USD Hold'em No Limit - Level VI (80/160) - 2021/05/09 9:41:17 MSK [2021/05/09 2:41:17 ET]
Table '3189943627 1' 6-max Seat #3 is the button
Seat 3: dimetruk (2001 in chips)
Seat 4: Carloss86 (3181 in chips)
Seat 5: gupshow (3818 in chips)
dimetruk: posts the ante 20
Carloss86: posts the ante 20
gupshow: posts the ante 20
Carloss86: posts small blind 80
gupshow: posts big blind 160
*** HOLE CARDS ***
Dealt to dimetruk [Qc Js]
dimetruk: raises 1821 to 1981 and is all-in
Carloss86: folds
gupshow: calls 1821
*** FLOP *** [7s 5c 3s]
*** TURN *** [7s 5c 3s] [As]
*** RIVER *** [7s 5c 3s As] [8s]
*** SHOW DOWN ***
gupshow: shows [Qh Qs] (a flush, Ace high)
dimetruk: shows [Qc Js] (a flush, Ace high - lower cards)
gupshow collected 4102 from pot
dimetruk finished the tournament in 3rd place
*** SUMMARY ***
Total pot 4102 | Rake 0
Board [7s 5c 3s As 8s]
Seat 3: dimetruk (button) showed [Qc Js] and lost with a flush, Ace high
Seat 4: Carloss86 (small blind) folded before Flop
Seat 5: gupshow (big blind) showed [Qh Qs] and won (4102) with a flush, Ace high


PokerStars Hand #226596737645: Tournament #3189961915, $13.70+$1.30 USD Hold'em No Limit - Level I (10/20) - 2021/05/09 11:21:53 MSK [2021/05/09 4:21:53 ET]
Table '3189961915 1' 9-max Seat #4 is the button
Seat 1: Smokineights (1491 in chips)
Seat 2: MinesALager (1481 in chips)
Seat 3: Vandbro (2351 in chips)
Seat 4: nsasak (1351 in chips)
Seat 5: Aryo888 (862 in chips)
Seat 6: dimetruk (1491 in chips)
Seat 7: julinhobrazu (1491 in chips)
Seat 8: Graande24 (1491 in chips)
Seat 9: SlugBob (1491 in chips)
Smokineights: posts the ante 3
MinesALager: posts the ante 3
Vandbro: posts the ante 3
nsasak: posts the ante 3
Aryo888: posts the ante 3
dimetruk: posts the ante 3
julinhobrazu: posts the ante 3
Graande24: posts the ante 3
SlugBob: posts the ante 3
Aryo888: posts small blind 10
dimetruk: posts big blind 20
*** HOLE CARDS ***
Dealt to dimetruk [Jh 8s]
julinhobrazu: folds
Graande24: raises 40 to 60
SlugBob: folds
Smokineights: folds
MinesALager: folds
Vandbro: folds
nsasak: folds
Aryo888: calls 50
dimetruk: calls 40
*** FLOP *** [6c Ts Ks]
Aryo888: checks
dimetruk: checks
Graande24: bets 100
Aryo888: calls 100
dimetruk: folds
*** TURN *** [6c Ts Ks] [4s]
Aryo888: checks
Graande24: bets 100
Aryo888: calls 100
*** RIVER *** [6c Ts Ks 4s] [Qs]
Aryo888: bets 599 and is all-in
Graande24: calls 599
*** SHOW DOWN ***
Aryo888: shows [Qh As] (a flush, Ace high)
Graande24: shows [9h 9s] (a flush, King high)
Aryo888 collected 1805 from pot
*** SUMMARY ***
Total pot 1805 | Rake 0
Board [6c Ts Ks 4s Qs]
Seat 1: Smokineights folded before Flop (didn't bet)
Seat 2: MinesALager folded before Flop (didn't bet)
Seat 3: Vandbro folded before Flop (didn't bet)
Seat 4: nsasak (button) folded before Flop (didn't bet)
Seat 5: Aryo888 (small blind) showed [Qh As] and won (1805) with a flush, Ace high
Seat 6: dimetruk (big blind) folded on the Flop
Seat 7: julinhobrazu folded before Flop (didn't bet)
Seat 8: Graande24 showed [9h 9s] and lost with a flush, King high
Seat 9: SlugBob folded before Flop (didn't bet)


PokerStars Hand #226596877215: Tournament #3189961915, $13.70+$1.30 USD Hold'em No Limit - Level II (15/30) - 2021/05/09 11:33:20 MSK [2021/05/09 4:33:20 ET]
Table '3189961915 1' 9-max Seat #9 is the button
Seat 2: MinesALager (2046 in chips)
Seat 3: Vandbro (3516 in chips)
Seat 4: nsasak (722 in chips)
Seat 5: Aryo888 (2901 in chips)
Seat 6: dimetruk (1336 in chips)
Seat 7: julinhobrazu (2223 in chips)
Seat 9: SlugBob (756 in chips)
MinesALager: posts the ante 4
Vandbro: posts the ante 4
nsasak: posts the ante 4
Aryo888: posts the ante 4
dimetruk: posts the ante 4
julinhobrazu: posts the ante 4
SlugBob: posts the ante 4
MinesALager: posts small blind 15
Vandbro: posts big blind 30
*** HOLE CARDS ***
Dealt to dimetruk [Ks Qh]
nsasak: folds
Aryo888: folds
dimetruk: raises 30 to 60
julinhobrazu: folds
SlugBob: folds
MinesALager: folds
Vandbro: calls 30
*** FLOP *** [Kh Qc 2c]
Vandbro: checks
dimetruk: bets 57
Vandbro: raises 168 to 225
dimetruk: calls 168
*** TURN *** [Kh Qc 2c] [9d]
Vandbro: bets 404
dimetruk: raises 643 to 1047 and is all-in
Vandbro: folds
Uncalled bet (643) returned to dimetruk
dimetruk collected 1421 from pot
dimetruk: doesn't show hand
*** SUMMARY ***
Total pot 1421 | Rake 0
Board [Kh Qc 2c 9d]
Seat 2: MinesALager (small blind) folded before Flop
Seat 3: Vandbro (big blind) folded on the Turn
Seat 4: nsasak folded before Flop (didn't bet)
Seat 5: Aryo888 folded before Flop (didn't bet)
Seat 6: dimetruk collected (1421)
Seat 7: julinhobrazu folded before Flop (didn't bet)
Seat 9: SlugBob (button) folded before Flop (didn't bet)


PokerStars Hand #226596890991: Tournament #3189961915, $13.70+$1.30 USD Hold'em No Limit - Level II (15/30) - 2021/05/09 11:34:28 MSK [2021/05/09 4:34:28 ET]
Table '3189961915 1' 9-max Seat #2 is the button
Seat 2: MinesALager (2027 in chips)
Seat 3: Vandbro (2823 in chips)
Seat 4: nsasak (718 in chips)
Seat 5: Aryo888 (2897 in chips)
Seat 6: dimetruk (2064 in chips)
Seat 7: julinhobrazu (2219 in chips)
Seat 9: SlugBob (752 in chips)
MinesALager: posts the ante 4
Vandbro: posts the ante 4
nsasak: posts the ante 4
Aryo888: posts the ante 4
dimetruk: posts the ante 4
julinhobrazu: posts the ante 4
SlugBob: posts the ante 4
Vandbro: posts small blind 15
nsasak: posts big blind 30
*** HOLE CARDS ***
Dealt to dimetruk [9d 9c]
Aryo888: folds
dimetruk: raises 30 to 60
julinhobrazu: folds
SlugBob: folds
MinesALager: folds
Vandbro: folds
nsasak: calls 30
*** FLOP *** [Th 3s 3h]
nsasak: checks
dimetruk: bets 57
nsasak: calls 57
*** TURN *** [Th 3s 3h] [2s]
nsasak: checks
dimetruk: bets 135
nsasak: calls 135
*** RIVER *** [Th 3s 3h 2s] [3d]
nsasak: checks
dimetruk: checks
*** SHOW DOWN ***
nsasak: shows [5c 4h] (three of a kind, Threes)
dimetruk: shows [9d 9c] (a full house, Threes full of Nines)
dimetruk collected 547 from pot
*** SUMMARY ***
Total pot 547 | Rake 0
Board [Th 3s 3h 2s 3d]
Seat 2: MinesALager (button) folded before Flop (didn't bet)
Seat 3: Vandbro (small blind) folded before Flop
Seat 4: nsasak (big blind) showed [5c 4h] and lost with three of a kind, Threes
Seat 5: Aryo888 folded before Flop (didn't bet)
Seat 6: dimetruk showed [9d 9c] and won (547) with a full house, Threes full of Nines
Seat 7: julinhobrazu folded before Flop (didn't bet)
Seat 9: SlugBob folded before Flop (didn't bet)


PokerStars Hand #226596948768: Tournament #3189961915, $13.70+$1.30 USD Hold'em No Limit - Level II (15/30) - 2021/05/09 11:39:11 MSK [2021/05/09 4:39:11 ET]
Table '3189961915 1' 9-max Seat #2 is the button
Seat 2: MinesALager (2161 in chips)
Seat 3: Vandbro (2750 in chips)
Seat 4: nsasak (423 in chips)
Seat 5: Aryo888 (2741 in chips)
Seat 6: dimetruk (2226 in chips)
Seat 7: julinhobrazu (2077 in chips)
Seat 9: SlugBob (1122 in chips)
MinesALager: posts the ante 4
Vandbro: posts the ante 4
nsasak: posts the ante 4
Aryo888: posts the ante 4
dimetruk: posts the ante 4
julinhobrazu: posts the ante 4
SlugBob: posts the ante 4
Vandbro: posts small blind 15
nsasak: posts big blind 30
*** HOLE CARDS ***
Dealt to dimetruk [Ad 9d]
Aryo888: calls 30
dimetruk: raises 60 to 90
julinhobrazu: folds
SlugBob: folds
MinesALager: calls 90
Vandbro: calls 75
nsasak: calls 60
Aryo888: calls 60
*** FLOP *** [Jc Qs Kc]
Vandbro: checks
nsasak: bets 329 and is all-in
Aryo888: calls 329
dimetruk: folds
MinesALager: folds
Vandbro: calls 329
*** TURN *** [Jc Qs Kc] [Ts]
Vandbro: checks
Aryo888: checks
*** RIVER *** [Jc Qs Kc Ts] [6c]
Vandbro: bets 966
Aryo888: calls 966
*** SHOW DOWN ***
Vandbro: shows [Tc Qc] (a flush, King high)
Aryo888: mucks hand
Vandbro collected 1932 from side pot
nsasak: mucks hand
Vandbro collected 1465 from main pot
nsasak finished the tournament in 7th place
*** SUMMARY ***
Total pot 3397 Main pot 1465. Side pot 1932. | Rake 0
Board [Jc Qs Kc Ts 6c]
Seat 2: MinesALager (button) folded on the Flop
Seat 3: Vandbro (small blind) showed [Tc Qc] and won (3397) with a flush, King high
Seat 4: nsasak (big blind) mucked [Jd Th]
Seat 5: Aryo888 mucked [8c 5c]
Seat 6: dimetruk folded on the Flop
Seat 7: julinhobrazu folded before Flop (didn't bet)
Seat 9: SlugBob folded before Flop (didn't bet)


PokerStars Hand #226596969855: Tournament #3189961915, $13.70+$1.30 USD Hold'em No Limit - Level III (25/50) - 2021/05/09 11:40:53 MSK [2021/05/09 4:40:53 ET]
Table '3189961915 1' 9-max Seat #3 is the button
Seat 2: MinesALager (2067 in chips)
Seat 3: Vandbro (4758 in chips)
Seat 5: Aryo888 (1352 in chips)
Seat 6: dimetruk (2132 in chips)
Seat 7: julinhobrazu (2073 in chips)
Seat 9: SlugBob (1118 in chips)
MinesALager: posts the ante 6
Vandbro: posts the ante 6
Aryo888: posts the ante 6
dimetruk: posts the ante 6
julinhobrazu: posts the ante 6
SlugBob: posts the ante 6
Aryo888: posts small blind 25
dimetruk: posts big blind 50
*** HOLE CARDS ***
Dealt to dimetruk [Jd Kd]
julinhobrazu: folds
SlugBob: folds
MinesALager: folds
Vandbro: raises 50 to 100
Aryo888: calls 75
dimetruk: calls 50
*** FLOP *** [5c 6d Js]
Aryo888: checks
dimetruk: checks
Vandbro: checks
*** TURN *** [5c 6d Js] [Ts]
Aryo888: checks
dimetruk: bets 168
Vandbro: folds
Aryo888: calls 168
*** RIVER *** [5c 6d Js Ts] [Ks]
Aryo888: checks
dimetruk: bets 235
Aryo888: folds
Uncalled bet (235) returned to dimetruk
dimetruk collected 672 from pot
dimetruk: doesn't show hand
*** SUMMARY ***
Total pot 672 | Rake 0
Board [5c 6d Js Ts Ks]
Seat 2: MinesALager folded before Flop (didn't bet)
Seat 3: Vandbro (button) folded on the Turn
Seat 5: Aryo888 (small blind) folded on the River
Seat 6: dimetruk (big blind) collected (672)
Seat 7: julinhobrazu folded before Flop (didn't bet)
Seat 9: SlugBob folded before Flop (didn't bet)


PokerStars Hand #226597024051: Tournament #3189961915, $13.70+$1.30 USD Hold'em No Limit - Level III (25/50) - 2021/05/09 11:45:05 MSK [2021/05/09 4:45:05 ET]
Table '3189961915 1' 9-max Seat #2 is the button
Seat 2: MinesALager (2123 in chips)
Seat 3: Vandbro (4789 in chips)
Seat 5: Aryo888 (1340 in chips)
Seat 6: dimetruk (2481 in chips)
Seat 7: julinhobrazu (1929 in chips)
Seat 9: SlugBob (838 in chips)
MinesALager: posts the ante 6
Vandbro: posts the ante 6
Aryo888: posts the ante 6
dimetruk: posts the ante 6
julinhobrazu: posts the ante 6
SlugBob: posts the ante 6
Vandbro: posts small blind 25
Aryo888: posts big blind 50
*** HOLE CARDS ***
Dealt to dimetruk [As Tc]
dimetruk: raises 50 to 100
julinhobrazu: folds
SlugBob: folds
MinesALager: folds
Vandbro: calls 75
Aryo888: folds
*** FLOP *** [7d 5s 2d]
Vandbro: checks
dimetruk: checks
*** TURN *** [7d 5s 2d] [3d]
Vandbro: checks
dimetruk: checks
*** RIVER *** [7d 5s 2d 3d] [Qc]
Vandbro: checks
dimetruk: checks
*** SHOW DOWN ***
Vandbro: shows [Ts Ad] (high card Ace)
dimetruk: shows [As Tc] (high card Ace)
Vandbro collected 143 from pot
dimetruk collected 143 from pot
*** SUMMARY ***
Total pot 286 | Rake 0
Board [7d 5s 2d 3d Qc]
Seat 2: MinesALager (button) folded before Flop (didn't bet)
Seat 3: Vandbro (small blind) showed [Ts Ad] and won (143) with high card Ace
Seat 5: Aryo888 (big blind) folded before Flop
Seat 6: dimetruk showed [As Tc] and won (143) with high card Ace
Seat 7: julinhobrazu folded before Flop (didn't bet)
Seat 9: SlugBob folded before Flop (didn't bet)


PokerStars Hand #226597038717: Tournament #3189961915, $13.70+$1.30 USD Hold'em No Limit - Level III (25/50) - 2021/05/09 11:46:12 MSK [2021/05/09 4:46:12 ET]
Table '3189961915 1' 9-max Seat #3 is the button
Seat 2: MinesALager (2117 in chips)
Seat 3: Vandbro (4826 in chips)
Seat 5: Aryo888 (1284 in chips)
Seat 6: dimetruk (2518 in chips)
Seat 7: julinhobrazu (1923 in chips)
Seat 9: SlugBob (832 in chips)
MinesALager: posts the ante 6
Vandbro: posts the ante 6
Aryo888: posts the ante 6
dimetruk: posts the ante 6
julinhobrazu: posts the ante 6
SlugBob: posts the ante 6
Aryo888: posts small blind 25
dimetruk: posts big blind 50
*** HOLE CARDS ***
Dealt to dimetruk [Td 9c]
julinhobrazu: raises 65 to 115
SlugBob: folds
MinesALager: folds
Vandbro: folds
Aryo888: folds
dimetruk: calls 65
*** FLOP *** [2c 3d 9h]
dimetruk: checks
julinhobrazu: bets 192
dimetruk: calls 192
*** TURN *** [2c 3d 9h] [Jc]
dimetruk: checks
julinhobrazu: bets 446
dimetruk: folds
Uncalled bet (446) returned to julinhobrazu
julinhobrazu collected 675 from pot
julinhobrazu: doesn't show hand
*** SUMMARY ***
Total pot 675 | Rake 0
Board [2c 3d 9h Jc]
Seat 2: MinesALager folded before Flop (didn't bet)
Seat 3: Vandbro (button) folded before Flop (didn't bet)
Seat 5: Aryo888 (small blind) folded before Flop
Seat 6: dimetruk (big blind) folded on the Turn
Seat 7: julinhobrazu collected (675)
Seat 9: SlugBob folded before Flop (didn't bet)


PokerStars Hand #226597091626: Tournament #3189961915, $13.70+$1.30 USD Hold'em No Limit - Level IV (40/80) - 2021/05/09 11:50:04 MSK [2021/05/09 4:50:04 ET]
Table '3189961915 1' 9-max Seat #3 is the button
Seat 2: MinesALager (2424 in chips)
Seat 3: Vandbro (5143 in chips)
Seat 5: Aryo888 (1094 in chips)
Seat 6: dimetruk (2146 in chips)
Seat 7: julinhobrazu (2176 in chips)
Seat 9: SlugBob (517 in chips)
MinesALager: posts the ante 10
Vandbro: posts the ante 10
Aryo888: posts the ante 10
dimetruk: posts the ante 10
julinhobrazu: posts the ante 10
SlugBob: posts the ante 10
Aryo888: posts small blind 40
dimetruk: posts big blind 80
*** HOLE CARDS ***
Dealt to dimetruk [Jd Ks]
julinhobrazu: folds
SlugBob: raises 427 to 507 and is all-in
MinesALager: folds
Vandbro: folds
Aryo888: folds
dimetruk: calls 427
*** FLOP *** [3c Tc 9h]
*** TURN *** [3c Tc 9h] [Qs]
*** RIVER *** [3c Tc 9h Qs] [2c]
*** SHOW DOWN ***
dimetruk: shows [Jd Ks] (a straight, Nine to King)
SlugBob: shows [Qh Th] (two pair, Queens and Tens)
dimetruk collected 1114 from pot
SlugBob finished the tournament in 6th place
*** SUMMARY ***
Total pot 1114 | Rake 0
Board [3c Tc 9h Qs 2c]
Seat 2: MinesALager folded before Flop (didn't bet)
Seat 3: Vandbro (button) folded before Flop (didn't bet)
Seat 5: Aryo888 (small blind) folded before Flop
Seat 6: dimetruk (big blind) showed [Jd Ks] and won (1114) with a straight, Nine to King
Seat 7: julinhobrazu folded before Flop (didn't bet)
Seat 9: SlugBob showed [Qh Th] and lost with two pair, Queens and Tens


PokerStars Hand #226597098793: Tournament #3189961915, $13.70+$1.30 USD Hold'em No Limit - Level IV (40/80) - 2021/05/09 11:50:37 MSK [2021/05/09 4:50:37 ET]
Table '3189961915 1' 9-max Seat #5 is the button
Seat 2: MinesALager (2414 in chips)
Seat 3: Vandbro (5133 in chips)
Seat 5: Aryo888 (1044 in chips)
Seat 6: dimetruk (2743 in chips)
Seat 7: julinhobrazu (2166 in chips)
MinesALager: posts the ante 10
Vandbro: posts the ante 10
Aryo888: posts the ante 10
dimetruk: posts the ante 10
julinhobrazu: posts the ante 10
dimetruk: posts small blind 40
julinhobrazu: posts big blind 80
*** HOLE CARDS ***
Dealt to dimetruk [8h 7h]
MinesALager: folds
Vandbro: folds
Aryo888: calls 80
dimetruk: calls 40
julinhobrazu: checks
*** FLOP *** [2d As Th]
dimetruk: checks
julinhobrazu: checks
Aryo888: checks
*** TURN *** [2d As Th] [4d]
dimetruk: checks
julinhobrazu: bets 87
Aryo888: calls 87
dimetruk: folds
*** RIVER *** [2d As Th 4d] [Ad]
julinhobrazu: bets 320
Aryo888: raises 547 to 867 and is all-in
julinhobrazu: folds
Uncalled bet (547) returned to Aryo888
Aryo888 collected 1104 from pot
Aryo888: doesn't show hand
*** SUMMARY ***
Total pot 1104 | Rake 0
Board [2d As Th 4d Ad]
Seat 2: MinesALager folded before Flop (didn't bet)
Seat 3: Vandbro folded before Flop (didn't bet)
Seat 5: Aryo888 (button) collected (1104)
Seat 6: dimetruk (small blind) folded on the Turn
Seat 7: julinhobrazu (big blind) folded on the River


PokerStars Hand #226597116894: Tournament #3189961915, $13.70+$1.30 USD Hold'em No Limit - Level IV (40/80) - 2021/05/09 11:51:58 MSK [2021/05/09 4:51:58 ET]
Table '3189961915 1' 9-max Seat #7 is the button
Seat 2: MinesALager (2314 in chips)
Seat 3: Vandbro (5113 in chips)
Seat 5: Aryo888 (1641 in chips)
Seat 6: dimetruk (2643 in chips)
Seat 7: julinhobrazu (1789 in chips)
MinesALager: posts the ante 10
Vandbro: posts the ante 10
Aryo888: posts the ante 10
dimetruk: posts the ante 10
julinhobrazu: posts the ante 10
MinesALager: posts small blind 40
Vandbro: posts big blind 80
*** HOLE CARDS ***
Dealt to dimetruk [7d Ad]
Aryo888: folds
dimetruk: raises 80 to 160
julinhobrazu: calls 160
MinesALager: folds
Vandbro: folds
*** FLOP *** [3h 2c Kd]
dimetruk: bets 172
julinhobrazu: calls 172
*** TURN *** [3h 2c Kd] [Ac]
dimetruk: bets 292
julinhobrazu: calls 292
*** RIVER *** [3h 2c Kd Ac] [5h]
dimetruk: checks
julinhobrazu: bets 1155 and is all-in
dimetruk: folds
Uncalled bet (1155) returned to julinhobrazu
julinhobrazu collected 1418 from pot
*** SUMMARY ***
Total pot 1418 | Rake 0
Board [3h 2c Kd Ac 5h]
Seat 2: MinesALager (small blind) folded before Flop
Seat 3: Vandbro (big blind) folded before Flop
Seat 5: Aryo888 folded before Flop (didn't bet)
Seat 6: dimetruk folded on the River
Seat 7: julinhobrazu (button) collected (1418)


PokerStars Hand #226597161504: Tournament #3189961915, $13.70+$1.30 USD Hold'em No Limit - Level IV (40/80) - 2021/05/09 11:55:20 MSK [2021/05/09 4:55:20 ET]
Table '3189961915 1' 9-max Seat #6 is the button
Seat 2: MinesALager (2234 in chips)
Seat 3: Vandbro (5753 in chips)
Seat 5: Aryo888 (1835 in chips)
Seat 6: dimetruk (1859 in chips)
Seat 7: julinhobrazu (1819 in chips)
MinesALager: posts the ante 10
Vandbro: posts the ante 10
Aryo888: posts the ante 10
dimetruk: posts the ante 10
julinhobrazu: posts the ante 10
julinhobrazu: posts small blind 40
MinesALager: posts big blind 80
*** HOLE CARDS ***
Dealt to dimetruk [9c 7h]
Vandbro: folds
Aryo888: folds
dimetruk: raises 80 to 160
julinhobrazu: folds
MinesALager: calls 80
*** FLOP *** [Ks 5h 5d]
MinesALager: checks
dimetruk: checks
*** TURN *** [Ks 5h 5d] [Ah]
MinesALager: checks
dimetruk: bets 144
MinesALager: folds
Uncalled bet (144) returned to dimetruk
dimetruk collected 410 from pot
dimetruk: doesn't show hand
*** SUMMARY ***
Total pot 410 | Rake 0
Board [Ks 5h 5d Ah]
Seat 2: MinesALager (big blind) folded on the Turn
Seat 3: Vandbro folded before Flop (didn't bet)
Seat 5: Aryo888 folded before Flop (didn't bet)
Seat 6: dimetruk (button) collected (410)
Seat 7: julinhobrazu (small blind) folded before Flop


PokerStars Hand #226597193666: Tournament #3189961915, $13.70+$1.30 USD Hold'em No Limit - Level IV (40/80) - 2021/05/09 11:58:11 MSK [2021/05/09 4:58:11 ET]
Table '3189961915 1' 9-max Seat #6 is the button
Seat 2: MinesALager (2354 in chips)
Seat 3: Vandbro (5473 in chips)
Seat 5: Aryo888 (1585 in chips)
Seat 6: dimetruk (2149 in chips)
Seat 7: julinhobrazu (1939 in chips)
MinesALager: posts the ante 10
Vandbro: posts the ante 10
Aryo888: posts the ante 10
dimetruk: posts the ante 10
julinhobrazu: posts the ante 10
julinhobrazu: posts small blind 40
MinesALager: posts big blind 80
*** HOLE CARDS ***
Dealt to dimetruk [Ad Ah]
Vandbro: folds
Aryo888: folds
dimetruk: raises 80 to 160
julinhobrazu: raises 1769 to 1929 and is all-in
MinesALager: folds
dimetruk: calls 1769
*** FLOP *** [4d 3s 8d]
*** TURN *** [4d 3s 8d] [7c]
*** RIVER *** [4d 3s 8d 7c] [6h]
*** SHOW DOWN ***
julinhobrazu: shows [4c As] (a pair of Fours)
dimetruk: shows [Ad Ah] (a pair of Aces)
dimetruk collected 3988 from pot
julinhobrazu finished the tournament in 5th place
*** SUMMARY ***
Total pot 3988 | Rake 0
Board [4d 3s 8d 7c 6h]
Seat 2: MinesALager (big blind) folded before Flop
Seat 3: Vandbro folded before Flop (didn't bet)
Seat 5: Aryo888 folded before Flop (didn't bet)
Seat 6: dimetruk (button) showed [Ad Ah] and won (3988) with a pair of Aces
Seat 7: julinhobrazu (small blind) showed [4c As] and lost with a pair of Fours


PokerStars Hand #226597236906: Tournament #3189961915, $13.70+$1.30 USD Hold'em No Limit - Level V (60/120) - 2021/05/09 12:01:47 MSK [2021/05/09 5:01:47 ET]
Table '3189961915 1' 9-max Seat #2 is the button
Seat 2: MinesALager (1809 in chips)
Seat 3: Vandbro (8343 in chips)
Seat 6: dimetruk (3348 in chips)
MinesALager: posts the ante 15
Vandbro: posts the ante 15
dimetruk: posts the ante 15
Vandbro: posts small blind 60
dimetruk: posts big blind 120
*** HOLE CARDS ***
Dealt to dimetruk [Ad 7d]
MinesALager: raises 120 to 240
Vandbro: folds
dimetruk: calls 120
*** FLOP *** [6d Ah Qs]
dimetruk: checks
MinesALager: bets 1554 and is all-in
dimetruk: calls 1554
*** TURN *** [6d Ah Qs] [9d]
*** RIVER *** [6d Ah Qs 9d] [8h]
*** SHOW DOWN ***
dimetruk: shows [Ad 7d] (a pair of Aces)
MinesALager: shows [Th Qd] (a pair of Queens)
dimetruk collected 3693 from pot
MinesALager finished the tournament in 3rd place and received $24.66.
*** SUMMARY ***
Total pot 3693 | Rake 0
Board [6d Ah Qs 9d 8h]
Seat 2: MinesALager (button) showed [Th Qd] and lost with a pair of Queens
Seat 3: Vandbro (small blind) folded before Flop
Seat 6: dimetruk (big blind) showed [Ad 7d] and won (3693) with a pair of Aces


PokerStars Hand #226597248714: Tournament #3189961915, $13.70+$1.30 USD Hold'em No Limit - Level V (60/120) - 2021/05/09 12:02:39 MSK [2021/05/09 5:02:39 ET]
Table '3189961915 1' 9-max Seat #3 is the button
Seat 3: Vandbro (8403 in chips)
Seat 6: dimetruk (5097 in chips)
Vandbro: posts the ante 15
dimetruk: posts the ante 15
Vandbro: posts small blind 60
dimetruk: posts big blind 120
*** HOLE CARDS ***
Dealt to dimetruk [4d Ts]
Vandbro: calls 60
dimetruk: checks
*** FLOP *** [3c 3d 2c]
dimetruk: checks
Vandbro: checks
*** TURN *** [3c 3d 2c] [Jd]
dimetruk: checks
Vandbro: bets 151
dimetruk: folds
Uncalled bet (151) returned to Vandbro
Vandbro collected 270 from pot
Vandbro: doesn't show hand
*** SUMMARY ***
Total pot 270 | Rake 0
Board [3c 3d 2c Jd]
Seat 3: Vandbro (button) (small blind) collected (270)
Seat 6: dimetruk (big blind) folded on the Turn


PokerStars Hand #226597255781: Tournament #3189961915, $13.70+$1.30 USD Hold'em No Limit - Level V (60/120) - 2021/05/09 12:03:11 MSK [2021/05/09 5:03:11 ET]
Table '3189961915 1' 9-max Seat #3 is the button
Seat 3: Vandbro (8613 in chips)
Seat 6: dimetruk (4887 in chips)
Vandbro: posts the ante 15
dimetruk: posts the ante 15
Vandbro: posts small blind 60
dimetruk: posts big blind 120
*** HOLE CARDS ***
Dealt to dimetruk [Kc Kd]
Vandbro: calls 60
dimetruk: raises 270 to 390
Vandbro: calls 270
*** FLOP *** [2h 3h As]
dimetruk: checks
Vandbro: checks
*** TURN *** [2h 3h As] [8c]
dimetruk: bets 284
Vandbro: folds
Uncalled bet (284) returned to dimetruk
dimetruk collected 810 from pot
dimetruk: doesn't show hand
*** SUMMARY ***
Total pot 810 | Rake 0
Board [2h 3h As 8c]
Seat 3: Vandbro (button) (small blind) folded on the Turn
Seat 6: dimetruk (big blind) collected (810)


PokerStars Hand #226597267404: Tournament #3189961915, $13.70+$1.30 USD Hold'em No Limit - Level V (60/120) - 2021/05/09 12:04:02 MSK [2021/05/09 5:04:02 ET]
Table '3189961915 1' 9-max Seat #3 is the button
Seat 3: Vandbro (8283 in chips)
Seat 6: dimetruk (5217 in chips)
Vandbro: posts the ante 15
dimetruk: posts the ante 15
Vandbro: posts small blind 60
dimetruk: posts big blind 120
*** HOLE CARDS ***
Dealt to dimetruk [2d 2s]
Vandbro: raises 120 to 240
dimetruk: calls 120
*** FLOP *** [6h Qh 5c]
dimetruk: checks
Vandbro: bets 120
dimetruk: calls 120
*** TURN *** [6h Qh 5c] [5d]
dimetruk: checks
Vandbro: checks
*** RIVER *** [6h Qh 5c 5d] [Kd]
dimetruk: checks
Vandbro: checks
*** SHOW DOWN ***
dimetruk: shows [2d 2s] (two pair, Fives and Deuces)
Vandbro: mucks hand
dimetruk collected 750 from pot
*** SUMMARY ***
Total pot 750 | Rake 0
Board [6h Qh 5c 5d Kd]
Seat 3: Vandbro (button) (small blind) mucked [Jh Ad]
Seat 6: dimetruk (big blind) showed [2d 2s] and won (750) with two pair, Fives and Deuces


PokerStars Hand #226597279121: Tournament #3189961915, $13.70+$1.30 USD Hold'em No Limit - Level V (60/120) - 2021/05/09 12:04:54 MSK [2021/05/09 5:04:54 ET]
Table '3189961915 1' 9-max Seat #6 is the button
Seat 3: Vandbro (7908 in chips)
Seat 6: dimetruk (5592 in chips)
Vandbro: posts the ante 15
dimetruk: posts the ante 15
dimetruk: posts small blind 60
Vandbro: posts big blind 120
*** HOLE CARDS ***
Dealt to dimetruk [Kd Ad]
dimetruk: raises 120 to 240
Vandbro: raises 660 to 900
dimetruk: raises 4677 to 5577 and is all-in
Vandbro: calls 4677
*** FLOP *** [4c Th Qc]
*** TURN *** [4c Th Qc] [Qd]
*** RIVER *** [4c Th Qc Qd] [Ks]
*** SHOW DOWN ***
Vandbro: shows [As Jh] (a straight, Ten to Ace)
dimetruk: shows [Kd Ad] (two pair, Kings and Queens)
Vandbro collected 11184 from pot
dimetruk finished the tournament in 2nd place and received $36.99.
Vandbro wins the tournament and receives $61.65 - congratulations!
*** SUMMARY ***
Total pot 11184 | Rake 0
Board [4c Th Qc Qd Ks]
Seat 3: Vandbro (big blind) showed [As Jh] and won (11184) with a straight, Ten to Ace
Seat 6: dimetruk (button) (small blind) showed [Kd Ad] and lost with two pair, Kings and Queens


PokerStars Hand #226611732422: Tournament #3190268420, $13.70+$1.30 USD Hold'em No Limit - Level I (10/20) - 2021/05/09 22:13:48 MSK [2021/05/09 15:13:48 ET]
Table '3190268420 2' 9-max Seat #5 is the button
Seat 1: trandan72 (1642 in chips)
Seat 2: DER_KAISER77777 (1458 in chips)
Seat 3: FuSchi8082 (1308 in chips)
Seat 4: obhavee23 (1759 in chips)
Seat 5: Wilq8309 (1244 in chips)
Seat 6: Smiggeroo7 (1565 in chips)
Seat 7: dimetruk (1488 in chips)
Seat 8: tonibosi29 (1251 in chips)
Seat 9: gorillasalad (1785 in chips)
trandan72: posts the ante 3
DER_KAISER77777: posts the ante 3
FuSchi8082: posts the ante 3
obhavee23: posts the ante 3
Wilq8309: posts the ante 3
Smiggeroo7: posts the ante 3
dimetruk: posts the ante 3
tonibosi29: posts the ante 3
gorillasalad: posts the ante 3
Smiggeroo7: posts small blind 10
dimetruk: posts big blind 20
*** HOLE CARDS ***
Dealt to dimetruk [5c 8h]
tonibosi29: folds
gorillasalad: folds
trandan72: folds
DER_KAISER77777: calls 20
FuSchi8082: calls 20
obhavee23: folds
Wilq8309: calls 20
Smiggeroo7: folds
dimetruk: checks
*** FLOP *** [Kd Ks 5h]
dimetruk: checks
DER_KAISER77777: checks
FuSchi8082: checks
Wilq8309: bets 59
dimetruk: folds
DER_KAISER77777: folds
FuSchi8082: folds
Uncalled bet (59) returned to Wilq8309
Wilq8309 collected 117 from pot
Wilq8309: doesn't show hand
*** SUMMARY ***
Total pot 117 | Rake 0
Board [Kd Ks 5h]
Seat 1: trandan72 folded before Flop (didn't bet)
Seat 2: DER_KAISER77777 folded on the Flop
Seat 3: FuSchi8082 folded on the Flop
Seat 4: obhavee23 folded before Flop (didn't bet)
Seat 5: Wilq8309 (button) collected (117)
Seat 6: Smiggeroo7 (small blind) folded before Flop
Seat 7: dimetruk (big blind) folded on the Flop
Seat 8: tonibosi29 folded before Flop (didn't bet)
Seat 9: gorillasalad folded before Flop (didn't bet)


PokerStars Hand #226612252094: Tournament #3190268420, $13.70+$1.30 USD Hold'em No Limit - Level II (15/30) - 2021/05/09 22:26:57 MSK [2021/05/09 15:26:57 ET]
Table '3190268420 2' 9-max Seat #6 is the button
Seat 1: trandan72 (1491 in chips)
Seat 2: DER_KAISER77777 (831 in chips)
Seat 3: FuSchi8082 (1198 in chips)
Seat 4: obhavee23 (581 in chips)
Seat 5: Wilq8309 (2502 in chips)
Seat 6: Smiggeroo7 (1953 in chips)
Seat 7: dimetruk (1391 in chips)
Seat 8: tonibosi29 (1184 in chips)
Seat 9: gorillasalad (2369 in chips)
trandan72: posts the ante 4
DER_KAISER77777: posts the ante 4
FuSchi8082: posts the ante 4
obhavee23: posts the ante 4
Wilq8309: posts the ante 4
Smiggeroo7: posts the ante 4
dimetruk: posts the ante 4
tonibosi29: posts the ante 4
gorillasalad: posts the ante 4
dimetruk: posts small blind 15
tonibosi29: posts big blind 30
*** HOLE CARDS ***
Dealt to dimetruk [9h Js]
gorillasalad: folds
trandan72: folds
DER_KAISER77777: folds
FuSchi8082: calls 30
obhavee23: folds
Wilq8309: calls 30
Smiggeroo7: calls 30
dimetruk: calls 15
tonibosi29: checks
*** FLOP *** [Td Ks 4d]
dimetruk: checks
tonibosi29: checks
FuSchi8082: bets 90
Wilq8309: folds
Smiggeroo7: folds
dimetruk: folds
tonibosi29: folds
Uncalled bet (90) returned to FuSchi8082
FuSchi8082 collected 186 from pot
FuSchi8082: doesn't show hand
*** SUMMARY ***
Total pot 186 | Rake 0
Board [Td Ks 4d]
Seat 1: trandan72 folded before Flop (didn't bet)
Seat 2: DER_KAISER77777 folded before Flop (didn't bet)
Seat 3: FuSchi8082 collected (186)
Seat 4: obhavee23 folded before Flop (didn't bet)
Seat 5: Wilq8309 folded on the Flop
Seat 6: Smiggeroo7 (button) folded on the Flop
Seat 7: dimetruk (small blind) folded on the Flop
Seat 8: tonibosi29 (big blind) folded on the Flop
Seat 9: gorillasalad folded before Flop (didn't bet)


PokerStars Hand #226612338029: Tournament #3190268420, $13.70+$1.30 USD Hold'em No Limit - Level III (25/50) - 2021/05/09 22:29:11 MSK [2021/05/09 15:29:11 ET]
Table '3190268420 2' 9-max Seat #8 is the button
Seat 1: trandan72 (1481 in chips)
Seat 2: DER_KAISER77777 (771 in chips)
Seat 3: FuSchi8082 (1344 in chips)
Seat 4: obhavee23 (750 in chips)
Seat 5: Wilq8309 (2462 in chips)
Seat 6: Smiggeroo7 (1913 in chips)
Seat 7: dimetruk (1351 in chips)
Seat 8: tonibosi29 (1119 in chips)
Seat 9: gorillasalad (2309 in chips)
trandan72: posts the ante 6
DER_KAISER77777: posts the ante 6
FuSchi8082: posts the ante 6
obhavee23: posts the ante 6
Wilq8309: posts the ante 6
Smiggeroo7: posts the ante 6
dimetruk: posts the ante 6
tonibosi29: posts the ante 6
gorillasalad: posts the ante 6
gorillasalad: posts small blind 25
trandan72: posts big blind 50
*** HOLE CARDS ***
Dealt to dimetruk [Ac Qd]
DER_KAISER77777: folds
FuSchi8082: folds
obhavee23: folds
Wilq8309: folds
Smiggeroo7: folds
dimetruk: raises 50 to 100
tonibosi29: folds
gorillasalad: folds
trandan72: calls 50
*** FLOP *** [Qh 5c 5s]
trandan72: checks
dimetruk: bets 140
trandan72: calls 140
*** TURN *** [Qh 5c 5s] [Th]
trandan72: checks
dimetruk: checks
*** RIVER *** [Qh 5c 5s Th] [Tc]
trandan72: checks
dimetruk: bets 280
trandan72: calls 280
*** SHOW DOWN ***
dimetruk: shows [Ac Qd] (two pair, Queens and Tens)
trandan72: mucks hand
dimetruk collected 1119 from pot
*** SUMMARY ***
Total pot 1119 | Rake 0
Board [Qh 5c 5s Th Tc]
Seat 1: trandan72 (big blind) mucked [Ah Jh]
Seat 2: DER_KAISER77777 folded before Flop (didn't bet)
Seat 3: FuSchi8082 folded before Flop (didn't bet)
Seat 4: obhavee23 folded before Flop (didn't bet)
Seat 5: Wilq8309 folded before Flop (didn't bet)
Seat 6: Smiggeroo7 folded before Flop (didn't bet)
Seat 7: dimetruk showed [Ac Qd] and won (1119) with two pair, Queens and Tens
Seat 8: tonibosi29 (button) folded before Flop (didn't bet)
Seat 9: gorillasalad (small blind) folded before Flop


PokerStars Hand #226612464600: Tournament #3190268420, $13.70+$1.30 USD Hold'em No Limit - Level III (25/50) - 2021/05/09 22:32:24 MSK [2021/05/09 15:32:24 ET]
Table '3190268420 2' 9-max Seat #2 is the button
Seat 1: trandan72 (918 in chips)
Seat 2: DER_KAISER77777 (678 in chips)
Seat 3: FuSchi8082 (1455 in chips)
Seat 4: obhavee23 (861 in chips)
Seat 5: Wilq8309 (2444 in chips)
Seat 6: Smiggeroo7 (1845 in chips)
Seat 7: dimetruk (1932 in chips)
Seat 8: tonibosi29 (1101 in chips)
Seat 9: gorillasalad (2266 in chips)
trandan72: posts the ante 6
DER_KAISER77777: posts the ante 6
FuSchi8082: posts the ante 6
obhavee23: posts the ante 6
Wilq8309: posts the ante 6
Smiggeroo7: posts the ante 6
dimetruk: posts the ante 6
tonibosi29: posts the ante 6
gorillasalad: posts the ante 6
FuSchi8082: posts small blind 25
obhavee23: posts big blind 50
*** HOLE CARDS ***
Dealt to dimetruk [3c 3d]
Wilq8309: calls 50
Smiggeroo7: folds
dimetruk: raises 75 to 125
tonibosi29: folds
gorillasalad: calls 125
trandan72: folds
DER_KAISER77777: folds
FuSchi8082: folds
obhavee23: folds
Wilq8309: calls 75
*** FLOP *** [Ts 3h 5c]
Wilq8309: checks
dimetruk: bets 176
gorillasalad: raises 856 to 1032
Wilq8309: folds
dimetruk: raises 769 to 1801 and is all-in
gorillasalad: calls 769
*** TURN *** [Ts 3h 5c] [5s]
*** RIVER *** [Ts 3h 5c 5s] [Qd]
*** SHOW DOWN ***
dimetruk: shows [3c 3d] (a full house, Threes full of Fives)
gorillasalad: shows [2c 2h] (two pair, Fives and Deuces)
dimetruk collected 4106 from pot
*** SUMMARY ***
Total pot 4106 | Rake 0
Board [Ts 3h 5c 5s Qd]
Seat 1: trandan72 folded before Flop (didn't bet)
Seat 2: DER_KAISER77777 (button) folded before Flop (didn't bet)
Seat 3: FuSchi8082 (small blind) folded before Flop
Seat 4: obhavee23 (big blind) folded before Flop
Seat 5: Wilq8309 folded on the Flop
Seat 6: Smiggeroo7 folded before Flop (didn't bet)
Seat 7: dimetruk showed [3c 3d] and won (4106) with a full house, Threes full of Fives
Seat 8: tonibosi29 folded before Flop (didn't bet)
Seat 9: gorillasalad showed [2c 2h] and lost with two pair, Fives and Deuces


PokerStars Hand #226612620605: Tournament #3190268420, $13.70+$1.30 USD Hold'em No Limit - Level III (25/50) - 2021/05/09 22:36:21 MSK [2021/05/09 15:36:21 ET]
Table '3190268420 2' 9-max Seat #6 is the button
Seat 1: trandan72 (894 in chips)
Seat 2: DER_KAISER77777 (654 in chips)
Seat 3: FuSchi8082 (1406 in chips)
Seat 4: obhavee23 (1008 in chips)
Seat 5: Wilq8309 (2220 in chips)
Seat 6: Smiggeroo7 (3280 in chips)
Seat 7: dimetruk (4038 in chips)
trandan72: posts the ante 6
DER_KAISER77777: posts the ante 6
FuSchi8082: posts the ante 6
obhavee23: posts the ante 6
Wilq8309: posts the ante 6
Smiggeroo7: posts the ante 6
dimetruk: posts the ante 6
dimetruk: posts small blind 25
trandan72: posts big blind 50
*** HOLE CARDS ***
Dealt to dimetruk [Ks 2s]
DER_KAISER77777: folds
FuSchi8082: calls 50
obhavee23: folds
Wilq8309: folds
Smiggeroo7: calls 50
dimetruk: calls 25
trandan72: checks
*** FLOP *** [5h 6h Td]
dimetruk: checks
trandan72: bets 838 and is all-in
FuSchi8082: folds
Smiggeroo7: calls 838
dimetruk: folds
*** TURN *** [5h 6h Td] [3h]
*** RIVER *** [5h 6h Td 3h] [5d]
*** SHOW DOWN ***
trandan72: shows [6s Ts] (two pair, Tens and Sixes)
Smiggeroo7: shows [Qh Jh] (a flush, Queen high)
Smiggeroo7 collected 1918 from pot
trandan72 finished the tournament in 15th place
*** SUMMARY ***
Total pot 1918 | Rake 0
Board [5h 6h Td 3h 5d]
Seat 1: trandan72 (big blind) showed [6s Ts] and lost with two pair, Tens and Sixes
Seat 2: DER_KAISER77777 folded before Flop (didn't bet)
Seat 3: FuSchi8082 folded on the Flop
Seat 4: obhavee23 folded before Flop (didn't bet)
Seat 5: Wilq8309 folded before Flop (didn't bet)
Seat 6: Smiggeroo7 (button) showed [Qh Jh] and won (1918) with a flush, Queen high
Seat 7: dimetruk (small blind) folded on the Flop


PokerStars Hand #226612653776: Tournament #3190268420, $13.70+$1.30 USD Hold'em No Limit - Level III (25/50) - 2021/05/09 22:37:11 MSK [2021/05/09 15:37:11 ET]
Table '3190268420 2' 9-max Seat #7 is the button
Seat 2: DER_KAISER77777 (648 in chips)
Seat 3: FuSchi8082 (1350 in chips)
Seat 4: obhavee23 (1002 in chips)
Seat 5: Wilq8309 (2214 in chips)
Seat 6: Smiggeroo7 (4304 in chips)
Seat 7: dimetruk (3982 in chips)
DER_KAISER77777: posts the ante 6
FuSchi8082: posts the ante 6
obhavee23: posts the ante 6
Wilq8309: posts the ante 6
Smiggeroo7: posts the ante 6
dimetruk: posts the ante 6
DER_KAISER77777: posts small blind 25
FuSchi8082: posts big blind 50
*** HOLE CARDS ***
Dealt to dimetruk [Kd Qh]
obhavee23: folds
Wilq8309: folds
Smiggeroo7: folds
dimetruk: raises 50 to 100
DER_KAISER77777: calls 75
FuSchi8082: folds
*** FLOP *** [As 3h 7h]
DER_KAISER77777: checks
dimetruk: bets 100
DER_KAISER77777: folds
Uncalled bet (100) returned to dimetruk
dimetruk collected 286 from pot
dimetruk: doesn't show hand
*** SUMMARY ***
Total pot 286 | Rake 0
Board [As 3h 7h]
Seat 2: DER_KAISER77777 (small blind) folded on the Flop
Seat 3: FuSchi8082 (big blind) folded before Flop
Seat 4: obhavee23 folded before Flop (didn't bet)
Seat 5: Wilq8309 folded before Flop (didn't bet)
Seat 6: Smiggeroo7 folded before Flop (didn't bet)
Seat 7: dimetruk (button) collected (286)


PokerStars Hand #226612842550: Tournament #3190268420, $13.70+$1.30 USD Hold'em No Limit - Level IV (40/80) - 2021/05/09 22:41:53 MSK [2021/05/09 15:41:53 ET]
Table '3190268420 2' 9-max Seat #5 is the button
Seat 1: Kybosh67 (1842 in chips)
Seat 2: DER_KAISER77777 (712 in chips)
Seat 4: obhavee23 (1172 in chips)
Seat 5: Wilq8309 (2467 in chips)
Seat 6: Smiggeroo7 (3821 in chips)
Seat 7: dimetruk (4136 in chips)
Kybosh67: posts the ante 10
DER_KAISER77777: posts the ante 10
obhavee23: posts the ante 10
Wilq8309: posts the ante 10
Smiggeroo7: posts the ante 10
dimetruk: posts the ante 10
Smiggeroo7: posts small blind 40
dimetruk: posts big blind 80
*** HOLE CARDS ***
Dealt to dimetruk [4s Td]
Kybosh67: folds
DER_KAISER77777: raises 80 to 160
obhavee23: folds
Wilq8309: calls 160
Smiggeroo7: calls 120
dimetruk: calls 80
*** FLOP *** [2s 8s Ks]
Smiggeroo7: checks
dimetruk: checks
DER_KAISER77777: checks
Wilq8309: bets 350
Smiggeroo7: raises 3301 to 3651 and is all-in
dimetruk: folds
DER_KAISER77777: folds
Wilq8309: folds
Uncalled bet (3301) returned to Smiggeroo7
Smiggeroo7 collected 1400 from pot
*** SUMMARY ***
Total pot 1400 | Rake 0
Board [2s 8s Ks]
Seat 1: Kybosh67 folded before Flop (didn't bet)
Seat 2: DER_KAISER77777 folded on the Flop
Seat 4: obhavee23 folded before Flop (didn't bet)
Seat 5: Wilq8309 (button) folded on the Flop
Seat 6: Smiggeroo7 (small blind) collected (1400)
Seat 7: dimetruk (big blind) folded on the Flop


PokerStars Hand #226613023086: Tournament #3190268420, $13.70+$1.30 USD Hold'em No Limit - Level IV (40/80) - 2021/05/09 22:46:21 MSK [2021/05/09 15:46:21 ET]
Table '3190268420 2' 9-max Seat #6 is the button
Seat 1: Kybosh67 (1862 in chips)
Seat 2: DER_KAISER77777 (642 in chips)
Seat 4: obhavee23 (2714 in chips)
Seat 5: Wilq8309 (2037 in chips)
Seat 6: Smiggeroo7 (3149 in chips)
Seat 7: dimetruk (3746 in chips)
Kybosh67: posts the ante 10
DER_KAISER77777: posts the ante 10
obhavee23: posts the ante 10
Wilq8309: posts the ante 10
Smiggeroo7: posts the ante 10
dimetruk: posts the ante 10
dimetruk: posts small blind 40
Kybosh67: posts big blind 80
*** HOLE CARDS ***
Dealt to dimetruk [Ad Ah]
DER_KAISER77777: folds
obhavee23: folds
Wilq8309: folds
Smiggeroo7 has timed out
Smiggeroo7: folds
Smiggeroo7 is sitting out
dimetruk: raises 80 to 160
Kybosh67: calls 80
*** FLOP *** [7h Ac 7c]
dimetruk: checks
Kybosh67: checks
*** TURN *** [7h Ac 7c] [2h]
dimetruk: bets 133
Kybosh67: calls 133
*** RIVER *** [7h Ac 7c 2h] [Kd]
dimetruk: bets 226
Kybosh67: folds
Uncalled bet (226) returned to dimetruk
dimetruk collected 646 from pot
dimetruk: doesn't show hand
*** SUMMARY ***
Total pot 646 | Rake 0
Board [7h Ac 7c 2h Kd]
Seat 1: Kybosh67 (big blind) folded on the River
Seat 2: DER_KAISER77777 folded before Flop (didn't bet)
Seat 4: obhavee23 folded before Flop (didn't bet)
Seat 5: Wilq8309 folded before Flop (didn't bet)
Seat 6: Smiggeroo7 (button) folded before Flop (didn't bet)
Seat 7: dimetruk (small blind) collected (646)


PokerStars Hand #226613111823: Tournament #3190268420, $13.70+$1.30 USD Hold'em No Limit - Level V (60/120) - 2021/05/09 22:48:26 MSK [2021/05/09 15:48:26 ET]
Table '3190268420 2' 9-max Seat #1 is the button
Seat 1: Kybosh67 (1509 in chips)
Seat 2: DER_KAISER77777 (462 in chips)
Seat 5: Wilq8309 (2017 in chips)
Seat 6: Smiggeroo7 (3129 in chips)
Seat 7: dimetruk (4079 in chips)
Kybosh67: posts the ante 15
DER_KAISER77777: posts the ante 15
Wilq8309: posts the ante 15
Smiggeroo7: posts the ante 15
dimetruk: posts the ante 15
DER_KAISER77777: posts small blind 60
Wilq8309: posts big blind 120
*** HOLE CARDS ***
Dealt to dimetruk [Qc Tc]
Smiggeroo7: folds
dimetruk: raises 120 to 240
Kybosh67: calls 240
DER_KAISER77777: folds
Wilq8309: folds
*** FLOP *** [6h As Jd]
dimetruk: bets 180
Kybosh67: calls 180
*** TURN *** [6h As Jd] [3d]
dimetruk: bets 300
Kybosh67: calls 300
*** RIVER *** [6h As Jd 3d] [8d]
dimetruk: checks
Kybosh67: bets 774 and is all-in
dimetruk: folds
Uncalled bet (774) returned to Kybosh67
Kybosh67 collected 1695 from pot
Kybosh67: doesn't show hand
*** SUMMARY ***
Total pot 1695 | Rake 0
Board [6h As Jd 3d 8d]
Seat 1: Kybosh67 (button) collected (1695)
Seat 2: DER_KAISER77777 (small blind) folded before Flop
Seat 5: Wilq8309 (big blind) folded before Flop
Seat 6: Smiggeroo7 folded before Flop (didn't bet)
Seat 7: dimetruk folded on the River


PokerStars Hand #226613172910: Tournament #3190268420, $13.70+$1.30 USD Hold'em No Limit - Level V (60/120) - 2021/05/09 22:50:00 MSK [2021/05/09 15:50:00 ET]
Table '3190268420 2' 9-max Seat #5 is the button
Seat 1: Kybosh67 (2454 in chips)
Seat 2: DER_KAISER77777 (879 in chips)
Seat 5: Wilq8309 (1807 in chips)
Seat 6: Smiggeroo7 (2727 in chips)
Seat 7: dimetruk (3329 in chips)
Kybosh67: posts the ante 15
DER_KAISER77777: posts the ante 15
Wilq8309: posts the ante 15
Smiggeroo7: posts the ante 15
dimetruk: posts the ante 15
Smiggeroo7: posts small blind 60
dimetruk: posts big blind 120
*** HOLE CARDS ***
Dealt to dimetruk [6c 2d]
Kybosh67: calls 120
DER_KAISER77777: folds
Wilq8309: folds
Smiggeroo7: calls 60
dimetruk: checks
*** FLOP *** [3h 6d 4d]
Smiggeroo7: checks
dimetruk: checks
Kybosh67: checks
*** TURN *** [3h 6d 4d] [8h]
Smiggeroo7: checks
dimetruk: bets 218
Kybosh67: calls 218
Smiggeroo7: folds
*** RIVER *** [3h 6d 4d 8h] [8s]
dimetruk: checks
Kybosh67: checks
*** SHOW DOWN ***
dimetruk: shows [6c 2d] (two pair, Eights and Sixes)
Kybosh67: mucks hand
dimetruk collected 871 from pot
*** SUMMARY ***
Total pot 871 | Rake 0
Board [3h 6d 4d 8h 8s]
Seat 1: Kybosh67 mucked [Ac 4h]
Seat 2: DER_KAISER77777 folded before Flop (didn't bet)
Seat 5: Wilq8309 (button) folded before Flop (didn't bet)
Seat 6: Smiggeroo7 (small blind) folded on the Turn
Seat 7: dimetruk (big blind) showed [6c 2d] and won (871) with two pair, Eights and Sixes


PokerStars Hand #226613212412: Tournament #3190268420, $13.70+$1.30 USD Hold'em No Limit - Level V (60/120) - 2021/05/09 22:51:00 MSK [2021/05/09 15:51:00 ET]
Table '3190268420 2' 9-max Seat #7 is the button
Seat 1: Kybosh67 (1966 in chips)
Seat 2: DER_KAISER77777 (849 in chips)
Seat 5: Wilq8309 (2032 in chips)
Seat 6: Smiggeroo7 (2577 in chips)
Seat 7: dimetruk (3772 in chips)
Kybosh67: posts the ante 15
DER_KAISER77777: posts the ante 15
Wilq8309: posts the ante 15
Smiggeroo7: posts the ante 15
dimetruk: posts the ante 15
Kybosh67: posts small blind 60
DER_KAISER77777: posts big blind 120
*** HOLE CARDS ***
Dealt to dimetruk [Kc Ks]
Wilq8309: folds
Smiggeroo7: folds
dimetruk: raises 120 to 240
Kybosh67: folds
DER_KAISER77777: calls 120
*** FLOP *** [Qh Jh 9c]
DER_KAISER77777: checks
dimetruk: bets 780
DER_KAISER77777: folds
Uncalled bet (780) returned to dimetruk
dimetruk collected 615 from pot
*** SUMMARY ***
Total pot 615 | Rake 0
Board [Qh Jh 9c]
Seat 1: Kybosh67 (small blind) folded before Flop
Seat 2: DER_KAISER77777 (big blind) folded on the Flop
Seat 5: Wilq8309 folded before Flop (didn't bet)
Seat 6: Smiggeroo7 folded before Flop (didn't bet)
Seat 7: dimetruk (button) collected (615)


PokerStars Hand #226613523570: Tournament #3190268420, $13.70+$1.30 USD Hold'em No Limit - Level V (60/120) - 2021/05/09 23:01:07 MSK [2021/05/09 16:01:07 ET]
Table '3190268420 2' 9-max Seat #6 is the button
Seat 1: Kybosh67 (2491 in chips)
Seat 2: DER_KAISER77777 (474 in chips)
Seat 4: Andreas28 (7140 in chips)
Seat 5: Wilq8309 (1597 in chips)
Seat 6: Smiggeroo7 (2322 in chips)
Seat 7: dimetruk (3952 in chips)
Seat 8: TheHulk7 (2477 in chips)
Seat 9: obhavee23 (6547 in chips)
Kybosh67: posts the ante 15
DER_KAISER77777: posts the ante 15
Andreas28: posts the ante 15
Wilq8309: posts the ante 15
Smiggeroo7: posts the ante 15
dimetruk: posts the ante 15
TheHulk7: posts the ante 15
obhavee23: posts the ante 15
dimetruk: posts small blind 60
TheHulk7: posts big blind 120
*** HOLE CARDS ***
Dealt to dimetruk [Jd Qh]
obhavee23: folds
Kybosh67: folds
DER_KAISER77777: raises 339 to 459 and is all-in
Andreas28: folds
Wilq8309: folds
Smiggeroo7: folds
dimetruk: calls 399
TheHulk7: folds
*** FLOP *** [9d Ts Jh]
*** TURN *** [9d Ts Jh] [Qc]
*** RIVER *** [9d Ts Jh Qc] [4c]
*** SHOW DOWN ***
dimetruk: shows [Jd Qh] (two pair, Queens and Jacks)
DER_KAISER77777: shows [Kh 2h] (a straight, Nine to King)
DER_KAISER77777 collected 1158 from pot
*** SUMMARY ***
Total pot 1158 | Rake 0
Board [9d Ts Jh Qc 4c]
Seat 1: Kybosh67 folded before Flop (didn't bet)
Seat 2: DER_KAISER77777 showed [Kh 2h] and won (1158) with a straight, Nine to King
Seat 4: Andreas28 folded before Flop (didn't bet)
Seat 5: Wilq8309 folded before Flop (didn't bet)
Seat 6: Smiggeroo7 (button) folded before Flop (didn't bet)
Seat 7: dimetruk (small blind) showed [Jd Qh] and lost with two pair, Queens and Jacks
Seat 8: TheHulk7 (big blind) folded before Flop
Seat 9: obhavee23 folded before Flop (didn't bet)


PokerStars Hand #226613834643: Tournament #3190268420, $13.70+$1.30 USD Hold'em No Limit - Level VI (80/160) - 2021/05/09 23:09:08 MSK [2021/05/09 16:09:08 ET]
Table '3190268420 2' 9-max Seat #4 is the button
Seat 1: Kybosh67 (2719 in chips)
Seat 4: Andreas28 (3390 in chips)
Seat 6: Smiggeroo7 (2142 in chips)
Seat 7: dimetruk (4153 in chips)
Seat 8: TheHulk7 (3109 in chips)
Seat 9: obhavee23 (11487 in chips)
Kybosh67: posts the ante 20
Andreas28: posts the ante 20
Smiggeroo7: posts the ante 20
dimetruk: posts the ante 20
TheHulk7: posts the ante 20
obhavee23: posts the ante 20
Smiggeroo7: posts small blind 80
dimetruk: posts big blind 160
*** HOLE CARDS ***
Dealt to dimetruk [9s Th]
TheHulk7: folds
obhavee23: raises 160 to 320
Kybosh67: folds
Andreas28: folds
Smiggeroo7: calls 240
dimetruk: calls 160
*** FLOP *** [Qd 8s Qh]
Smiggeroo7: checks
dimetruk: checks
obhavee23: bets 11147 and is all-in
Smiggeroo7: folds
dimetruk: folds
Uncalled bet (11147) returned to obhavee23
obhavee23 collected 1080 from pot
obhavee23: doesn't show hand
*** SUMMARY ***
Total pot 1080 | Rake 0
Board [Qd 8s Qh]
Seat 1: Kybosh67 folded before Flop (didn't bet)
Seat 4: Andreas28 (button) folded before Flop (didn't bet)
Seat 6: Smiggeroo7 (small blind) folded on the Flop
Seat 7: dimetruk (big blind) folded on the Flop
Seat 8: TheHulk7 folded before Flop (didn't bet)
Seat 9: obhavee23 collected (1080)


PokerStars Hand #226613933268: Tournament #3190268420, $13.70+$1.30 USD Hold'em No Limit - Level VI (80/160) - 2021/05/09 23:11:39 MSK [2021/05/09 16:11:39 ET]
Table '3190268420 2' 9-max Seat #9 is the button
Seat 1: Kybosh67 (3199 in chips)
Seat 4: Andreas28 (6840 in chips)
Seat 6: Smiggeroo7 (1742 in chips)
Seat 7: dimetruk (3673 in chips)
Seat 8: TheHulk7 (2789 in chips)
Seat 9: obhavee23 (8757 in chips)
Kybosh67: posts the ante 20
Andreas28: posts the ante 20
Smiggeroo7: posts the ante 20
dimetruk: posts the ante 20
TheHulk7: posts the ante 20
obhavee23: posts the ante 20
Kybosh67: posts small blind 80
Andreas28: posts big blind 160
*** HOLE CARDS ***
Dealt to dimetruk [7h As]
Smiggeroo7: folds
dimetruk: raises 160 to 320
TheHulk7: folds
obhavee23: folds
Kybosh67: folds
Andreas28: calls 160
*** FLOP *** [Ks 4c 7s]
Andreas28: checks
dimetruk: bets 420
Andreas28: folds
Uncalled bet (420) returned to dimetruk
dimetruk collected 840 from pot
dimetruk: doesn't show hand
*** SUMMARY ***
Total pot 840 | Rake 0
Board [Ks 4c 7s]
Seat 1: Kybosh67 (small blind) folded before Flop
Seat 4: Andreas28 (big blind) folded on the Flop
Seat 6: Smiggeroo7 folded before Flop (didn't bet)
Seat 7: dimetruk collected (840)
Seat 8: TheHulk7 folded before Flop (didn't bet)
Seat 9: obhavee23 (button) folded before Flop (didn't bet)


PokerStars Hand #226613966453: Tournament #3190268420, $13.70+$1.30 USD Hold'em No Limit - Level VI (80/160) - 2021/05/09 23:12:30 MSK [2021/05/09 16:12:30 ET]
Table '3190268420 2' 9-max Seat #4 is the button
Seat 1: Kybosh67 (2919 in chips)
Seat 4: Andreas28 (6320 in chips)
Seat 6: Smiggeroo7 (2142 in chips)
Seat 7: dimetruk (4153 in chips)
Seat 8: TheHulk7 (2749 in chips)
Seat 9: obhavee23 (8717 in chips)
Kybosh67: posts the ante 20
Andreas28: posts the ante 20
Smiggeroo7: posts the ante 20
dimetruk: posts the ante 20
TheHulk7: posts the ante 20
obhavee23: posts the ante 20
Smiggeroo7: posts small blind 80
dimetruk: posts big blind 160
*** HOLE CARDS ***
Dealt to dimetruk [8s Js]
TheHulk7: folds
obhavee23: raises 320 to 480
Kybosh67: folds
Andreas28: folds
Smiggeroo7: folds
dimetruk: calls 320
*** FLOP *** [As Th Td]
dimetruk: checks
obhavee23: bets 580
dimetruk: folds
Uncalled bet (580) returned to obhavee23
obhavee23 collected 1160 from pot
obhavee23: doesn't show hand
*** SUMMARY ***
Total pot 1160 | Rake 0
Board [As Th Td]
Seat 1: Kybosh67 folded before Flop (didn't bet)
Seat 4: Andreas28 (button) folded before Flop (didn't bet)
Seat 6: Smiggeroo7 (small blind) folded before Flop
Seat 7: dimetruk (big blind) folded on the Flop
Seat 8: TheHulk7 folded before Flop (didn't bet)
Seat 9: obhavee23 collected (1160)


PokerStars Hand #226614310281: Tournament #3190268420, $13.70+$1.30 USD Hold'em No Limit - Level VII (100/200) - 2021/05/09 23:21:00 MSK [2021/05/09 16:21:00 ET]
Table '3190268420 2' 9-max Seat #6 is the button
Seat 1: Kybosh67 (2004 in chips)
Seat 4: Andreas28 (5855 in chips)
Seat 6: Smiggeroo7 (3570 in chips)
Seat 7: dimetruk (2778 in chips)
Seat 8: TheHulk7 (3148 in chips)
Seat 9: obhavee23 (9645 in chips)
Kybosh67: posts the ante 25
Andreas28: posts the ante 25
Smiggeroo7: posts the ante 25
dimetruk: posts the ante 25
TheHulk7: posts the ante 25
obhavee23: posts the ante 25
dimetruk: posts small blind 100
TheHulk7: posts big blind 200
*** HOLE CARDS ***
Dealt to dimetruk [Jh Ah]
obhavee23: folds
Kybosh67: folds
Andreas28: folds
Smiggeroo7: folds
dimetruk: raises 2553 to 2753 and is all-in
TheHulk7: calls 2553
*** FLOP *** [8c Qd 5d]
*** TURN *** [8c Qd 5d] [2s]
*** RIVER *** [8c Qd 5d 2s] [Kc]
*** SHOW DOWN ***
dimetruk: shows [Jh Ah] (high card Ace)
TheHulk7: shows [Kd Qh] (two pair, Kings and Queens)
TheHulk7 collected 5656 from pot
dimetruk finished the tournament in 6th place
*** SUMMARY ***
Total pot 5656 | Rake 0
Board [8c Qd 5d 2s Kc]
Seat 1: Kybosh67 folded before Flop (didn't bet)
Seat 4: Andreas28 folded before Flop (didn't bet)
Seat 6: Smiggeroo7 (button) folded before Flop (didn't bet)
Seat 7: dimetruk (small blind) showed [Jh Ah] and lost with high card Ace
Seat 8: TheHulk7 (big blind) showed [Kd Qh] and won (5656) with two pair, Kings and Queens
Seat 9: obhavee23 folded before Flop (didn't bet)


PokerStars Hand #226611118462: Tournament #3190275458, $27.58+$2.42 USD Hold'em No Limit - Level I (10/20) - 2021/05/09 21:55:50 MSK [2021/05/09 14:55:50 ET]
Table '3190275458 1' 6-max Seat #4 is the button
Seat 1: morcinga (1471 in chips)
Seat 2: rockyvi4 (1087 in chips)
Seat 3: ScousePro (1529 in chips)
Seat 4: dimetruk (1461 in chips)
Seat 5: Noogaii (1471 in chips)
Seat 6: aermsche1976 (1981 in chips)
morcinga: posts the ante 3
rockyvi4: posts the ante 3
ScousePro: posts the ante 3
dimetruk: posts the ante 3
Noogaii: posts the ante 3
aermsche1976: posts the ante 3
Noogaii: posts small blind 10
aermsche1976: posts big blind 20
*** HOLE CARDS ***
Dealt to dimetruk [Qd Th]
morcinga: folds
rockyvi4: folds
ScousePro: folds
dimetruk: raises 20 to 40
Noogaii: folds
aermsche1976: calls 20
*** FLOP *** [Jh Jd 6s]
aermsche1976: checks
dimetruk: bets 54
aermsche1976: calls 54
*** TURN *** [Jh Jd 6s] [Ah]
aermsche1976: checks
dimetruk: checks
*** RIVER *** [Jh Jd 6s Ah] [4s]
aermsche1976: checks
dimetruk: bets 145
aermsche1976: folds
Uncalled bet (145) returned to dimetruk
dimetruk collected 216 from pot
dimetruk: doesn't show hand
*** SUMMARY ***
Total pot 216 | Rake 0
Board [Jh Jd 6s Ah 4s]
Seat 1: morcinga folded before Flop (didn't bet)
Seat 2: rockyvi4 folded before Flop (didn't bet)
Seat 3: ScousePro folded before Flop (didn't bet)
Seat 4: dimetruk (button) collected (216)
Seat 5: Noogaii (small blind) folded before Flop
Seat 6: aermsche1976 (big blind) folded on the River


PokerStars Hand #226611217259: Tournament #3190275458, $27.58+$2.42 USD Hold'em No Limit - Level I (10/20) - 2021/05/09 22:00:12 MSK [2021/05/09 15:00:12 ET]
Table '3190275458 1' 6-max Seat #2 is the button
Seat 1: morcinga (1555 in chips)
Seat 2: rockyvi4 (1045 in chips)
Seat 3: ScousePro (1497 in chips)
Seat 4: dimetruk (1571 in chips)
Seat 5: Noogaii (1449 in chips)
Seat 6: aermsche1976 (1883 in chips)
morcinga: posts the ante 3
rockyvi4: posts the ante 3
ScousePro: posts the ante 3
dimetruk: posts the ante 3
Noogaii: posts the ante 3
aermsche1976: posts the ante 3
ScousePro: posts small blind 10
dimetruk: posts big blind 20
*** HOLE CARDS ***
Dealt to dimetruk [Th Ad]
Noogaii: folds
aermsche1976: calls 20
morcinga: raises 20 to 40
rockyvi4: folds
ScousePro: folds
dimetruk: calls 20
aermsche1976: calls 20
*** FLOP *** [5h 2d Jd]
dimetruk: checks
aermsche1976: checks
morcinga: checks
*** TURN *** [5h 2d Jd] [5s]
dimetruk: bets 52
aermsche1976: folds
morcinga: folds
Uncalled bet (52) returned to dimetruk
dimetruk collected 148 from pot
dimetruk: doesn't show hand
*** SUMMARY ***
Total pot 148 | Rake 0
Board [5h 2d Jd 5s]
Seat 1: morcinga folded on the Turn
Seat 2: rockyvi4 (button) folded before Flop (didn't bet)
Seat 3: ScousePro (small blind) folded before Flop
Seat 4: dimetruk (big blind) collected (148)
Seat 5: Noogaii folded before Flop (didn't bet)
Seat 6: aermsche1976 folded on the Turn


PokerStars Hand #226611373146: Tournament #3190275458, $27.58+$2.42 USD Hold'em No Limit - Level II (15/30) - 2021/05/09 22:04:47 MSK [2021/05/09 15:04:47 ET]
Table '3190275458 1' 6-max Seat #2 is the button
Seat 1: morcinga (1429 in chips)
Seat 2: rockyvi4 (951 in chips)
Seat 3: ScousePro (1258 in chips)
Seat 4: dimetruk (1698 in chips)
Seat 5: Noogaii (1717 in chips)
Seat 6: aermsche1976 (1947 in chips)
morcinga: posts the ante 4
rockyvi4: posts the ante 4
ScousePro: posts the ante 4
dimetruk: posts the ante 4
Noogaii: posts the ante 4
aermsche1976: posts the ante 4
ScousePro: posts small blind 15
dimetruk: posts big blind 30
*** HOLE CARDS ***
Dealt to dimetruk [5c Th]
Noogaii: folds
aermsche1976: calls 30
morcinga: folds
rockyvi4: folds
ScousePro: folds
dimetruk: checks
*** FLOP *** [8d 2d 6d]
dimetruk: checks
aermsche1976: checks
*** TURN *** [8d 2d 6d] [4h]
dimetruk: bets 50
aermsche1976: calls 50
*** RIVER *** [8d 2d 6d 4h] [Js]
dimetruk: bets 133
aermsche1976: calls 133
*** SHOW DOWN ***
dimetruk: shows [5c Th] (high card Jack)
aermsche1976: shows [Ks 4d] (a pair of Fours)
aermsche1976 collected 465 from pot
*** SUMMARY ***
Total pot 465 | Rake 0
Board [8d 2d 6d 4h Js]
Seat 1: morcinga folded before Flop (didn't bet)
Seat 2: rockyvi4 (button) folded before Flop (didn't bet)
Seat 3: ScousePro (small blind) folded before Flop
Seat 4: dimetruk (big blind) showed [5c Th] and lost with high card Jack
Seat 5: Noogaii folded before Flop (didn't bet)
Seat 6: aermsche1976 showed [Ks 4d] and won (465) with a pair of Fours


PokerStars Hand #226611397198: Tournament #3190275458, $27.58+$2.42 USD Hold'em No Limit - Level II (15/30) - 2021/05/09 22:05:26 MSK [2021/05/09 15:05:26 ET]
Table '3190275458 1' 6-max Seat #3 is the button
Seat 1: morcinga (1425 in chips)
Seat 2: rockyvi4 (947 in chips)
Seat 3: ScousePro (1239 in chips)
Seat 4: dimetruk (1481 in chips)
Seat 5: Noogaii (1713 in chips)
Seat 6: aermsche1976 (2195 in chips)
morcinga: posts the ante 4
rockyvi4: posts the ante 4
ScousePro: posts the ante 4
dimetruk: posts the ante 4
Noogaii: posts the ante 4
aermsche1976: posts the ante 4
dimetruk: posts small blind 15
Noogaii: posts big blind 30
*** HOLE CARDS ***
Dealt to dimetruk [Td 9c]
aermsche1976: calls 30
morcinga: folds
rockyvi4: folds
ScousePro: folds
dimetruk: calls 15
Noogaii: checks
*** FLOP *** [6d 2c 8d]
dimetruk: checks
Noogaii: checks
aermsche1976: checks
*** TURN *** [6d 2c 8d] [Qh]
dimetruk: bets 57
Noogaii: folds
aermsche1976: calls 57
*** RIVER *** [6d 2c 8d Qh] [4c]
dimetruk: checks
aermsche1976: checks
*** SHOW DOWN ***
dimetruk: shows [Td 9c] (high card Queen)
aermsche1976: shows [2d Kh] (a pair of Deuces)
aermsche1976 collected 228 from pot
*** SUMMARY ***
Total pot 228 | Rake 0
Board [6d 2c 8d Qh 4c]
Seat 1: morcinga folded before Flop (didn't bet)
Seat 2: rockyvi4 folded before Flop (didn't bet)
Seat 3: ScousePro (button) folded before Flop (didn't bet)
Seat 4: dimetruk (small blind) showed [Td 9c] and lost with high card Queen
Seat 5: Noogaii (big blind) folded on the Turn
Seat 6: aermsche1976 showed [2d Kh] and won (228) with a pair of Deuces


PokerStars Hand #226611594831: Tournament #3190275458, $27.58+$2.42 USD Hold'em No Limit - Level II (15/30) - 2021/05/09 22:10:29 MSK [2021/05/09 15:10:29 ET]
Table '3190275458 1' 6-max Seat #2 is the button
Seat 1: morcinga (1360 in chips) is sitting out
Seat 2: rockyvi4 (1257 in chips)
Seat 3: ScousePro (1016 in chips)
Seat 4: dimetruk (1374 in chips)
Seat 5: Noogaii (1950 in chips)
Seat 6: aermsche1976 (2043 in chips)
morcinga: posts the ante 4
rockyvi4: posts the ante 4
ScousePro: posts the ante 4
dimetruk: posts the ante 4
Noogaii: posts the ante 4
aermsche1976: posts the ante 4
ScousePro: posts small blind 15
dimetruk: posts big blind 30
*** HOLE CARDS ***
Dealt to dimetruk [As 9h]
Noogaii: raises 30 to 60
aermsche1976: folds
morcinga: folds
rockyvi4: folds
ScousePro: folds
dimetruk: calls 30
*** FLOP *** [8d 9s 9d]
dimetruk: checks
Noogaii: checks
*** TURN *** [8d 9s 9d] [Kd]
dimetruk: bets 80
Noogaii: calls 80
*** RIVER *** [8d 9s 9d Kd] [8s]
dimetruk: bets 214
Noogaii: folds
Uncalled bet (214) returned to dimetruk
dimetruk collected 319 from pot
dimetruk: doesn't show hand
*** SUMMARY ***
Total pot 319 | Rake 0
Board [8d 9s 9d Kd 8s]
Seat 1: morcinga folded before Flop (didn't bet)
Seat 2: rockyvi4 (button) folded before Flop (didn't bet)
Seat 3: ScousePro (small blind) folded before Flop
Seat 4: dimetruk (big blind) collected (319)
Seat 5: Noogaii folded on the River
Seat 6: aermsche1976 folded before Flop (didn't bet)


PokerStars Hand #226611705070: Tournament #3190275458, $27.58+$2.42 USD Hold'em No Limit - Level II (15/30) - 2021/05/09 22:13:06 MSK [2021/05/09 15:13:06 ET]
Table '3190275458 1' 6-max Seat #5 is the button
Seat 1: morcinga (1318 in chips)
Seat 2: rockyvi4 (1245 in chips)
Seat 3: ScousePro (989 in chips)
Seat 4: dimetruk (1526 in chips)
Seat 5: Noogaii (1921 in chips)
Seat 6: aermsche1976 (2001 in chips)
morcinga: posts the ante 4
rockyvi4: posts the ante 4
ScousePro: posts the ante 4
dimetruk: posts the ante 4
Noogaii: posts the ante 4
aermsche1976: posts the ante 4
aermsche1976: posts small blind 15
morcinga: posts big blind 30
*** HOLE CARDS ***
Dealt to dimetruk [Qc 9c]
rockyvi4: folds
ScousePro: folds
dimetruk: raises 30 to 60
Noogaii: folds
aermsche1976: calls 45
morcinga has timed out
morcinga: folds
morcinga is sitting out
*** FLOP *** [8c 5d 8d]
aermsche1976: bets 60
dimetruk: folds
Uncalled bet (60) returned to aermsche1976
aermsche1976 collected 174 from pot
*** SUMMARY ***
Total pot 174 | Rake 0
Board [8c 5d 8d]
Seat 1: morcinga (big blind) folded before Flop
Seat 2: rockyvi4 folded before Flop (didn't bet)
Seat 3: ScousePro folded before Flop (didn't bet)
Seat 4: dimetruk folded on the Flop
Seat 5: Noogaii (button) folded before Flop (didn't bet)
Seat 6: aermsche1976 (small blind) collected (174)


PokerStars Hand #226611768078: Tournament #3190275458, $27.58+$2.42 USD Hold'em No Limit - Level III (25/50) - 2021/05/09 22:14:43 MSK [2021/05/09 15:14:43 ET]
Table '3190275458 1' 6-max Seat #2 is the button
Seat 1: morcinga (1247 in chips) is sitting out
Seat 2: rockyvi4 (1612 in chips)
Seat 3: ScousePro (923 in chips)
Seat 4: dimetruk (1450 in chips)
Seat 5: Noogaii (1905 in chips)
Seat 6: aermsche1976 (1863 in chips)
morcinga: posts the ante 6
rockyvi4: posts the ante 6
ScousePro: posts the ante 6
dimetruk: posts the ante 6
Noogaii: posts the ante 6
aermsche1976: posts the ante 6
ScousePro: posts small blind 25
dimetruk: posts big blind 50
*** HOLE CARDS ***
Dealt to dimetruk [5c Kc]
Noogaii: folds
aermsche1976: folds
morcinga: folds
rockyvi4: folds
ScousePro: raises 60 to 110
dimetruk: calls 60
*** FLOP *** [4d 8c Ts]
ScousePro: bets 100
dimetruk: folds
Uncalled bet (100) returned to ScousePro
ScousePro collected 256 from pot
ScousePro: doesn't show hand
*** SUMMARY ***
Total pot 256 | Rake 0
Board [4d 8c Ts]
Seat 1: morcinga folded before Flop (didn't bet)
Seat 2: rockyvi4 (button) folded before Flop (didn't bet)
Seat 3: ScousePro (small blind) collected (256)
Seat 4: dimetruk (big blind) folded on the Flop
Seat 5: Noogaii folded before Flop (didn't bet)
Seat 6: aermsche1976 folded before Flop (didn't bet)


PokerStars Hand #226611787865: Tournament #3190275458, $27.58+$2.42 USD Hold'em No Limit - Level III (25/50) - 2021/05/09 22:15:13 MSK [2021/05/09 15:15:13 ET]
Table '3190275458 1' 6-max Seat #3 is the button
Seat 1: morcinga (1241 in chips) is sitting out
Seat 2: rockyvi4 (1606 in chips)
Seat 3: ScousePro (1063 in chips)
Seat 4: dimetruk (1334 in chips)
Seat 5: Noogaii (1899 in chips)
Seat 6: aermsche1976 (1857 in chips)
morcinga: posts the ante 6
rockyvi4: posts the ante 6
ScousePro: posts the ante 6
dimetruk: posts the ante 6
Noogaii: posts the ante 6
aermsche1976: posts the ante 6
dimetruk: posts small blind 25
Noogaii: posts big blind 50
*** HOLE CARDS ***
Dealt to dimetruk [Qh 9h]
aermsche1976: calls 50
morcinga: folds
rockyvi4: folds
ScousePro: folds
dimetruk: calls 25
Noogaii: checks
*** FLOP *** [Ac 4h 4s]
dimetruk: checks
Noogaii: checks
aermsche1976: checks
*** TURN *** [Ac 4h 4s] [Jd]
dimetruk: checks
Noogaii: checks
aermsche1976: checks
*** RIVER *** [Ac 4h 4s Jd] [2h]
dimetruk: checks
Noogaii: checks
aermsche1976: checks
*** SHOW DOWN ***
dimetruk: shows [Qh 9h] (a pair of Fours)
Noogaii: mucks hand
aermsche1976: shows [5c Qc] (a pair of Fours)
dimetruk collected 93 from pot
aermsche1976 collected 93 from pot
*** SUMMARY ***
Total pot 186 | Rake 0
Board [Ac 4h 4s Jd 2h]
Seat 1: morcinga folded before Flop (didn't bet)
Seat 2: rockyvi4 folded before Flop (didn't bet)
Seat 3: ScousePro (button) folded before Flop (didn't bet)
Seat 4: dimetruk (small blind) showed [Qh 9h] and won (93) with a pair of Fours
Seat 5: Noogaii (big blind) mucked [7h Td]
Seat 6: aermsche1976 showed [5c Qc] and won (93) with a pair of Fours


PokerStars Hand #226611951721: Tournament #3190275458, $27.58+$2.42 USD Hold'em No Limit - Level III (25/50) - 2021/05/09 22:19:25 MSK [2021/05/09 15:19:25 ET]
Table '3190275458 1' 6-max Seat #3 is the button
Seat 1: morcinga (1130 in chips)
Seat 2: rockyvi4 (1987 in chips)
Seat 3: ScousePro (893 in chips)
Seat 4: dimetruk (1402 in chips)
Seat 5: Noogaii (1899 in chips)
Seat 6: aermsche1976 (1689 in chips)
morcinga: posts the ante 6
rockyvi4: posts the ante 6
ScousePro: posts the ante 6
dimetruk: posts the ante 6
Noogaii: posts the ante 6
aermsche1976: posts the ante 6
dimetruk: posts small blind 25
Noogaii: posts big blind 50
*** HOLE CARDS ***
Dealt to dimetruk [Ts 9c]
aermsche1976: calls 50
morcinga: folds
rockyvi4: folds
ScousePro: folds
dimetruk: calls 25
Noogaii: checks
*** FLOP *** [2d 6s 9d]
dimetruk: checks
Noogaii: checks
aermsche1976: checks
*** TURN *** [2d 6s 9d] [5c]
dimetruk: bets 93
Noogaii: folds
aermsche1976: calls 93
*** RIVER *** [2d 6s 9d 5c] [5s]
dimetruk: checks
aermsche1976: checks
*** SHOW DOWN ***
dimetruk: shows [Ts 9c] (two pair, Nines and Fives)
aermsche1976: mucks hand
dimetruk collected 372 from pot
*** SUMMARY ***
Total pot 372 | Rake 0
Board [2d 6s 9d 5c 5s]
Seat 1: morcinga folded before Flop (didn't bet)
Seat 2: rockyvi4 folded before Flop (didn't bet)
Seat 3: ScousePro (button) folded before Flop (didn't bet)
Seat 4: dimetruk (small blind) showed [Ts 9c] and won (372) with two pair, Nines and Fives
Seat 5: Noogaii (big blind) folded on the Turn
Seat 6: aermsche1976 mucked [As 7c]


PokerStars Hand #226612095084: Tournament #3190275458, $27.58+$2.42 USD Hold'em No Limit - Level III (25/50) - 2021/05/09 22:23:07 MSK [2021/05/09 15:23:07 ET]
Table '3190275458 1' 6-max Seat #2 is the button
Seat 1: morcinga (1025 in chips)
Seat 2: rockyvi4 (1863 in chips)
Seat 3: ScousePro (1135 in chips)
Seat 4: dimetruk (1712 in chips)
Seat 5: Noogaii (1794 in chips)
Seat 6: aermsche1976 (1471 in chips)
morcinga: posts the ante 6
rockyvi4: posts the ante 6
ScousePro: posts the ante 6
dimetruk: posts the ante 6
Noogaii: posts the ante 6
aermsche1976: posts the ante 6
ScousePro: posts small blind 25
dimetruk: posts big blind 50
*** HOLE CARDS ***
Dealt to dimetruk [3h 8h]
Noogaii: folds
aermsche1976: raises 50 to 100
morcinga: folds
rockyvi4: folds
ScousePro: folds
dimetruk: calls 50
*** FLOP *** [6d 2h Ad]
dimetruk: checks
aermsche1976: bets 150
dimetruk: folds
Uncalled bet (150) returned to aermsche1976
aermsche1976 collected 261 from pot
*** SUMMARY ***
Total pot 261 | Rake 0
Board [6d 2h Ad]
Seat 1: morcinga folded before Flop (didn't bet)
Seat 2: rockyvi4 (button) folded before Flop (didn't bet)
Seat 3: ScousePro (small blind) folded before Flop
Seat 4: dimetruk (big blind) folded on the Flop
Seat 5: Noogaii folded before Flop (didn't bet)
Seat 6: aermsche1976 collected (261)


PokerStars Hand #226612353353: Tournament #3190275458, $27.58+$2.42 USD Hold'em No Limit - Level IV (40/80) - 2021/05/09 22:29:35 MSK [2021/05/09 15:29:35 ET]
Table '3190275458 1' 6-max Seat #2 is the button
Seat 1: morcinga (1418 in chips)
Seat 2: rockyvi4 (2568 in chips)
Seat 3: ScousePro (1774 in chips)
Seat 4: dimetruk (1686 in chips)
Seat 6: aermsche1976 (1554 in chips)
morcinga: posts the ante 10
rockyvi4: posts the ante 10
ScousePro: posts the ante 10
dimetruk: posts the ante 10
aermsche1976: posts the ante 10
ScousePro: posts small blind 40
dimetruk: posts big blind 80
*** HOLE CARDS ***
Dealt to dimetruk [Kh 3h]
aermsche1976: calls 80
morcinga: calls 80
rockyvi4: folds
ScousePro: folds
dimetruk: checks
*** FLOP *** [Ad 7s Js]
dimetruk: checks
aermsche1976: checks
morcinga: bets 640
dimetruk: folds
aermsche1976: folds
Uncalled bet (640) returned to morcinga
morcinga collected 330 from pot
morcinga: doesn't show hand
*** SUMMARY ***
Total pot 330 | Rake 0
Board [Ad 7s Js]
Seat 1: morcinga collected (330)
Seat 2: rockyvi4 (button) folded before Flop (didn't bet)
Seat 3: ScousePro (small blind) folded before Flop
Seat 4: dimetruk (big blind) folded on the Flop
Seat 6: aermsche1976 folded on the Flop


PokerStars Hand #226612396269: Tournament #3190275458, $27.58+$2.42 USD Hold'em No Limit - Level IV (40/80) - 2021/05/09 22:30:40 MSK [2021/05/09 15:30:40 ET]
Table '3190275458 1' 6-max Seat #4 is the button
Seat 1: morcinga (1898 in chips)
Seat 2: rockyvi4 (2548 in chips)
Seat 3: ScousePro (1714 in chips)
Seat 4: dimetruk (1546 in chips)
Seat 6: aermsche1976 (1294 in chips)
morcinga: posts the ante 10
rockyvi4: posts the ante 10
ScousePro: posts the ante 10
dimetruk: posts the ante 10
aermsche1976: posts the ante 10
aermsche1976: posts small blind 40
morcinga: posts big blind 80
*** HOLE CARDS ***
Dealt to dimetruk [5s 3c]
rockyvi4: folds
ScousePro: folds
dimetruk: raises 80 to 160
aermsche1976: calls 120
morcinga: folds
*** FLOP *** [2d 7d Tc]
aermsche1976: checks
dimetruk: checks
*** TURN *** [2d 7d Tc] [Jd]
aermsche1976: checks
dimetruk: checks
*** RIVER *** [2d 7d Tc Jd] [Ts]
aermsche1976: checks
dimetruk: bets 392
aermsche1976: folds
Uncalled bet (392) returned to dimetruk
dimetruk collected 450 from pot
dimetruk: doesn't show hand
*** SUMMARY ***
Total pot 450 | Rake 0
Board [2d 7d Tc Jd Ts]
Seat 1: morcinga (big blind) folded before Flop
Seat 2: rockyvi4 folded before Flop (didn't bet)
Seat 3: ScousePro folded before Flop (didn't bet)
Seat 4: dimetruk (button) collected (450)
Seat 6: aermsche1976 (small blind) folded on the River


PokerStars Hand #226612445256: Tournament #3190275458, $27.58+$2.42 USD Hold'em No Limit - Level IV (40/80) - 2021/05/09 22:31:55 MSK [2021/05/09 15:31:55 ET]
Table '3190275458 1' 6-max Seat #1 is the button
Seat 1: morcinga (2033 in chips)
Seat 2: rockyvi4 (2343 in chips)
Seat 3: ScousePro (1694 in chips)
Seat 4: dimetruk (1816 in chips)
Seat 6: aermsche1976 (1114 in chips)
morcinga: posts the ante 10
rockyvi4: posts the ante 10
ScousePro: posts the ante 10
dimetruk: posts the ante 10
aermsche1976: posts the ante 10
rockyvi4: posts small blind 40
ScousePro: posts big blind 80
*** HOLE CARDS ***
Dealt to dimetruk [As 6s]
dimetruk: raises 80 to 160
aermsche1976: calls 160
morcinga: folds
rockyvi4: folds
ScousePro: folds
*** FLOP *** [3d 5h 9d]
dimetruk: checks
aermsche1976: bets 240
dimetruk: folds
Uncalled bet (240) returned to aermsche1976
aermsche1976 collected 490 from pot
*** SUMMARY ***
Total pot 490 | Rake 0
Board [3d 5h 9d]
Seat 1: morcinga (button) folded before Flop (didn't bet)
Seat 2: rockyvi4 (small blind) folded before Flop
Seat 3: ScousePro (big blind) folded before Flop
Seat 4: dimetruk folded on the Flop
Seat 6: aermsche1976 collected (490)


PokerStars Hand #226612483177: Tournament #3190275458, $27.58+$2.42 USD Hold'em No Limit - Level IV (40/80) - 2021/05/09 22:32:52 MSK [2021/05/09 15:32:52 ET]
Table '3190275458 1' 6-max Seat #4 is the button
Seat 1: morcinga (2003 in chips)
Seat 2: rockyvi4 (2273 in chips)
Seat 3: ScousePro (1714 in chips)
Seat 4: dimetruk (1506 in chips)
Seat 6: aermsche1976 (1504 in chips)
morcinga: posts the ante 10
rockyvi4: posts the ante 10
ScousePro: posts the ante 10
dimetruk: posts the ante 10
aermsche1976: posts the ante 10
aermsche1976: posts small blind 40
morcinga: posts big blind 80
*** HOLE CARDS ***
Dealt to dimetruk [Td 8c]
rockyvi4: folds
ScousePro: folds
dimetruk: raises 80 to 160
aermsche1976: calls 120
morcinga: folds
*** FLOP *** [Ah 5d Qh]
aermsche1976: checks
dimetruk: bets 158
aermsche1976: calls 158
*** TURN *** [Ah 5d Qh] [5s]
aermsche1976: checks
dimetruk: checks
*** RIVER *** [Ah 5d Qh 5s] [9d]
aermsche1976: bets 1176 and is all-in
dimetruk: folds
Uncalled bet (1176) returned to aermsche1976
aermsche1976 collected 766 from pot
*** SUMMARY ***
Total pot 766 | Rake 0
Board [Ah 5d Qh 5s 9d]
Seat 1: morcinga (big blind) folded before Flop
Seat 2: rockyvi4 folded before Flop (didn't bet)
Seat 3: ScousePro folded before Flop (didn't bet)
Seat 4: dimetruk (button) folded on the River
Seat 6: aermsche1976 (small blind) collected (766)


PokerStars Hand #226612573801: Tournament #3190275458, $27.58+$2.42 USD Hold'em No Limit - Level V (60/120) - 2021/05/09 22:35:10 MSK [2021/05/09 15:35:10 ET]
Table '3190275458 1' 6-max Seat #2 is the button
Seat 1: morcinga (2236 in chips)
Seat 2: rockyvi4 (1655 in chips)
Seat 3: ScousePro (2049 in chips)
Seat 4: dimetruk (1148 in chips)
Seat 6: aermsche1976 (1912 in chips)
morcinga: posts the ante 15
rockyvi4: posts the ante 15
ScousePro: posts the ante 15
dimetruk: posts the ante 15
aermsche1976: posts the ante 15
ScousePro: posts small blind 60
dimetruk: posts big blind 120
*** HOLE CARDS ***
Dealt to dimetruk [Ah Tc]
aermsche1976: folds
morcinga: calls 120
rockyvi4: folds
ScousePro: folds
dimetruk: raises 1013 to 1133 and is all-in
morcinga: calls 1013
*** FLOP *** [8d 6s 7d]
*** TURN *** [8d 6s 7d] [As]
*** RIVER *** [8d 6s 7d As] [Jh]
*** SHOW DOWN ***
dimetruk: shows [Ah Tc] (a pair of Aces)
morcinga: shows [Ad Qd] (a pair of Aces - Queen kicker)
morcinga collected 2401 from pot
dimetruk finished the tournament in 5th place
*** SUMMARY ***
Total pot 2401 | Rake 0
Board [8d 6s 7d As Jh]
Seat 1: morcinga showed [Ad Qd] and won (2401) with a pair of Aces
Seat 2: rockyvi4 (button) folded before Flop (didn't bet)
Seat 3: ScousePro (small blind) folded before Flop
Seat 4: dimetruk (big blind) showed [Ah Tc] and lost with a pair of Aces
Seat 6: aermsche1976 folded before Flop (didn't bet)


PokerStars Hand #226612810638: Tournament #3190323036, $13.79+$1.21 USD Hold'em No Limit - Level I (10/20) - 2021/05/09 22:41:05 MSK [2021/05/09 15:41:05 ET]
Table '3190323036 1' 6-max Seat #6 is the button
Seat 1: dimetruk (1513 in chips)
Seat 2: gorillasalad (1387 in chips)
Seat 3: ArgentAgent (1591 in chips)
Seat 4: Carloss86 (1445 in chips)
Seat 5: Mr Mike 6666 (1521 in chips)
Seat 6: Mossy018 (1543 in chips)
dimetruk: posts the ante 3
gorillasalad: posts the ante 3
ArgentAgent: posts the ante 3
Carloss86: posts the ante 3
Mr Mike 6666: posts the ante 3
Mossy018: posts the ante 3
dimetruk: posts small blind 10
gorillasalad: posts big blind 20
*** HOLE CARDS ***
Dealt to dimetruk [Qs Kc]
ArgentAgent: raises 55 to 75
Carloss86: folds
Mr Mike 6666: folds
Mossy018: calls 75
dimetruk: calls 65
gorillasalad: calls 55
*** FLOP *** [7d 9c 8s]
dimetruk: checks
gorillasalad: bets 318
ArgentAgent: folds
Mossy018: folds
dimetruk: folds
Uncalled bet (318) returned to gorillasalad
gorillasalad collected 318 from pot
*** SUMMARY ***
Total pot 318 | Rake 0
Board [7d 9c 8s]
Seat 1: dimetruk (small blind) folded on the Flop
Seat 2: gorillasalad (big blind) collected (318)
Seat 3: ArgentAgent folded on the Flop
Seat 4: Carloss86 folded before Flop (didn't bet)
Seat 5: Mr Mike 6666 folded before Flop (didn't bet)
Seat 6: Mossy018 (button) folded on the Flop


PokerStars Hand #226613002420: Tournament #3190323036, $13.79+$1.21 USD Hold'em No Limit - Level I (10/20) - 2021/05/09 22:45:49 MSK [2021/05/09 15:45:49 ET]
Table '3190323036 1' 6-max Seat #4 is the button
Seat 1: dimetruk (1426 in chips)
Seat 2: gorillasalad (1608 in chips)
Seat 3: ArgentAgent (48 in chips)
Seat 4: Carloss86 (3225 in chips)
Seat 5: Mr Mike 6666 (1349 in chips)
Seat 6: Mossy018 (1344 in chips)
dimetruk: posts the ante 3
gorillasalad: posts the ante 3
ArgentAgent: posts the ante 3
Carloss86: posts the ante 3
Mr Mike 6666: posts the ante 3
Mossy018: posts the ante 3
Mr Mike 6666: posts small blind 10
Mossy018: posts big blind 20
*** HOLE CARDS ***
Dealt to dimetruk [Kd Js]
dimetruk: raises 20 to 40
gorillasalad: folds
ArgentAgent: folds
Carloss86: folds
Mr Mike 6666: raises 60 to 100
Mossy018: folds
dimetruk: calls 60
*** FLOP *** [3h 4s Th]
Mr Mike 6666: checks
dimetruk: checks
*** TURN *** [3h 4s Th] [Kh]
Mr Mike 6666: bets 100
dimetruk: calls 100
*** RIVER *** [3h 4s Th Kh] [9h]
Mr Mike 6666: bets 100
dimetruk: raises 260 to 360
Mr Mike 6666: raises 786 to 1146 and is all-in
dimetruk: folds
Uncalled bet (786) returned to Mr Mike 6666
Mr Mike 6666 collected 1158 from pot
*** SUMMARY ***
Total pot 1158 | Rake 0
Board [3h 4s Th Kh 9h]
Seat 1: dimetruk folded on the River
Seat 2: gorillasalad folded before Flop (didn't bet)
Seat 3: ArgentAgent folded before Flop (didn't bet)
Seat 4: Carloss86 (button) folded before Flop (didn't bet)
Seat 5: Mr Mike 6666 (small blind) collected (1158)
Seat 6: Mossy018 (big blind) folded before Flop


PokerStars Hand #226613119411: Tournament #3190323036, $13.79+$1.21 USD Hold'em No Limit - Level II (15/30) - 2021/05/09 22:48:37 MSK [2021/05/09 15:48:37 ET]
Table '3190323036 1' 6-max Seat #1 is the button
Seat 1: dimetruk (810 in chips)
Seat 2: gorillasalad (1591 in chips)
Seat 3: ArgentAgent (37 in chips)
Seat 4: Carloss86 (3328 in chips)
Seat 5: Mr Mike 6666 (1936 in chips)
Seat 6: Mossy018 (1298 in chips)
dimetruk: posts the ante 4
gorillasalad: posts the ante 4
ArgentAgent: posts the ante 4
Carloss86: posts the ante 4
Mr Mike 6666: posts the ante 4
Mossy018: posts the ante 4
gorillasalad: posts small blind 15
ArgentAgent: posts big blind 30
*** HOLE CARDS ***
Dealt to dimetruk [Ts As]
Carloss86: folds
Mr Mike 6666: raises 90 to 120
Mossy018: folds
dimetruk: raises 686 to 806 and is all-in
gorillasalad: folds
ArgentAgent: calls 3 and is all-in
Mr Mike 6666: folds
Uncalled bet (686) returned to dimetruk
*** FLOP *** [4d 6h 5c]
*** TURN *** [4d 6h 5c] [6d]
*** RIVER *** [4d 6h 5c 6d] [9s]
*** SHOW DOWN ***
dimetruk: shows [Ts As] (a pair of Sixes)
dimetruk collected 174 from side pot
ArgentAgent: shows [3s 6c] (three of a kind, Sixes)
ArgentAgent collected 138 from main pot
*** SUMMARY ***
Total pot 312 Main pot 138. Side pot 174. | Rake 0
Board [4d 6h 5c 6d 9s]
Seat 1: dimetruk (button) showed [Ts As] and won (174) with a pair of Sixes
Seat 2: gorillasalad (small blind) folded before Flop
Seat 3: ArgentAgent (big blind) showed [3s 6c] and won (138) with three of a kind, Sixes
Seat 4: Carloss86 folded before Flop (didn't bet)
Seat 5: Mr Mike 6666 folded before Flop
Seat 6: Mossy018 folded before Flop (didn't bet)


PokerStars Hand #226613144953: Tournament #3190323036, $13.79+$1.21 USD Hold'em No Limit - Level II (15/30) - 2021/05/09 22:49:16 MSK [2021/05/09 15:49:16 ET]
Table '3190323036 1' 6-max Seat #2 is the button
Seat 1: dimetruk (860 in chips)
Seat 2: gorillasalad (1572 in chips)
Seat 3: ArgentAgent (138 in chips)
Seat 4: Carloss86 (3324 in chips)
Seat 5: Mr Mike 6666 (1812 in chips)
Seat 6: Mossy018 (1294 in chips)
dimetruk: posts the ante 4
gorillasalad: posts the ante 4
ArgentAgent: posts the ante 4
Carloss86: posts the ante 4
Mr Mike 6666: posts the ante 4
Mossy018: posts the ante 4
ArgentAgent: posts small blind 15
Carloss86: posts big blind 30
*** HOLE CARDS ***
Dealt to dimetruk [2s As]
Mr Mike 6666: folds
Mossy018: folds
dimetruk: raises 30 to 60
gorillasalad: folds
ArgentAgent: folds
Carloss86: calls 30
*** FLOP *** [Td Ah Qc]
Carloss86: checks
dimetruk: bets 56
Carloss86: calls 56
*** TURN *** [Td Ah Qc] [Tc]
Carloss86: bets 163
dimetruk: calls 163
*** RIVER *** [Td Ah Qc Tc] [8c]
Carloss86: bets 3041 and is all-in
dimetruk: folds
Uncalled bet (3041) returned to Carloss86
Carloss86 collected 597 from pot
Carloss86: doesn't show hand
*** SUMMARY ***
Total pot 597 | Rake 0
Board [Td Ah Qc Tc 8c]
Seat 1: dimetruk folded on the River
Seat 2: gorillasalad (button) folded before Flop (didn't bet)
Seat 3: ArgentAgent (small blind) folded before Flop
Seat 4: Carloss86 (big blind) collected (597)
Seat 5: Mr Mike 6666 folded before Flop (didn't bet)
Seat 6: Mossy018 folded before Flop (didn't bet)


PokerStars Hand #226613308677: Tournament #3190323036, $13.79+$1.21 USD Hold'em No Limit - Level II (15/30) - 2021/05/09 22:53:28 MSK [2021/05/09 15:53:28 ET]
Table '3190323036 1' 6-max Seat #6 is the button
Seat 1: dimetruk (535 in chips)
Seat 2: gorillasalad (1790 in chips)
Seat 3: ArgentAgent (107 in chips)
Seat 4: Carloss86 (2855 in chips)
Seat 5: Mr Mike 6666 (2531 in chips)
Seat 6: Mossy018 (1182 in chips)
dimetruk: posts the ante 4
gorillasalad: posts the ante 4
ArgentAgent: posts the ante 4
Carloss86: posts the ante 4
Mr Mike 6666: posts the ante 4
Mossy018: posts the ante 4
dimetruk: posts small blind 15
gorillasalad: posts big blind 30
*** HOLE CARDS ***
Dealt to dimetruk [Kd 8s]
ArgentAgent: folds
Carloss86: folds
Mr Mike 6666: folds
Mossy018: calls 30
dimetruk: calls 15
gorillasalad: checks
*** FLOP *** [5s 5h As]
dimetruk: checks
gorillasalad: checks
Mossy018: bets 57
dimetruk: folds
gorillasalad: folds
Uncalled bet (57) returned to Mossy018
Mossy018 collected 114 from pot
*** SUMMARY ***
Total pot 114 | Rake 0
Board [5s 5h As]
Seat 1: dimetruk (small blind) folded on the Flop
Seat 2: gorillasalad (big blind) folded on the Flop
Seat 3: ArgentAgent folded before Flop (didn't bet)
Seat 4: Carloss86 folded before Flop (didn't bet)
Seat 5: Mr Mike 6666 folded before Flop (didn't bet)
Seat 6: Mossy018 (button) collected (114)


PokerStars Hand #226613445497: Tournament #3190323036, $13.79+$1.21 USD Hold'em No Limit - Level III (25/50) - 2021/05/09 22:57:57 MSK [2021/05/09 15:57:57 ET]
Table '3190323036 1' 6-max Seat #4 is the button
Seat 1: dimetruk (426 in chips)
Seat 2: gorillasalad (3060 in chips)
Seat 4: Carloss86 (2436 in chips)
Seat 5: Mr Mike 6666 (1688 in chips)
Seat 6: Mossy018 (1390 in chips)
dimetruk: posts the ante 6
gorillasalad: posts the ante 6
Carloss86: posts the ante 6
Mr Mike 6666: posts the ante 6
Mossy018: posts the ante 6
Mr Mike 6666: posts small blind 25
Mossy018: posts big blind 50
*** HOLE CARDS ***
Dealt to dimetruk [Ac 4h]
dimetruk: raises 370 to 420 and is all-in
gorillasalad: folds
Carloss86: calls 420
Mr Mike 6666: folds
Mossy018: folds
*** FLOP *** [Jd Kc Js]
*** TURN *** [Jd Kc Js] [6d]
*** RIVER *** [Jd Kc Js 6d] [8c]
*** SHOW DOWN ***
dimetruk: shows [Ac 4h] (a pair of Jacks)
Carloss86: shows [6s 6h] (a full house, Sixes full of Jacks)
Carloss86 collected 945 from pot
dimetruk finished the tournament in 5th place
*** SUMMARY ***
Total pot 945 | Rake 0
Board [Jd Kc Js 6d 8c]
Seat 1: dimetruk showed [Ac 4h] and lost with a pair of Jacks
Seat 2: gorillasalad folded before Flop (didn't bet)
Seat 4: Carloss86 (button) showed [6s 6h] and won (945) with a full house, Sixes full of Jacks
Seat 5: Mr Mike 6666 (small blind) folded before Flop
Seat 6: Mossy018 (big blind) folded before Flop


PokerStars Hand #226613238528: Tournament #3190325009, $13.70+$1.30 USD Hold'em No Limit - Level I (10/20) - 2021/05/09 22:51:41 MSK [2021/05/09 15:51:41 ET]
Table '3190325009 1' 9-max Seat #4 is the button
Seat 2: 10iz9 (1307 in chips)
Seat 3: karawondo (734 in chips)
Seat 4: IncrementX (1387 in chips)
Seat 5: Mas101G (731 in chips)
Seat 6: dimetruk (1437 in chips)
Seat 7: sergei930 (1504 in chips)
Seat 8: gnella13 (1377 in chips)
Seat 9: fernandovgt (5023 in chips)
10iz9: posts the ante 3
karawondo: posts the ante 3
IncrementX: posts the ante 3
Mas101G: posts the ante 3
dimetruk: posts the ante 3
sergei930: posts the ante 3
gnella13: posts the ante 3
fernandovgt: posts the ante 3
Mas101G: posts small blind 10
dimetruk: posts big blind 20
*** HOLE CARDS ***
Dealt to dimetruk [Ac 5d]
sergei930: folds
gnella13: folds
fernandovgt: folds
10iz9: raises 20 to 40
karawondo: folds
IncrementX: folds
Mas101G: calls 30
dimetruk: calls 20
*** FLOP *** [5h Jc 7s]
Mas101G: checks
dimetruk: checks
10iz9: checks
*** TURN *** [5h Jc 7s] [3c]
Mas101G: checks
dimetruk: bets 72
10iz9: calls 72
Mas101G: folds
*** RIVER *** [5h Jc 7s 3c] [Kc]
dimetruk: checks
10iz9: checks
*** SHOW DOWN ***
dimetruk: shows [Ac 5d] (a pair of Fives)
10iz9: shows [6c 6h] (a pair of Sixes)
10iz9 collected 288 from pot
*** SUMMARY ***
Total pot 288 | Rake 0
Board [5h Jc 7s 3c Kc]
Seat 2: 10iz9 showed [6c 6h] and won (288) with a pair of Sixes
Seat 3: karawondo folded before Flop (didn't bet)
Seat 4: IncrementX (button) folded before Flop (didn't bet)
Seat 5: Mas101G (small blind) folded on the Turn
Seat 6: dimetruk (big blind) showed [Ac 5d] and lost with a pair of Fives
Seat 7: sergei930 folded before Flop (didn't bet)
Seat 8: gnella13 folded before Flop (didn't bet)
Seat 9: fernandovgt folded before Flop (didn't bet)


PokerStars Hand #226613480719: Tournament #3190325009, $13.70+$1.30 USD Hold'em No Limit - Level II (15/30) - 2021/05/09 22:59:26 MSK [2021/05/09 15:59:26 ET]
Table '3190325009 1' 9-max Seat #4 is the button
Seat 2: 10iz9 (1122 in chips)
Seat 3: karawondo (1014 in chips)
Seat 4: IncrementX (3140 in chips)
Seat 5: Mas101G (1083 in chips)
Seat 6: dimetruk (1279 in chips)
Seat 7: sergei930 (1428 in chips)
Seat 8: gnella13 (1181 in chips)
Seat 9: fernandovgt (3253 in chips)
10iz9: posts the ante 4
karawondo: posts the ante 4
IncrementX: posts the ante 4
Mas101G: posts the ante 4
dimetruk: posts the ante 4
sergei930: posts the ante 4
gnella13: posts the ante 4
fernandovgt: posts the ante 4
Mas101G: posts small blind 15
dimetruk: posts big blind 30
*** HOLE CARDS ***
Dealt to dimetruk [5d 7s]
sergei930: folds
gnella13: folds
fernandovgt: folds
10iz9: raises 30 to 60
karawondo: folds
IncrementX: folds
Mas101G: folds
dimetruk: calls 30
*** FLOP *** [Qc 4c Th]
dimetruk: checks
10iz9: checks
*** TURN *** [Qc 4c Th] [2c]
dimetruk: checks
10iz9: bets 60
dimetruk: folds
Uncalled bet (60) returned to 10iz9
10iz9 collected 167 from pot
10iz9: doesn't show hand
*** SUMMARY ***
Total pot 167 | Rake 0
Board [Qc 4c Th 2c]
Seat 2: 10iz9 collected (167)
Seat 3: karawondo folded before Flop (didn't bet)
Seat 4: IncrementX (button) folded before Flop (didn't bet)
Seat 5: Mas101G (small blind) folded before Flop
Seat 6: dimetruk (big blind) folded on the Turn
Seat 7: sergei930 folded before Flop (didn't bet)
Seat 8: gnella13 folded before Flop (didn't bet)
Seat 9: fernandovgt folded before Flop (didn't bet)


PokerStars Hand #226613497495: Tournament #3190325009, $13.70+$1.30 USD Hold'em No Limit - Level II (15/30) - 2021/05/09 23:00:07 MSK [2021/05/09 16:00:07 ET]
Table '3190325009 1' 9-max Seat #5 is the button
Seat 2: 10iz9 (1225 in chips)
Seat 3: karawondo (1010 in chips)
Seat 4: IncrementX (3136 in chips)
Seat 5: Mas101G (1064 in chips)
Seat 6: dimetruk (1215 in chips)
Seat 7: sergei930 (1424 in chips)
Seat 8: gnella13 (1177 in chips)
Seat 9: fernandovgt (3249 in chips)
10iz9: posts the ante 4
karawondo: posts the ante 4
IncrementX: posts the ante 4
Mas101G: posts the ante 4
dimetruk: posts the ante 4
sergei930: posts the ante 4
gnella13: posts the ante 4
fernandovgt: posts the ante 4
dimetruk: posts small blind 15
sergei930: posts big blind 30
*** HOLE CARDS ***
Dealt to dimetruk [3s 3c]
gnella13: folds
fernandovgt: calls 30
10iz9: raises 60 to 90
karawondo: calls 90
IncrementX: folds
Mas101G: calls 90
dimetruk: calls 75
sergei930: folds
fernandovgt: calls 60
*** FLOP *** [5d 4c 8d]
dimetruk: checks
fernandovgt: checks
10iz9: checks
karawondo: checks
Mas101G: bets 970 and is all-in
dimetruk: folds
fernandovgt: calls 970
10iz9: raises 161 to 1131 and is all-in
karawondo: folds
fernandovgt: calls 161
*** TURN *** [5d 4c 8d] [5h]
*** RIVER *** [5d 4c 8d 5h] [Kh]
*** SHOW DOWN ***
fernandovgt: shows [6d Qd] (a pair of Fives)
10iz9: shows [4h 4d] (a full house, Fours full of Fives)
10iz9 collected 322 from side pot
Mas101G: shows [7s As] (a pair of Fives)
10iz9 collected 3422 from main pot
Mas101G finished the tournament in 8th place
*** SUMMARY ***
Total pot 3744 Main pot 3422. Side pot 322. | Rake 0
Board [5d 4c 8d 5h Kh]
Seat 2: 10iz9 showed [4h 4d] and won (3744) with a full house, Fours full of Fives
Seat 3: karawondo folded on the Flop
Seat 4: IncrementX folded before Flop (didn't bet)
Seat 5: Mas101G (button) showed [7s As] and lost with a pair of Fives
Seat 6: dimetruk (small blind) folded on the Flop
Seat 7: sergei930 (big blind) folded before Flop
Seat 8: gnella13 folded before Flop (didn't bet)
Seat 9: fernandovgt showed [6d Qd] and lost with a pair of Fives


PokerStars Hand #226613757574: Tournament #3190325009, $13.70+$1.30 USD Hold'em No Limit - Level III (25/50) - 2021/05/09 23:07:18 MSK [2021/05/09 16:07:18 ET]
Table '3190325009 1' 9-max Seat #3 is the button
Seat 2: 10iz9 (3465 in chips)
Seat 3: karawondo (1558 in chips)
Seat 4: IncrementX (2749 in chips)
Seat 6: dimetruk (1147 in chips)
Seat 7: sergei930 (1536 in chips)
Seat 8: gnella13 (957 in chips)
Seat 9: fernandovgt (2088 in chips)
10iz9: posts the ante 6
karawondo: posts the ante 6
IncrementX: posts the ante 6
dimetruk: posts the ante 6
sergei930: posts the ante 6
gnella13: posts the ante 6
fernandovgt: posts the ante 6
IncrementX: posts small blind 25
dimetruk: posts big blind 50
*** HOLE CARDS ***
Dealt to dimetruk [6d 6c]
sergei930: folds
gnella13: folds
fernandovgt: calls 50
10iz9: folds
karawondo: raises 50 to 100
IncrementX: folds
dimetruk: calls 50
fernandovgt: calls 50
*** FLOP *** [5s Tc 2d]
dimetruk: checks
fernandovgt: bets 183
karawondo: raises 183 to 366
dimetruk: folds
fernandovgt: raises 1099 to 1465
karawondo: calls 1086 and is all-in
Uncalled bet (13) returned to fernandovgt
*** TURN *** [5s Tc 2d] [As]
*** RIVER *** [5s Tc 2d As] [Qs]
*** SHOW DOWN ***
fernandovgt: shows [Td Qd] (two pair, Queens and Tens)
karawondo: shows [Jc 9c] (high card Ace)
fernandovgt collected 3271 from pot
karawondo finished the tournament in 7th place
*** SUMMARY ***
Total pot 3271 | Rake 0
Board [5s Tc 2d As Qs]
Seat 2: 10iz9 folded before Flop (didn't bet)
Seat 3: karawondo (button) showed [Jc 9c] and lost with high card Ace
Seat 4: IncrementX (small blind) folded before Flop
Seat 6: dimetruk (big blind) folded on the Flop
Seat 7: sergei930 folded before Flop (didn't bet)
Seat 8: gnella13 folded before Flop (didn't bet)
Seat 9: fernandovgt showed [Td Qd] and won (3271) with two pair, Queens and Tens


PokerStars Hand #226613838445: Tournament #3190325009, $13.70+$1.30 USD Hold'em No Limit - Level III (25/50) - 2021/05/09 23:09:14 MSK [2021/05/09 16:09:14 ET]
Table '3190325009 1' 9-max Seat #7 is the button
Seat 2: 10iz9 (3447 in chips)
Seat 4: IncrementX (2706 in chips)
Seat 6: dimetruk (1115 in chips)
Seat 7: sergei930 (984 in chips)
Seat 8: gnella13 (889 in chips)
Seat 9: fernandovgt (4359 in chips)
10iz9: posts the ante 6
IncrementX: posts the ante 6
dimetruk: posts the ante 6
sergei930: posts the ante 6
gnella13: posts the ante 6
fernandovgt: posts the ante 6
gnella13: posts small blind 25
fernandovgt: posts big blind 50
*** HOLE CARDS ***
Dealt to dimetruk [Kd 7s]
10iz9: folds
IncrementX: folds
dimetruk: raises 50 to 100
sergei930: folds
gnella13: folds
fernandovgt: calls 50
*** FLOP *** [2s 3h 6c]
fernandovgt: checks
dimetruk: bets 175
fernandovgt: folds
Uncalled bet (175) returned to dimetruk
dimetruk collected 261 from pot
dimetruk: doesn't show hand
*** SUMMARY ***
Total pot 261 | Rake 0
Board [2s 3h 6c]
Seat 2: 10iz9 folded before Flop (didn't bet)
Seat 4: IncrementX folded before Flop (didn't bet)
Seat 6: dimetruk collected (261)
Seat 7: sergei930 (button) folded before Flop (didn't bet)
Seat 8: gnella13 (small blind) folded before Flop
Seat 9: fernandovgt (big blind) folded on the Flop


PokerStars Hand #226613879085: Tournament #3190325009, $13.70+$1.30 USD Hold'em No Limit - Level III (25/50) - 2021/05/09 23:10:16 MSK [2021/05/09 16:10:16 ET]
Table '3190325009 1' 9-max Seat #9 is the button
Seat 2: 10iz9 (3385 in chips)
Seat 4: IncrementX (2980 in chips)
Seat 6: dimetruk (1264 in chips)
Seat 7: sergei930 (972 in chips)
Seat 8: gnella13 (852 in chips)
Seat 9: fernandovgt (4047 in chips)
10iz9: posts the ante 6
IncrementX: posts the ante 6
dimetruk: posts the ante 6
sergei930: posts the ante 6
gnella13: posts the ante 6
fernandovgt: posts the ante 6
10iz9: posts small blind 25
IncrementX: posts big blind 50
*** HOLE CARDS ***
Dealt to dimetruk [Qd Qc]
dimetruk: raises 50 to 100
sergei930: folds
gnella13: folds
fernandovgt: folds
10iz9: calls 75
IncrementX: calls 50
*** FLOP *** [As 4s 5s]
10iz9: checks
IncrementX: checks
dimetruk: checks
*** TURN *** [As 4s 5s] [3d]
10iz9: bets 100
IncrementX: calls 100
dimetruk: folds
*** RIVER *** [As 4s 5s 3d] [Js]
10iz9: bets 250
IncrementX: folds
Uncalled bet (250) returned to 10iz9
10iz9 collected 536 from pot
10iz9: doesn't show hand
*** SUMMARY ***
Total pot 536 | Rake 0
Board [As 4s 5s 3d Js]
Seat 2: 10iz9 (small blind) collected (536)
Seat 4: IncrementX (big blind) folded on the River
Seat 6: dimetruk folded on the Turn
Seat 7: sergei930 folded before Flop (didn't bet)
Seat 8: gnella13 folded before Flop (didn't bet)
Seat 9: fernandovgt (button) folded before Flop (didn't bet)


PokerStars Hand #226613923007: Tournament #3190325009, $13.70+$1.30 USD Hold'em No Limit - Level III (25/50) - 2021/05/09 23:11:24 MSK [2021/05/09 16:11:24 ET]
Table '3190325009 1' 9-max Seat #2 is the button
Seat 2: 10iz9 (3715 in chips)
Seat 4: IncrementX (2774 in chips)
Seat 6: dimetruk (1158 in chips)
Seat 7: sergei930 (966 in chips)
Seat 8: gnella13 (846 in chips)
Seat 9: fernandovgt (4041 in chips)
10iz9: posts the ante 6
IncrementX: posts the ante 6
dimetruk: posts the ante 6
sergei930: posts the ante 6
gnella13: posts the ante 6
fernandovgt: posts the ante 6
IncrementX: posts small blind 25
dimetruk: posts big blind 50
*** HOLE CARDS ***
Dealt to dimetruk [Jd Qd]
sergei930: folds
gnella13: folds
fernandovgt: calls 50
10iz9: folds
IncrementX: folds
dimetruk: checks
*** FLOP *** [Kh 6c 3d]
dimetruk: checks
fernandovgt: checks
*** TURN *** [Kh 6c 3d] [2d]
dimetruk: bets 81
fernandovgt: calls 81
*** RIVER *** [Kh 6c 3d 2d] [Ks]
dimetruk: bets 216
fernandovgt: calls 216
*** SHOW DOWN ***
dimetruk: shows [Jd Qd] (a pair of Kings)
fernandovgt: shows [6h 9h] (two pair, Kings and Sixes)
fernandovgt collected 755 from pot
*** SUMMARY ***
Total pot 755 | Rake 0
Board [Kh 6c 3d 2d Ks]
Seat 2: 10iz9 (button) folded before Flop (didn't bet)
Seat 4: IncrementX (small blind) folded before Flop
Seat 6: dimetruk (big blind) showed [Jd Qd] and lost with a pair of Kings
Seat 7: sergei930 folded before Flop (didn't bet)
Seat 8: gnella13 folded before Flop (didn't bet)
Seat 9: fernandovgt showed [6h 9h] and won (755) with two pair, Kings and Sixes


PokerStars Hand #226613988258: Tournament #3190325009, $13.70+$1.30 USD Hold'em No Limit - Level IV (40/80) - 2021/05/09 23:13:04 MSK [2021/05/09 16:13:04 ET]
Table '3190325009 1' 9-max Seat #8 is the button
Seat 2: 10iz9 (3848 in chips)
Seat 4: IncrementX (2721 in chips)
Seat 6: dimetruk (758 in chips)
Seat 7: sergei930 (1043 in chips)
Seat 8: gnella13 (939 in chips)
Seat 9: fernandovgt (4191 in chips)
10iz9: posts the ante 10
IncrementX: posts the ante 10
dimetruk: posts the ante 10
sergei930: posts the ante 10
gnella13: posts the ante 10
fernandovgt: posts the ante 10
fernandovgt: posts small blind 40
10iz9: posts big blind 80
*** HOLE CARDS ***
Dealt to dimetruk [Jh Qc]
IncrementX: folds
dimetruk: raises 668 to 748 and is all-in
sergei930: folds
gnella13: raises 181 to 929 and is all-in
fernandovgt: raises 3252 to 4181 and is all-in
10iz9: folds
Uncalled bet (3252) returned to fernandovgt
*** FLOP *** [Kh Qs 9h]
*** TURN *** [Kh Qs 9h] [Jd]
*** RIVER *** [Kh Qs 9h Jd] [4d]
*** SHOW DOWN ***
fernandovgt: shows [As Ks] (a pair of Kings)
gnella13: shows [Ac Jc] (a pair of Jacks)
fernandovgt collected 362 from side pot
dimetruk: shows [Jh Qc] (two pair, Queens and Jacks)
dimetruk collected 2384 from main pot
gnella13 finished the tournament in 6th place
*** SUMMARY ***
Total pot 2746 Main pot 2384. Side pot 362. | Rake 0
Board [Kh Qs 9h Jd 4d]
Seat 2: 10iz9 (big blind) folded before Flop
Seat 4: IncrementX folded before Flop (didn't bet)
Seat 6: dimetruk showed [Jh Qc] and won (2384) with two pair, Queens and Jacks
Seat 7: sergei930 folded before Flop (didn't bet)
Seat 8: gnella13 (button) showed [Ac Jc] and lost with a pair of Jacks
Seat 9: fernandovgt (small blind) showed [As Ks] and won (362) with a pair of Kings


PokerStars Hand #226614003154: Tournament #3190325009, $13.70+$1.30 USD Hold'em No Limit - Level IV (40/80) - 2021/05/09 23:13:27 MSK [2021/05/09 16:13:27 ET]
Table '3190325009 1' 9-max Seat #9 is the button
Seat 2: 10iz9 (3758 in chips)
Seat 4: IncrementX (2711 in chips)
Seat 6: dimetruk (2384 in chips)
Seat 7: sergei930 (1033 in chips)
Seat 9: fernandovgt (3614 in chips)
10iz9: posts the ante 10
IncrementX: posts the ante 10
dimetruk: posts the ante 10
sergei930: posts the ante 10
fernandovgt: posts the ante 10
10iz9: posts small blind 40
IncrementX: posts big blind 80
*** HOLE CARDS ***
Dealt to dimetruk [Ac Jd]
dimetruk: raises 80 to 160
sergei930: raises 863 to 1023 and is all-in
fernandovgt: folds
10iz9: folds
IncrementX: folds
dimetruk: calls 863
*** FLOP *** [3h As 6c]
*** TURN *** [3h As 6c] [Js]
*** RIVER *** [3h As 6c Js] [Qc]
*** SHOW DOWN ***
dimetruk: shows [Ac Jd] (two pair, Aces and Jacks)
sergei930: shows [Ad Kd] (a pair of Aces)
dimetruk collected 2216 from pot
sergei930 finished the tournament in 5th place
*** SUMMARY ***
Total pot 2216 | Rake 0
Board [3h As 6c Js Qc]
Seat 2: 10iz9 (small blind) folded before Flop
Seat 4: IncrementX (big blind) folded before Flop
Seat 6: dimetruk showed [Ac Jd] and won (2216) with two pair, Aces and Jacks
Seat 7: sergei930 showed [Ad Kd] and lost with a pair of Aces
Seat 9: fernandovgt (button) folded before Flop (didn't bet)


PokerStars Hand #226614030117: Tournament #3190325009, $13.70+$1.30 USD Hold'em No Limit - Level IV (40/80) - 2021/05/09 23:14:10 MSK [2021/05/09 16:14:10 ET]
Table '3190325009 1' 9-max Seat #2 is the button
Seat 2: 10iz9 (3708 in chips)
Seat 4: IncrementX (2621 in chips)
Seat 6: dimetruk (3567 in chips)
Seat 9: fernandovgt (3604 in chips)
10iz9: posts the ante 10
IncrementX: posts the ante 10
dimetruk: posts the ante 10
fernandovgt: posts the ante 10
IncrementX: posts small blind 40
dimetruk: posts big blind 80
*** HOLE CARDS ***
Dealt to dimetruk [9h Ts]
fernandovgt: calls 80
10iz9: folds
IncrementX: calls 40
dimetruk: checks
*** FLOP *** [9c 8s 2s]
IncrementX: checks
dimetruk: bets 120
fernandovgt: calls 120
IncrementX: folds
*** TURN *** [9c 8s 2s] [4s]
dimetruk: bets 260
fernandovgt: folds
Uncalled bet (260) returned to dimetruk
dimetruk collected 520 from pot
dimetruk: doesn't show hand
*** SUMMARY ***
Total pot 520 | Rake 0
Board [9c 8s 2s 4s]
Seat 2: 10iz9 (button) folded before Flop (didn't bet)
Seat 4: IncrementX (small blind) folded on the Flop
Seat 6: dimetruk (big blind) collected (520)
Seat 9: fernandovgt folded on the Turn


PokerStars Hand #226614067819: Tournament #3190325009, $13.70+$1.30 USD Hold'em No Limit - Level IV (40/80) - 2021/05/09 23:14:54 MSK [2021/05/09 16:14:54 ET]
Table '3190325009 1' 9-max Seat #4 is the button
Seat 2: 10iz9 (3698 in chips)
Seat 4: IncrementX (2531 in chips)
Seat 6: dimetruk (3877 in chips)
Seat 9: fernandovgt (3394 in chips)
10iz9: posts the ante 10
IncrementX: posts the ante 10
dimetruk: posts the ante 10
fernandovgt: posts the ante 10
dimetruk: posts small blind 40
fernandovgt: posts big blind 80
*** HOLE CARDS ***
Dealt to dimetruk [Jh 7h]
10iz9: folds
IncrementX: folds
dimetruk: raises 80 to 160
fernandovgt: calls 80
*** FLOP *** [5s 9h Qs]
dimetruk: checks
fernandovgt: checks
*** TURN *** [5s 9h Qs] [8s]
dimetruk: bets 180
fernandovgt: folds
Uncalled bet (180) returned to dimetruk
dimetruk collected 360 from pot
dimetruk: doesn't show hand
*** SUMMARY ***
Total pot 360 | Rake 0
Board [5s 9h Qs 8s]
Seat 2: 10iz9 folded before Flop (didn't bet)
Seat 4: IncrementX (button) folded before Flop (didn't bet)
Seat 6: dimetruk (small blind) collected (360)
Seat 9: fernandovgt (big blind) folded on the Turn


PokerStars Hand #226614119739: Tournament #3190325009, $13.70+$1.30 USD Hold'em No Limit - Level IV (40/80) - 2021/05/09 23:16:13 MSK [2021/05/09 16:16:13 ET]
Table '3190325009 1' 9-max Seat #4 is the button
Seat 2: 10iz9 (4018 in chips)
Seat 4: IncrementX (2371 in chips)
Seat 6: dimetruk (3957 in chips)
Seat 9: fernandovgt (3154 in chips)
10iz9: posts the ante 10
IncrementX: posts the ante 10
dimetruk: posts the ante 10
fernandovgt: posts the ante 10
dimetruk: posts small blind 40
fernandovgt: posts big blind 80
*** HOLE CARDS ***
Dealt to dimetruk [Ah 5c]
10iz9: folds
IncrementX: folds
dimetruk: raises 80 to 160
fernandovgt: raises 80 to 240
dimetruk: calls 80
*** FLOP *** [8d 3d As]
dimetruk: checks
fernandovgt: bets 80
dimetruk: calls 80
*** TURN *** [8d 3d As] [Jd]
dimetruk: checks
fernandovgt: bets 340
dimetruk: calls 340
*** RIVER *** [8d 3d As Jd] [6c]
dimetruk: checks
fernandovgt: bets 2484 and is all-in
dimetruk: folds
Uncalled bet (2484) returned to fernandovgt
fernandovgt collected 1360 from pot
fernandovgt: doesn't show hand
*** SUMMARY ***
Total pot 1360 | Rake 0
Board [8d 3d As Jd 6c]
Seat 2: 10iz9 folded before Flop (didn't bet)
Seat 4: IncrementX (button) folded before Flop (didn't bet)
Seat 6: dimetruk (small blind) folded on the River
Seat 9: fernandovgt (big blind) collected (1360)


PokerStars Hand #226614168691: Tournament #3190325009, $13.70+$1.30 USD Hold'em No Limit - Level IV (40/80) - 2021/05/09 23:17:27 MSK [2021/05/09 16:17:27 ET]
Table '3190325009 1' 9-max Seat #9 is the button
Seat 2: 10iz9 (4198 in chips)
Seat 4: IncrementX (2351 in chips)
Seat 6: dimetruk (3277 in chips)
Seat 9: fernandovgt (3674 in chips)
10iz9: posts the ante 10
IncrementX: posts the ante 10
dimetruk: posts the ante 10
fernandovgt: posts the ante 10
10iz9: posts small blind 40
IncrementX: posts big blind 80
*** HOLE CARDS ***
Dealt to dimetruk [6h Ah]
dimetruk: raises 80 to 160
fernandovgt: folds
10iz9: folds
IncrementX: calls 80
*** FLOP *** [9c 3c 5h]
IncrementX: checks
dimetruk: checks
*** TURN *** [9c 3c 5h] [6d]
IncrementX: checks
dimetruk: bets 200
IncrementX: folds
Uncalled bet (200) returned to dimetruk
dimetruk collected 400 from pot
dimetruk: doesn't show hand
*** SUMMARY ***
Total pot 400 | Rake 0
Board [9c 3c 5h 6d]
Seat 2: 10iz9 (small blind) folded before Flop
Seat 4: IncrementX (big blind) folded on the Turn
Seat 6: dimetruk collected (400)
Seat 9: fernandovgt (button) folded before Flop (didn't bet)


PokerStars Hand #226614193704: Tournament #3190325009, $13.70+$1.30 USD Hold'em No Limit - Level IV (40/80) - 2021/05/09 23:18:04 MSK [2021/05/09 16:18:04 ET]
Table '3190325009 1' 9-max Seat #4 is the button
Seat 2: 10iz9 (4138 in chips)
Seat 4: IncrementX (2131 in chips)
Seat 6: dimetruk (3577 in chips)
Seat 9: fernandovgt (3654 in chips)
10iz9: posts the ante 10
IncrementX: posts the ante 10
dimetruk: posts the ante 10
fernandovgt: posts the ante 10
dimetruk: posts small blind 40
fernandovgt: posts big blind 80
*** HOLE CARDS ***
Dealt to dimetruk [7s 6d]
10iz9: folds
IncrementX: folds
dimetruk: calls 40
fernandovgt: checks
*** FLOP *** [6s 7d Qc]
dimetruk: bets 120
fernandovgt: folds
Uncalled bet (120) returned to dimetruk
dimetruk collected 200 from pot
dimetruk: doesn't show hand
*** SUMMARY ***
Total pot 200 | Rake 0
Board [6s 7d Qc]
Seat 2: 10iz9 folded before Flop (didn't bet)
Seat 4: IncrementX (button) folded before Flop (didn't bet)
Seat 6: dimetruk (small blind) collected (200)
Seat 9: fernandovgt (big blind) folded on the Flop


PokerStars Hand #226614203936: Tournament #3190325009, $13.70+$1.30 USD Hold'em No Limit - Level IV (40/80) - 2021/05/09 23:18:20 MSK [2021/05/09 16:18:20 ET]
Table '3190325009 1' 9-max Seat #6 is the button
Seat 2: 10iz9 (4128 in chips)
Seat 4: IncrementX (2121 in chips)
Seat 6: dimetruk (3687 in chips)
Seat 9: fernandovgt (3564 in chips)
10iz9: posts the ante 10
IncrementX: posts the ante 10
dimetruk: posts the ante 10
fernandovgt: posts the ante 10
fernandovgt: posts small blind 40
10iz9: posts big blind 80
*** HOLE CARDS ***
Dealt to dimetruk [2h 2s]
IncrementX: folds
dimetruk: raises 80 to 160
fernandovgt: calls 120
10iz9: folds
*** FLOP *** [Kh Tc 2d]
fernandovgt: checks
dimetruk: bets 220
fernandovgt: folds
Uncalled bet (220) returned to dimetruk
dimetruk collected 440 from pot
dimetruk: doesn't show hand
*** SUMMARY ***
Total pot 440 | Rake 0
Board [Kh Tc 2d]
Seat 2: 10iz9 (big blind) folded before Flop
Seat 4: IncrementX folded before Flop (didn't bet)
Seat 6: dimetruk (button) collected (440)
Seat 9: fernandovgt (small blind) folded on the Flop


PokerStars Hand #226614242871: Tournament #3190325009, $13.70+$1.30 USD Hold'em No Limit - Level IV (40/80) - 2021/05/09 23:19:18 MSK [2021/05/09 16:19:18 ET]
Table '3190325009 1' 9-max Seat #4 is the button
Seat 2: 10iz9 (4138 in chips)
Seat 4: IncrementX (2311 in chips)
Seat 6: dimetruk (3677 in chips)
Seat 9: fernandovgt (3374 in chips)
10iz9: posts the ante 10
IncrementX: posts the ante 10
dimetruk: posts the ante 10
fernandovgt: posts the ante 10
dimetruk: posts small blind 40
fernandovgt: posts big blind 80
*** HOLE CARDS ***
Dealt to dimetruk [Tc 9h]
10iz9: folds
IncrementX: folds
dimetruk: raises 80 to 160
fernandovgt: calls 80
*** FLOP *** [Ah Jd Ac]
dimetruk: bets 126
fernandovgt: folds
Uncalled bet (126) returned to dimetruk
dimetruk collected 360 from pot
dimetruk: doesn't show hand
*** SUMMARY ***
Total pot 360 | Rake 0
Board [Ah Jd Ac]
Seat 2: 10iz9 folded before Flop (didn't bet)
Seat 4: IncrementX (button) folded before Flop (didn't bet)
Seat 6: dimetruk (small blind) collected (360)
Seat 9: fernandovgt (big blind) folded on the Flop


PokerStars Hand #226614354972: Tournament #3190325009, $13.70+$1.30 USD Hold'em No Limit - Level IV (40/80) - 2021/05/09 23:21:54 MSK [2021/05/09 16:21:54 ET]
Table '3190325009 1' 9-max Seat #6 is the button
Seat 2: 10iz9 (4768 in chips)
Seat 4: IncrementX (1821 in chips)
Seat 6: dimetruk (3867 in chips)
Seat 9: fernandovgt (3044 in chips)
10iz9: posts the ante 10
IncrementX: posts the ante 10
dimetruk: posts the ante 10
fernandovgt: posts the ante 10
fernandovgt: posts small blind 40
10iz9: posts big blind 80
*** HOLE CARDS ***
Dealt to dimetruk [9h Ks]
IncrementX: folds
dimetruk: raises 80 to 160
fernandovgt: folds
10iz9: calls 80
*** FLOP *** [8d 4c Kh]
10iz9: checks
dimetruk: checks
*** TURN *** [8d 4c Kh] [As]
10iz9: checks
dimetruk: checks
*** RIVER *** [8d 4c Kh As] [9s]
10iz9: bets 160
dimetruk: calls 160
*** SHOW DOWN ***
10iz9: shows [Ts 4h] (a pair of Fours)
dimetruk: shows [9h Ks] (two pair, Kings and Nines)
dimetruk collected 720 from pot
*** SUMMARY ***
Total pot 720 | Rake 0
Board [8d 4c Kh As 9s]
Seat 2: 10iz9 (big blind) showed [Ts 4h] and lost with a pair of Fours
Seat 4: IncrementX folded before Flop (didn't bet)
Seat 6: dimetruk (button) showed [9h Ks] and won (720) with two pair, Kings and Nines
Seat 9: fernandovgt (small blind) folded before Flop


PokerStars Hand #226614435795: Tournament #3190325009, $13.70+$1.30 USD Hold'em No Limit - Level V (60/120) - 2021/05/09 23:23:58 MSK [2021/05/09 16:23:58 ET]
Table '3190325009 1' 9-max Seat #2 is the button
Seat 2: 10iz9 (4748 in chips)
Seat 4: IncrementX (1961 in chips)
Seat 6: dimetruk (4247 in chips)
Seat 9: fernandovgt (2544 in chips)
10iz9: posts the ante 15
IncrementX: posts the ante 15
dimetruk: posts the ante 15
fernandovgt: posts the ante 15
IncrementX: posts small blind 60
dimetruk: posts big blind 120
*** HOLE CARDS ***
Dealt to dimetruk [9d 5h]
fernandovgt: calls 120
10iz9: folds
IncrementX: folds
dimetruk: checks
*** FLOP *** [Ad Kh Qh]
dimetruk: checks
fernandovgt: checks
*** TURN *** [Ad Kh Qh] [5d]
dimetruk: checks
fernandovgt: checks
*** RIVER *** [Ad Kh Qh 5d] [Ac]
dimetruk: checks
fernandovgt: bets 120
dimetruk: calls 120
*** SHOW DOWN ***
fernandovgt: shows [Td Th] (two pair, Aces and Tens)
dimetruk: mucks hand
fernandovgt collected 600 from pot
*** SUMMARY ***
Total pot 600 | Rake 0
Board [Ad Kh Qh 5d Ac]
Seat 2: 10iz9 (button) folded before Flop (didn't bet)
Seat 4: IncrementX (small blind) folded before Flop
Seat 6: dimetruk (big blind) mucked [9d 5h]
Seat 9: fernandovgt showed [Td Th] and won (600) with two pair, Aces and Tens


PokerStars Hand #226614507337: Tournament #3190325009, $13.70+$1.30 USD Hold'em No Limit - Level V (60/120) - 2021/05/09 23:25:47 MSK [2021/05/09 16:25:47 ET]
Table '3190325009 1' 9-max Seat #6 is the button
Seat 2: 10iz9 (3158 in chips)
Seat 4: IncrementX (2111 in chips)
Seat 6: dimetruk (3917 in chips)
Seat 9: fernandovgt (4314 in chips)
10iz9: posts the ante 15
IncrementX: posts the ante 15
dimetruk: posts the ante 15
fernandovgt: posts the ante 15
fernandovgt: posts small blind 60
10iz9: posts big blind 120
*** HOLE CARDS ***
Dealt to dimetruk [Js Td]
IncrementX: folds
dimetruk: raises 120 to 240
fernandovgt: calls 180
10iz9: calls 120
*** FLOP *** [Ts Kc 5c]
fernandovgt: checks
10iz9: checks
dimetruk: checks
*** TURN *** [Ts Kc 5c] [7d]
fernandovgt: checks
10iz9: bets 480
dimetruk: calls 480
fernandovgt: folds
*** RIVER *** [Ts Kc 5c 7d] [4s]
10iz9: bets 1200
dimetruk: folds
Uncalled bet (1200) returned to 10iz9
10iz9 collected 1740 from pot
10iz9: doesn't show hand
*** SUMMARY ***
Total pot 1740 | Rake 0
Board [Ts Kc 5c 7d 4s]
Seat 2: 10iz9 (big blind) collected (1740)
Seat 4: IncrementX folded before Flop (didn't bet)
Seat 6: dimetruk (button) folded on the River
Seat 9: fernandovgt (small blind) folded on the Turn


PokerStars Hand #226614528217: Tournament #3190325009, $13.70+$1.30 USD Hold'em No Limit - Level V (60/120) - 2021/05/09 23:26:19 MSK [2021/05/09 16:26:19 ET]
Table '3190325009 1' 9-max Seat #9 is the button
Seat 2: 10iz9 (4163 in chips)
Seat 4: IncrementX (2096 in chips)
Seat 6: dimetruk (3182 in chips)
Seat 9: fernandovgt (4059 in chips)
10iz9: posts the ante 15
IncrementX: posts the ante 15
dimetruk: posts the ante 15
fernandovgt: posts the ante 15
10iz9: posts small blind 60
IncrementX: posts big blind 120
*** HOLE CARDS ***
Dealt to dimetruk [Ks Jh]
dimetruk: raises 120 to 240
fernandovgt: folds
10iz9: calls 180
IncrementX: folds
*** FLOP *** [2d 9h 8h]
10iz9: checks
dimetruk: bets 442
10iz9: calls 442
*** TURN *** [2d 9h 8h] [7c]
10iz9: checks
dimetruk: checks
*** RIVER *** [2d 9h 8h 7c] [As]
10iz9: checks
dimetruk: checks
*** SHOW DOWN ***
10iz9: shows [Kh Qh] (high card Ace)
dimetruk: mucks hand
10iz9 collected 1544 from pot
*** SUMMARY ***
Total pot 1544 | Rake 0
Board [2d 9h 8h 7c As]
Seat 2: 10iz9 (small blind) showed [Kh Qh] and won (1544) with high card Ace
Seat 4: IncrementX (big blind) folded before Flop
Seat 6: dimetruk mucked [Ks Jh]
Seat 9: fernandovgt (button) folded before Flop (didn't bet)


PokerStars Hand #226614557306: Tournament #3190325009, $13.70+$1.30 USD Hold'em No Limit - Level V (60/120) - 2021/05/09 23:27:04 MSK [2021/05/09 16:27:04 ET]
Table '3190325009 1' 9-max Seat #4 is the button
Seat 2: 10iz9 (5235 in chips)
Seat 4: IncrementX (1886 in chips)
Seat 6: dimetruk (2350 in chips)
Seat 9: fernandovgt (4029 in chips)
10iz9: posts the ante 15
IncrementX: posts the ante 15
dimetruk: posts the ante 15
fernandovgt: posts the ante 15
dimetruk: posts small blind 60
fernandovgt: posts big blind 120
*** HOLE CARDS ***
Dealt to dimetruk [7h Qh]
10iz9: folds
IncrementX: folds
dimetruk: raises 120 to 240
fernandovgt: calls 120
*** FLOP *** [2d 2s 3c]
dimetruk: bets 270
fernandovgt: calls 270
*** TURN *** [2d 2s 3c] [8d]
dimetruk: checks
fernandovgt: checks
*** RIVER *** [2d 2s 3c 8d] [3s]
dimetruk: checks
fernandovgt: bets 2160
dimetruk: folds
Uncalled bet (2160) returned to fernandovgt
fernandovgt collected 1080 from pot
fernandovgt: doesn't show hand
*** SUMMARY ***
Total pot 1080 | Rake 0
Board [2d 2s 3c 8d 3s]
Seat 2: 10iz9 folded before Flop (didn't bet)
Seat 4: IncrementX (button) folded before Flop (didn't bet)
Seat 6: dimetruk (small blind) folded on the River
Seat 9: fernandovgt (big blind) collected (1080)


PokerStars Hand #226614604819: Tournament #3190325009, $13.70+$1.30 USD Hold'em No Limit - Level V (60/120) - 2021/05/09 23:28:17 MSK [2021/05/09 16:28:17 ET]
Table '3190325009 1' 9-max Seat #2 is the button
Seat 2: 10iz9 (5310 in chips)
Seat 4: IncrementX (1961 in chips)
Seat 6: dimetruk (1795 in chips)
Seat 9: fernandovgt (4434 in chips)
10iz9: posts the ante 15
IncrementX: posts the ante 15
dimetruk: posts the ante 15
fernandovgt: posts the ante 15
IncrementX: posts small blind 60
dimetruk: posts big blind 120
*** HOLE CARDS ***
Dealt to dimetruk [Qh Ks]
fernandovgt: folds
10iz9: folds
IncrementX: raises 1826 to 1946 and is all-in
dimetruk: calls 1660 and is all-in
Uncalled bet (166) returned to IncrementX
*** FLOP *** [7s 6d 6h]
*** TURN *** [7s 6d 6h] [Kh]
*** RIVER *** [7s 6d 6h Kh] [3d]
*** SHOW DOWN ***
IncrementX: shows [4c 4s] (two pair, Sixes and Fours)
dimetruk: shows [Qh Ks] (two pair, Kings and Sixes)
dimetruk collected 3620 from pot
*** SUMMARY ***
Total pot 3620 | Rake 0
Board [7s 6d 6h Kh 3d]
Seat 2: 10iz9 (button) folded before Flop (didn't bet)
Seat 4: IncrementX (small blind) showed [4c 4s] and lost with two pair, Sixes and Fours
Seat 6: dimetruk (big blind) showed [Qh Ks] and won (3620) with two pair, Kings and Sixes
Seat 9: fernandovgt folded before Flop (didn't bet)


PokerStars Hand #226614646391: Tournament #3190325009, $13.70+$1.30 USD Hold'em No Limit - Level V (60/120) - 2021/05/09 23:29:21 MSK [2021/05/09 16:29:21 ET]
Table '3190325009 1' 9-max Seat #9 is the button
Seat 2: 10iz9 (5505 in chips)
Seat 4: IncrementX (136 in chips)
Seat 6: dimetruk (3290 in chips)
Seat 9: fernandovgt (4569 in chips)
10iz9: posts the ante 15
IncrementX: posts the ante 15
dimetruk: posts the ante 15
fernandovgt: posts the ante 15
10iz9: posts small blind 60
IncrementX: posts big blind 120
*** HOLE CARDS ***
Dealt to dimetruk [Ah 2d]
dimetruk: raises 120 to 240
fernandovgt: folds
10iz9: calls 180
IncrementX: calls 1 and is all-in
*** FLOP *** [7d Jh 7h]
10iz9: checks
dimetruk: checks
*** TURN *** [7d Jh 7h] [9d]
10iz9: checks
dimetruk: checks
*** RIVER *** [7d Jh 7h 9d] [3s]
10iz9: checks
dimetruk: checks
*** SHOW DOWN ***
10iz9: shows [Ts 5c] (a pair of Sevens)
dimetruk: shows [Ah 2d] (a pair of Sevens - Ace kicker)
dimetruk collected 238 from side pot
IncrementX: shows [7s 3h] (a full house, Sevens full of Threes)
IncrementX collected 423 from main pot
*** SUMMARY ***
Total pot 661 Main pot 423. Side pot 238. | Rake 0
Board [7d Jh 7h 9d 3s]
Seat 2: 10iz9 (small blind) showed [Ts 5c] and lost with a pair of Sevens
Seat 4: IncrementX (big blind) showed [7s 3h] and won (423) with a full house, Sevens full of Threes
Seat 6: dimetruk showed [Ah 2d] and won (238) with a pair of Sevens
Seat 9: fernandovgt (button) folded before Flop (didn't bet)


PokerStars Hand #226614672522: Tournament #3190325009, $13.70+$1.30 USD Hold'em No Limit - Level V (60/120) - 2021/05/09 23:30:02 MSK [2021/05/09 16:30:02 ET]
Table '3190325009 1' 9-max Seat #4 is the button
Seat 2: 10iz9 (5235 in chips)
Seat 4: IncrementX (348 in chips)
Seat 6: dimetruk (3378 in chips)
Seat 9: fernandovgt (4539 in chips)
10iz9: posts the ante 15
IncrementX: posts the ante 15
dimetruk: posts the ante 15
fernandovgt: posts the ante 15
dimetruk: posts small blind 60
fernandovgt: posts big blind 120
*** HOLE CARDS ***
Dealt to dimetruk [Jh Ad]
10iz9: folds
IncrementX: folds
dimetruk: raises 120 to 240
fernandovgt: calls 120
*** FLOP *** [5s 7d Kh]
dimetruk: bets 189
fernandovgt: calls 189
*** TURN *** [5s 7d Kh] [2c]
dimetruk: bets 459
fernandovgt: folds
Uncalled bet (459) returned to dimetruk
dimetruk collected 918 from pot
dimetruk: doesn't show hand
*** SUMMARY ***
Total pot 918 | Rake 0
Board [5s 7d Kh 2c]
Seat 2: 10iz9 folded before Flop (didn't bet)
Seat 4: IncrementX (button) folded before Flop (didn't bet)
Seat 6: dimetruk (small blind) collected (918)
Seat 9: fernandovgt (big blind) folded on the Turn


PokerStars Hand #226614716817: Tournament #3190325009, $13.70+$1.30 USD Hold'em No Limit - Level V (60/120) - 2021/05/09 23:31:10 MSK [2021/05/09 16:31:10 ET]
Table '3190325009 1' 9-max Seat #2 is the button
Seat 2: 10iz9 (9585 in chips)
Seat 4: IncrementX (318 in chips)
Seat 6: dimetruk (3597 in chips)
10iz9: posts the ante 15
IncrementX: posts the ante 15
dimetruk: posts the ante 15
IncrementX: posts small blind 60
dimetruk: posts big blind 120
*** HOLE CARDS ***
Dealt to dimetruk [Qh Jd]
10iz9: folds
IncrementX: raises 183 to 303 and is all-in
dimetruk: calls 183
*** FLOP *** [3s 5d Ad]
*** TURN *** [3s 5d Ad] [2d]
*** RIVER *** [3s 5d Ad 2d] [8s]
*** SHOW DOWN ***
IncrementX: shows [9d Ac] (a pair of Aces)
dimetruk: shows [Qh Jd] (high card Ace)
IncrementX collected 651 from pot
*** SUMMARY ***
Total pot 651 | Rake 0
Board [3s 5d Ad 2d 8s]
Seat 2: 10iz9 (button) folded before Flop (didn't bet)
Seat 4: IncrementX (small blind) showed [9d Ac] and won (651) with a pair of Aces
Seat 6: dimetruk (big blind) showed [Qh Jd] and lost with high card Ace


PokerStars Hand #226614745297: Tournament #3190325009, $13.70+$1.30 USD Hold'em No Limit - Level V (60/120) - 2021/05/09 23:31:54 MSK [2021/05/09 16:31:54 ET]
Table '3190325009 1' 9-max Seat #2 is the button
Seat 2: 10iz9 (10311 in chips)
Seat 6: dimetruk (3189 in chips)
10iz9: posts the ante 15
dimetruk: posts the ante 15
10iz9: posts small blind 60
dimetruk: posts big blind 120
*** HOLE CARDS ***
Dealt to dimetruk [5h 8h]
10iz9: raises 120 to 240
dimetruk: calls 120
*** FLOP *** [5d Ad 6s]
dimetruk: checks
10iz9: bets 240
dimetruk: calls 240
*** TURN *** [5d Ad 6s] [4h]
dimetruk: checks
10iz9: checks
*** RIVER *** [5d Ad 6s 4h] [2h]
dimetruk: bets 720
10iz9: folds
Uncalled bet (720) returned to dimetruk
dimetruk collected 990 from pot
dimetruk: doesn't show hand
*** SUMMARY ***
Total pot 990 | Rake 0
Board [5d Ad 6s 4h 2h]
Seat 2: 10iz9 (button) (small blind) folded on the River
Seat 6: dimetruk (big blind) collected (990)


PokerStars Hand #226614762335: Tournament #3190325009, $13.70+$1.30 USD Hold'em No Limit - Level V (60/120) - 2021/05/09 23:32:21 MSK [2021/05/09 16:32:21 ET]
Table '3190325009 1' 9-max Seat #6 is the button
Seat 2: 10iz9 (9816 in chips)
Seat 6: dimetruk (3684 in chips)
10iz9: posts the ante 15
dimetruk: posts the ante 15
dimetruk: posts small blind 60
10iz9: posts big blind 120
*** HOLE CARDS ***
Dealt to dimetruk [9h Qh]
dimetruk: raises 120 to 240
10iz9: calls 120
*** FLOP *** [Jc Ad 6d]
10iz9: checks
dimetruk: bets 180
10iz9: raises 180 to 360
dimetruk: folds
Uncalled bet (180) returned to 10iz9
10iz9 collected 870 from pot
10iz9: doesn't show hand
*** SUMMARY ***
Total pot 870 | Rake 0
Board [Jc Ad 6d]
Seat 2: 10iz9 (big blind) collected (870)
Seat 6: dimetruk (button) (small blind) folded on the Flop


PokerStars Hand #226614771902: Tournament #3190325009, $13.70+$1.30 USD Hold'em No Limit - Level V (60/120) - 2021/05/09 23:32:36 MSK [2021/05/09 16:32:36 ET]
Table '3190325009 1' 9-max Seat #2 is the button
Seat 2: 10iz9 (10251 in chips)
Seat 6: dimetruk (3249 in chips)
10iz9: posts the ante 15
dimetruk: posts the ante 15
10iz9: posts small blind 60
dimetruk: posts big blind 120
*** HOLE CARDS ***
Dealt to dimetruk [8h Th]
10iz9: raises 120 to 240
dimetruk: calls 120
*** FLOP *** [Jc Js Kd]
dimetruk: checks
10iz9: checks
*** TURN *** [Jc Js Kd] [Ts]
dimetruk: checks
10iz9: bets 360
dimetruk: folds
Uncalled bet (360) returned to 10iz9
10iz9 collected 510 from pot
10iz9: doesn't show hand
*** SUMMARY ***
Total pot 510 | Rake 0
Board [Jc Js Kd Ts]
Seat 2: 10iz9 (button) (small blind) collected (510)
Seat 6: dimetruk (big blind) folded on the Turn


PokerStars Hand #226614792254: Tournament #3190325009, $13.70+$1.30 USD Hold'em No Limit - Level VI (80/160) - 2021/05/09 23:33:08 MSK [2021/05/09 16:33:08 ET]
Table '3190325009 1' 9-max Seat #2 is the button
Seat 2: 10iz9 (10686 in chips)
Seat 6: dimetruk (2814 in chips)
10iz9: posts the ante 20
dimetruk: posts the ante 20
10iz9: posts small blind 80
dimetruk: posts big blind 160
*** HOLE CARDS ***
Dealt to dimetruk [Td 9d]
10iz9: raises 160 to 320
dimetruk: raises 2474 to 2794 and is all-in
10iz9: calls 2474
*** FLOP *** [7h Jc Ah]
*** TURN *** [7h Jc Ah] [8d]
*** RIVER *** [7h Jc Ah 8d] [Qs]
*** SHOW DOWN ***
dimetruk: shows [Td 9d] (a straight, Eight to Queen)
10iz9: shows [Kh 5h] (high card Ace)
dimetruk collected 5628 from pot
*** SUMMARY ***
Total pot 5628 | Rake 0
Board [7h Jc Ah 8d Qs]
Seat 2: 10iz9 (button) (small blind) showed [Kh 5h] and lost with high card Ace
Seat 6: dimetruk (big blind) showed [Td 9d] and won (5628) with a straight, Eight to Queen


PokerStars Hand #226614805032: Tournament #3190325009, $13.70+$1.30 USD Hold'em No Limit - Level VI (80/160) - 2021/05/09 23:33:28 MSK [2021/05/09 16:33:28 ET]
Table '3190325009 1' 9-max Seat #2 is the button
Seat 2: 10iz9 (7972 in chips)
Seat 6: dimetruk (5528 in chips)
10iz9: posts the ante 20
dimetruk: posts the ante 20
10iz9: posts small blind 80
dimetruk: posts big blind 160
*** HOLE CARDS ***
Dealt to dimetruk [5d Ad]
10iz9: raises 160 to 320
dimetruk: calls 160
*** FLOP *** [3d 6h Kh]
dimetruk: checks
10iz9: bets 480
dimetruk: folds
Uncalled bet (480) returned to 10iz9
10iz9 collected 680 from pot
10iz9: doesn't show hand
*** SUMMARY ***
Total pot 680 | Rake 0
Board [3d 6h Kh]
Seat 2: 10iz9 (button) (small blind) collected (680)
Seat 6: dimetruk (big blind) folded on the Flop


PokerStars Hand #226614817112: Tournament #3190325009, $13.70+$1.30 USD Hold'em No Limit - Level VI (80/160) - 2021/05/09 23:33:47 MSK [2021/05/09 16:33:47 ET]
Table '3190325009 1' 9-max Seat #6 is the button
Seat 2: 10iz9 (8312 in chips)
Seat 6: dimetruk (5188 in chips)
10iz9: posts the ante 20
dimetruk: posts the ante 20
dimetruk: posts small blind 80
10iz9: posts big blind 160
*** HOLE CARDS ***
Dealt to dimetruk [As Ad]
dimetruk: raises 160 to 320
10iz9: calls 160
*** FLOP *** [4h 6s Jh]
10iz9: checks
dimetruk: bets 340
10iz9: calls 340
*** TURN *** [4h 6s Jh] [6c]
10iz9: checks
dimetruk: checks
*** RIVER *** [4h 6s Jh 6c] [2c]
10iz9: bets 960
dimetruk: calls 960
*** SHOW DOWN ***
10iz9: shows [5d 9h] (a pair of Sixes)
dimetruk: shows [As Ad] (two pair, Aces and Sixes)
dimetruk collected 3280 from pot
*** SUMMARY ***
Total pot 3280 | Rake 0
Board [4h 6s Jh 6c 2c]
Seat 2: 10iz9 (big blind) showed [5d 9h] and lost with a pair of Sixes
Seat 6: dimetruk (button) (small blind) showed [As Ad] and won (3280) with two pair, Aces and Sixes


PokerStars Hand #226614840546: Tournament #3190325009, $13.70+$1.30 USD Hold'em No Limit - Level VI (80/160) - 2021/05/09 23:34:24 MSK [2021/05/09 16:34:24 ET]
Table '3190325009 1' 9-max Seat #6 is the button
Seat 2: 10iz9 (6852 in chips)
Seat 6: dimetruk (6648 in chips)
10iz9: posts the ante 20
dimetruk: posts the ante 20
dimetruk: posts small blind 80
10iz9: posts big blind 160
*** HOLE CARDS ***
Dealt to dimetruk [Td Js]
dimetruk: raises 160 to 320
10iz9: calls 160
*** FLOP *** [9s Kh Ad]
10iz9: checks
dimetruk: bets 240
10iz9: raises 560 to 800
dimetruk: calls 560
*** TURN *** [9s Kh Ad] [Ts]
10iz9: checks
dimetruk: checks
*** RIVER *** [9s Kh Ad Ts] [Kd]
10iz9: bets 1120
dimetruk: folds
Uncalled bet (1120) returned to 10iz9
10iz9 collected 2280 from pot
10iz9: doesn't show hand
*** SUMMARY ***
Total pot 2280 | Rake 0
Board [9s Kh Ad Ts Kd]
Seat 2: 10iz9 (big blind) collected (2280)
Seat 6: dimetruk (button) (small blind) folded on the River


PokerStars Hand #226614866721: Tournament #3190325009, $13.70+$1.30 USD Hold'em No Limit - Level VI (80/160) - 2021/05/09 23:35:05 MSK [2021/05/09 16:35:05 ET]
Table '3190325009 1' 9-max Seat #2 is the button
Seat 2: 10iz9 (7992 in chips)
Seat 6: dimetruk (5508 in chips)
10iz9: posts the ante 20
dimetruk: posts the ante 20
10iz9: posts small blind 80
dimetruk: posts big blind 160
*** HOLE CARDS ***
Dealt to dimetruk [5s 5h]
10iz9: raises 160 to 320
dimetruk: calls 160
*** FLOP *** [9s 7c Kh]
dimetruk: checks
10iz9: bets 640
dimetruk: folds
Uncalled bet (640) returned to 10iz9
10iz9 collected 680 from pot
10iz9: doesn't show hand
*** SUMMARY ***
Total pot 680 | Rake 0
Board [9s 7c Kh]
Seat 2: 10iz9 (button) (small blind) collected (680)
Seat 6: dimetruk (big blind) folded on the Flop


PokerStars Hand #226614887325: Tournament #3190325009, $13.70+$1.30 USD Hold'em No Limit - Level VI (80/160) - 2021/05/09 23:35:37 MSK [2021/05/09 16:35:37 ET]
Table '3190325009 1' 9-max Seat #6 is the button
Seat 2: 10iz9 (8092 in chips)
Seat 6: dimetruk (5408 in chips)
10iz9: posts the ante 20
dimetruk: posts the ante 20
dimetruk: posts small blind 80
10iz9: posts big blind 160
*** HOLE CARDS ***
Dealt to dimetruk [8h 4s]
dimetruk: calls 80
10iz9: raises 160 to 320
dimetruk: raises 720 to 1040
10iz9: calls 720
*** FLOP *** [Ks 7d As]
10iz9: checks
dimetruk: bets 742
10iz9: calls 742
*** TURN *** [Ks 7d As] [6d]
10iz9: checks
dimetruk: checks
*** RIVER *** [Ks 7d As 6d] [Kd]
10iz9: checks
dimetruk: checks
*** SHOW DOWN ***
10iz9: shows [Th Js] (a pair of Kings)
dimetruk: mucks hand
10iz9 collected 3604 from pot
*** SUMMARY ***
Total pot 3604 | Rake 0
Board [Ks 7d As 6d Kd]
Seat 2: 10iz9 (big blind) showed [Th Js] and won (3604) with a pair of Kings
Seat 6: dimetruk (button) (small blind) mucked [8h 4s]


PokerStars Hand #226614927532: Tournament #3190325009, $13.70+$1.30 USD Hold'em No Limit - Level VI (80/160) - 2021/05/09 23:36:26 MSK [2021/05/09 16:36:26 ET]
Table '3190325009 1' 9-max Seat #2 is the button
Seat 2: 10iz9 (9894 in chips)
Seat 6: dimetruk (3606 in chips)
10iz9: posts the ante 20
dimetruk: posts the ante 20
10iz9: posts small blind 80
dimetruk: posts big blind 160
*** HOLE CARDS ***
Dealt to dimetruk [7h 6d]
10iz9: raises 160 to 320
dimetruk: calls 160
*** FLOP *** [Jh 2c 4h]
dimetruk: checks
10iz9: checks
*** TURN *** [Jh 2c 4h] [Qs]
dimetruk: checks
10iz9: bets 320
dimetruk: folds
Uncalled bet (320) returned to 10iz9
10iz9 collected 680 from pot
10iz9: doesn't show hand
*** SUMMARY ***
Total pot 680 | Rake 0
Board [Jh 2c 4h Qs]
Seat 2: 10iz9 (button) (small blind) collected (680)
Seat 6: dimetruk (big blind) folded on the Turn


PokerStars Hand #226614940042: Tournament #3190325009, $13.70+$1.30 USD Hold'em No Limit - Level VI (80/160) - 2021/05/09 23:36:45 MSK [2021/05/09 16:36:45 ET]
Table '3190325009 1' 9-max Seat #6 is the button
Seat 2: 10iz9 (10234 in chips)
Seat 6: dimetruk (3266 in chips)
10iz9: posts the ante 20
dimetruk: posts the ante 20
dimetruk: posts small blind 80
10iz9: posts big blind 160
*** HOLE CARDS ***
Dealt to dimetruk [2c Jc]
dimetruk: calls 80
10iz9: checks
*** FLOP *** [9d 8s 2s]
10iz9: checks
dimetruk: checks
*** TURN *** [9d 8s 2s] [4h]
10iz9: bets 320
dimetruk: calls 320
*** RIVER *** [9d 8s 2s 4h] [Ad]
10iz9: checks
dimetruk: bets 670
10iz9: folds
Uncalled bet (670) returned to dimetruk
dimetruk collected 1000 from pot
dimetruk: doesn't show hand
*** SUMMARY ***
Total pot 1000 | Rake 0
Board [9d 8s 2s 4h Ad]
Seat 2: 10iz9 (big blind) folded on the River
Seat 6: dimetruk (button) (small blind) collected (1000)


PokerStars Hand #226614961948: Tournament #3190325009, $13.70+$1.30 USD Hold'em No Limit - Level VI (80/160) - 2021/05/09 23:37:20 MSK [2021/05/09 16:37:20 ET]
Table '3190325009 1' 9-max Seat #6 is the button
Seat 2: 10iz9 (9394 in chips)
Seat 6: dimetruk (4106 in chips)
10iz9: posts the ante 20
dimetruk: posts the ante 20
dimetruk: posts small blind 80
10iz9: posts big blind 160
*** HOLE CARDS ***
Dealt to dimetruk [2h 4h]
dimetruk: calls 80
10iz9: raises 160 to 320
dimetruk: calls 160
*** FLOP *** [Qc 5h 7d]
10iz9: bets 160
dimetruk: calls 160
*** TURN *** [Qc 5h 7d] [Ad]
10iz9: bets 480
dimetruk: calls 480
*** RIVER *** [Qc 5h 7d Ad] [9h]
10iz9: checks
dimetruk: bets 980
10iz9: calls 980
*** SHOW DOWN ***
dimetruk: shows [2h 4h] (high card Ace)
10iz9: shows [9s 2s] (a pair of Nines)
10iz9 collected 3920 from pot
*** SUMMARY ***
Total pot 3920 | Rake 0
Board [Qc 5h 7d Ad 9h]
Seat 2: 10iz9 (big blind) showed [9s 2s] and won (3920) with a pair of Nines
Seat 6: dimetruk (button) (small blind) showed [2h 4h] and lost with high card Ace


PokerStars Hand #226614982923: Tournament #3190325009, $13.70+$1.30 USD Hold'em No Limit - Level VI (80/160) - 2021/05/09 23:37:52 MSK [2021/05/09 16:37:52 ET]
Table '3190325009 1' 9-max Seat #6 is the button
Seat 2: 10iz9 (11534 in chips)
Seat 6: dimetruk (1966 in chips)
10iz9: posts the ante 20
dimetruk: posts the ante 20
dimetruk: posts small blind 80
10iz9: posts big blind 160
*** HOLE CARDS ***
Dealt to dimetruk [6d Ad]
dimetruk: raises 1786 to 1946 and is all-in
10iz9: calls 1786
*** FLOP *** [4c Kd Qd]
*** TURN *** [4c Kd Qd] [7c]
*** RIVER *** [4c Kd Qd 7c] [7s]
*** SHOW DOWN ***
10iz9: shows [3d As] (a pair of Sevens)
dimetruk: shows [6d Ad] (a pair of Sevens)
10iz9 collected 1966 from pot
dimetruk collected 1966 from pot
*** SUMMARY ***
Total pot 3932 | Rake 0
Board [4c Kd Qd 7c 7s]
Seat 2: 10iz9 (big blind) showed [3d As] and won (1966) with a pair of Sevens
Seat 6: dimetruk (button) (small blind) showed [6d Ad] and won (1966) with a pair of Sevens


PokerStars Hand #226614990025: Tournament #3190325009, $13.70+$1.30 USD Hold'em No Limit - Level VI (80/160) - 2021/05/09 23:38:04 MSK [2021/05/09 16:38:04 ET]
Table '3190325009 1' 9-max Seat #2 is the button
Seat 2: 10iz9 (11534 in chips)
Seat 6: dimetruk (1966 in chips)
10iz9: posts the ante 20
dimetruk: posts the ante 20
10iz9: posts small blind 80
dimetruk: posts big blind 160
*** HOLE CARDS ***
Dealt to dimetruk [8s 5s]
10iz9: raises 160 to 320
dimetruk: calls 160
*** FLOP *** [8h 4c Tc]
dimetruk: checks
10iz9: bets 640
dimetruk: raises 986 to 1626 and is all-in
10iz9: calls 986
*** TURN *** [8h 4c Tc] [Jc]
*** RIVER *** [8h 4c Tc Jc] [Td]
*** SHOW DOWN ***
dimetruk: shows [8s 5s] (two pair, Tens and Eights)
10iz9: shows [8d 9h] (two pair, Tens and Eights)
dimetruk collected 1966 from pot
10iz9 collected 1966 from pot
*** SUMMARY ***
Total pot 3932 | Rake 0
Board [8h 4c Tc Jc Td]
Seat 2: 10iz9 (button) (small blind) showed [8d 9h] and won (1966) with two pair, Tens and Eights
Seat 6: dimetruk (big blind) showed [8s 5s] and won (1966) with two pair, Tens and Eights


PokerStars Hand #226615014264: Tournament #3190325009, $13.70+$1.30 USD Hold'em No Limit - Level VI (80/160) - 2021/05/09 23:38:42 MSK [2021/05/09 16:38:42 ET]
Table '3190325009 1' 9-max Seat #6 is the button
Seat 2: 10iz9 (11014 in chips)
Seat 6: dimetruk (2486 in chips)
10iz9: posts the ante 20
dimetruk: posts the ante 20
dimetruk: posts small blind 80
10iz9: posts big blind 160
*** HOLE CARDS ***
Dealt to dimetruk [9h 8s]
dimetruk: calls 80
10iz9: raises 160 to 320
dimetruk: calls 160
*** FLOP *** [7d Kc 5s]
10iz9: checks
dimetruk: checks
*** TURN *** [7d Kc 5s] [6h]
10iz9: bets 640
dimetruk: calls 640
*** RIVER *** [7d Kc 5s 6h] [8c]
10iz9: checks
dimetruk: bets 1506 and is all-in
10iz9: calls 1506
*** SHOW DOWN ***
dimetruk: shows [9h 8s] (a straight, Five to Nine)
10iz9: shows [Ks 3c] (a pair of Kings)
dimetruk collected 4972 from pot
*** SUMMARY ***
Total pot 4972 | Rake 0
Board [7d Kc 5s 6h 8c]
Seat 2: 10iz9 (big blind) showed [Ks 3c] and lost with a pair of Kings
Seat 6: dimetruk (button) (small blind) showed [9h 8s] and won (4972) with a straight, Five to Nine


PokerStars Hand #226615031221: Tournament #3190325009, $13.70+$1.30 USD Hold'em No Limit - Level VI (80/160) - 2021/05/09 23:39:09 MSK [2021/05/09 16:39:09 ET]
Table '3190325009 1' 9-max Seat #2 is the button
Seat 2: 10iz9 (8528 in chips)
Seat 6: dimetruk (4972 in chips)
10iz9: posts the ante 20
dimetruk: posts the ante 20
10iz9: posts small blind 80
dimetruk: posts big blind 160
*** HOLE CARDS ***
Dealt to dimetruk [2h 5d]
10iz9: raises 160 to 320
dimetruk: calls 160
*** FLOP *** [9h Ks 3s]
dimetruk: checks
10iz9: bets 640
dimetruk: folds
Uncalled bet (640) returned to 10iz9
10iz9 collected 680 from pot
10iz9: doesn't show hand
*** SUMMARY ***
Total pot 680 | Rake 0
Board [9h Ks 3s]
Seat 2: 10iz9 (button) (small blind) collected (680)
Seat 6: dimetruk (big blind) folded on the Flop


PokerStars Hand #226615037926: Tournament #3190325009, $13.70+$1.30 USD Hold'em No Limit - Level VI (80/160) - 2021/05/09 23:39:20 MSK [2021/05/09 16:39:20 ET]
Table '3190325009 1' 9-max Seat #6 is the button
Seat 2: 10iz9 (8868 in chips)
Seat 6: dimetruk (4632 in chips)
10iz9: posts the ante 20
dimetruk: posts the ante 20
dimetruk: posts small blind 80
10iz9: posts big blind 160
*** HOLE CARDS ***
Dealt to dimetruk [4c As]
dimetruk: raises 160 to 320
10iz9: calls 160
*** FLOP *** [8c 8h Jh]
10iz9: checks
dimetruk: bets 592
10iz9: raises 1808 to 2400
dimetruk: folds
Uncalled bet (1808) returned to 10iz9
10iz9 collected 1864 from pot
10iz9: doesn't show hand
*** SUMMARY ***
Total pot 1864 | Rake 0
Board [8c 8h Jh]
Seat 2: 10iz9 (big blind) collected (1864)
Seat 6: dimetruk (button) (small blind) folded on the Flop


PokerStars Hand #226615054561: Tournament #3190325009, $13.70+$1.30 USD Hold'em No Limit - Level VI (80/160) - 2021/05/09 23:39:46 MSK [2021/05/09 16:39:46 ET]
Table '3190325009 1' 9-max Seat #2 is the button
Seat 2: 10iz9 (10320 in chips)
Seat 6: dimetruk (3180 in chips)
10iz9: posts the ante 20
dimetruk: posts the ante 20
10iz9: posts small blind 80
dimetruk: posts big blind 160
*** HOLE CARDS ***
Dealt to dimetruk [5s 4c]
10iz9: raises 160 to 320
dimetruk: calls 160
*** FLOP *** [Kc Qh Qc]
dimetruk: checks
10iz9: checks
*** TURN *** [Kc Qh Qc] [6s]
dimetruk: bets 480
10iz9: folds
Uncalled bet (480) returned to dimetruk
dimetruk collected 680 from pot
dimetruk: doesn't show hand
*** SUMMARY ***
Total pot 680 | Rake 0
Board [Kc Qh Qc 6s]
Seat 2: 10iz9 (button) (small blind) folded on the Turn
Seat 6: dimetruk (big blind) collected (680)


PokerStars Hand #226615064526: Tournament #3190325009, $13.70+$1.30 USD Hold'em No Limit - Level VI (80/160) - 2021/05/09 23:40:02 MSK [2021/05/09 16:40:02 ET]
Table '3190325009 1' 9-max Seat #2 is the button
Seat 2: 10iz9 (10080 in chips)
Seat 6: dimetruk (3420 in chips)
10iz9: posts the ante 20
dimetruk: posts the ante 20
10iz9: posts small blind 80
dimetruk: posts big blind 160
*** HOLE CARDS ***
Dealt to dimetruk [4d 3d]
10iz9: raises 160 to 320
dimetruk: calls 160
*** FLOP *** [As 9h Qd]
dimetruk: checks
10iz9: checks
*** TURN *** [As 9h Qd] [8d]
dimetruk: checks
10iz9: bets 480
dimetruk: calls 480
*** RIVER *** [As 9h Qd 8d] [Ac]
dimetruk: checks
10iz9: checks
*** SHOW DOWN ***
dimetruk: shows [4d 3d] (a pair of Aces)
10iz9: shows [Jd 6c] (a pair of Aces - Queen+Jack kicker)
10iz9 collected 1640 from pot
*** SUMMARY ***
Total pot 1640 | Rake 0
Board [As 9h Qd 8d Ac]
Seat 2: 10iz9 (button) (small blind) showed [Jd 6c] and won (1640) with a pair of Aces
Seat 6: dimetruk (big blind) showed [4d 3d] and lost with a pair of Aces


PokerStars Hand #226615078302: Tournament #3190325009, $13.70+$1.30 USD Hold'em No Limit - Level VI (80/160) - 2021/05/09 23:40:24 MSK [2021/05/09 16:40:24 ET]
Table '3190325009 1' 9-max Seat #2 is the button
Seat 2: 10iz9 (11000 in chips)
Seat 6: dimetruk (2500 in chips)
10iz9: posts the ante 20
dimetruk: posts the ante 20
10iz9: posts small blind 80
dimetruk: posts big blind 160
*** HOLE CARDS ***
Dealt to dimetruk [4h Kh]
10iz9: raises 160 to 320
dimetruk: calls 160
*** FLOP *** [2c 8c 7c]
dimetruk: checks
10iz9: bets 160
dimetruk: folds
Uncalled bet (160) returned to 10iz9
10iz9 collected 680 from pot
10iz9: doesn't show hand
*** SUMMARY ***
Total pot 680 | Rake 0
Board [2c 8c 7c]
Seat 2: 10iz9 (button) (small blind) collected (680)
Seat 6: dimetruk (big blind) folded on the Flop


PokerStars Hand #226615091288: Tournament #3190325009, $13.70+$1.30 USD Hold'em No Limit - Level VI (80/160) - 2021/05/09 23:40:37 MSK [2021/05/09 16:40:37 ET]
Table '3190325009 1' 9-max Seat #6 is the button
Seat 2: 10iz9 (11340 in chips)
Seat 6: dimetruk (2160 in chips)
10iz9: posts the ante 20
dimetruk: posts the ante 20
dimetruk: posts small blind 80
10iz9: posts big blind 160
*** HOLE CARDS ***
Dealt to dimetruk [2d Ks]
dimetruk: calls 80
10iz9: checks
*** FLOP *** [2s 5s 4h]
10iz9: bets 320
dimetruk: calls 320
*** TURN *** [2s 5s 4h] [Ad]
10iz9: checks
dimetruk: bets 350
10iz9: calls 350
*** RIVER *** [2s 5s 4h Ad] [7c]
10iz9: checks
dimetruk: bets 1310 and is all-in
10iz9: folds
Uncalled bet (1310) returned to dimetruk
dimetruk collected 1700 from pot
dimetruk: doesn't show hand
*** SUMMARY ***
Total pot 1700 | Rake 0
Board [2s 5s 4h Ad 7c]
Seat 2: 10iz9 (big blind) folded on the River
Seat 6: dimetruk (button) (small blind) collected (1700)


PokerStars Hand #226615105798: Tournament #3190325009, $13.70+$1.30 USD Hold'em No Limit - Level VI (80/160) - 2021/05/09 23:41:00 MSK [2021/05/09 16:41:00 ET]
Table '3190325009 1' 9-max Seat #2 is the button
Seat 2: 10iz9 (10490 in chips)
Seat 6: dimetruk (3010 in chips)
10iz9: posts the ante 20
dimetruk: posts the ante 20
10iz9: posts small blind 80
dimetruk: posts big blind 160
*** HOLE CARDS ***
Dealt to dimetruk [Kh 2c]
10iz9: raises 160 to 320
dimetruk: calls 160
*** FLOP *** [Qd 6h 4d]
dimetruk: checks
10iz9: bets 320
dimetruk: folds
Uncalled bet (320) returned to 10iz9
10iz9 collected 680 from pot
10iz9: doesn't show hand
*** SUMMARY ***
Total pot 680 | Rake 0
Board [Qd 6h 4d]
Seat 2: 10iz9 (button) (small blind) collected (680)
Seat 6: dimetruk (big blind) folded on the Flop


PokerStars Hand #226615112728: Tournament #3190325009, $13.70+$1.30 USD Hold'em No Limit - Level VI (80/160) - 2021/05/09 23:41:11 MSK [2021/05/09 16:41:11 ET]
Table '3190325009 1' 9-max Seat #6 is the button
Seat 2: 10iz9 (10830 in chips)
Seat 6: dimetruk (2670 in chips)
10iz9: posts the ante 20
dimetruk: posts the ante 20
dimetruk: posts small blind 80
10iz9: posts big blind 160
*** HOLE CARDS ***
Dealt to dimetruk [9s Ts]
dimetruk: raises 160 to 320
10iz9: calls 160
*** FLOP *** [Jh 6d 3d]
10iz9: checks
dimetruk: checks
*** TURN *** [Jh 6d 3d] [8h]
10iz9: bets 480
dimetruk: raises 1850 to 2330 and is all-in
10iz9: folds
Uncalled bet (1850) returned to dimetruk
dimetruk collected 1640 from pot
dimetruk: doesn't show hand
*** SUMMARY ***
Total pot 1640 | Rake 0
Board [Jh 6d 3d 8h]
Seat 2: 10iz9 (big blind) folded on the Turn
Seat 6: dimetruk (button) (small blind) collected (1640)


PokerStars Hand #226615128503: Tournament #3190325009, $13.70+$1.30 USD Hold'em No Limit - Level VI (80/160) - 2021/05/09 23:41:36 MSK [2021/05/09 16:41:36 ET]
Table '3190325009 1' 9-max Seat #2 is the button
Seat 2: 10iz9 (10010 in chips)
Seat 6: dimetruk (3490 in chips)
10iz9: posts the ante 20
dimetruk: posts the ante 20
10iz9: posts small blind 80
dimetruk: posts big blind 160
*** HOLE CARDS ***
Dealt to dimetruk [3d Kh]
10iz9: raises 160 to 320
dimetruk: calls 160
*** FLOP *** [8c Th Ah]
dimetruk: checks
10iz9: bets 320
dimetruk: folds
Uncalled bet (320) returned to 10iz9
10iz9 collected 680 from pot
10iz9: doesn't show hand
*** SUMMARY ***
Total pot 680 | Rake 0
Board [8c Th Ah]
Seat 2: 10iz9 (button) (small blind) collected (680)
Seat 6: dimetruk (big blind) folded on the Flop


PokerStars Hand #226615141254: Tournament #3190325009, $13.70+$1.30 USD Hold'em No Limit - Level VI (80/160) - 2021/05/09 23:41:57 MSK [2021/05/09 16:41:57 ET]
Table '3190325009 1' 9-max Seat #2 is the button
Seat 2: 10iz9 (10010 in chips)
Seat 6: dimetruk (3490 in chips)
10iz9: posts the ante 20
dimetruk: posts the ante 20
10iz9: posts small blind 80
dimetruk: posts big blind 160
*** HOLE CARDS ***
Dealt to dimetruk [2c 6c]
10iz9: raises 160 to 320
dimetruk: calls 160
*** FLOP *** [Ks Kc Qs]
dimetruk: checks
10iz9: bets 160
dimetruk: folds
Uncalled bet (160) returned to 10iz9
10iz9 collected 680 from pot
10iz9: doesn't show hand
*** SUMMARY ***
Total pot 680 | Rake 0
Board [Ks Kc Qs]
Seat 2: 10iz9 (button) (small blind) collected (680)
Seat 6: dimetruk (big blind) folded on the Flop


PokerStars Hand #226615150372: Tournament #3190325009, $13.70+$1.30 USD Hold'em No Limit - Level VI (80/160) - 2021/05/09 23:42:11 MSK [2021/05/09 16:42:11 ET]
Table '3190325009 1' 9-max Seat #6 is the button
Seat 2: 10iz9 (10350 in chips)
Seat 6: dimetruk (3150 in chips)
10iz9: posts the ante 20
dimetruk: posts the ante 20
dimetruk: posts small blind 80
10iz9: posts big blind 160
*** HOLE CARDS ***
Dealt to dimetruk [Kd 7d]
dimetruk: raises 160 to 320
10iz9: calls 160
*** FLOP *** [6h 3c Ac]
10iz9: checks
dimetruk: checks
*** TURN *** [6h 3c Ac] [Ad]
10iz9: checks
dimetruk: bets 340
10iz9: calls 340
*** RIVER *** [6h 3c Ac Ad] [Th]
10iz9: checks
dimetruk: checks
*** SHOW DOWN ***
10iz9: shows [Td 3h] (two pair, Aces and Tens)
dimetruk: mucks hand
10iz9 collected 1360 from pot
*** SUMMARY ***
Total pot 1360 | Rake 0
Board [6h 3c Ac Ad Th]
Seat 2: 10iz9 (big blind) showed [Td 3h] and won (1360) with two pair, Aces and Tens
Seat 6: dimetruk (button) (small blind) mucked [Kd 7d]


PokerStars Hand #226615163619: Tournament #3190325009, $13.70+$1.30 USD Hold'em No Limit - Level VI (80/160) - 2021/05/09 23:42:32 MSK [2021/05/09 16:42:32 ET]
Table '3190325009 1' 9-max Seat #2 is the button
Seat 2: 10iz9 (11030 in chips)
Seat 6: dimetruk (2470 in chips)
10iz9: posts the ante 20
dimetruk: posts the ante 20
10iz9: posts small blind 80
dimetruk: posts big blind 160
*** HOLE CARDS ***
Dealt to dimetruk [Td 8c]
10iz9: raises 160 to 320
dimetruk: calls 160
*** FLOP *** [Jh Kh Ts]
dimetruk: checks
10iz9: bets 320
dimetruk: calls 320
*** TURN *** [Jh Kh Ts] [Ah]
dimetruk: checks
10iz9: bets 960
dimetruk: folds
Uncalled bet (960) returned to 10iz9
10iz9 collected 1320 from pot
10iz9: doesn't show hand
*** SUMMARY ***
Total pot 1320 | Rake 0
Board [Jh Kh Ts Ah]
Seat 2: 10iz9 (button) (small blind) collected (1320)
Seat 6: dimetruk (big blind) folded on the Turn


PokerStars Hand #226615180941: Tournament #3190325009, $13.70+$1.30 USD Hold'em No Limit - Level VII (100/200) - 2021/05/09 23:43:00 MSK [2021/05/09 16:43:00 ET]
Table '3190325009 1' 9-max Seat #2 is the button
Seat 2: 10iz9 (11465 in chips)
Seat 6: dimetruk (2035 in chips)
10iz9: posts the ante 25
dimetruk: posts the ante 25
10iz9: posts small blind 100
dimetruk: posts big blind 200
*** HOLE CARDS ***
Dealt to dimetruk [8c 7h]
10iz9: raises 200 to 400
dimetruk: calls 200
*** FLOP *** [Ac 6h 5d]
dimetruk: bets 1610 and is all-in
10iz9: folds
Uncalled bet (1610) returned to dimetruk
dimetruk collected 850 from pot
dimetruk: doesn't show hand
*** SUMMARY ***
Total pot 850 | Rake 0
Board [Ac 6h 5d]
Seat 2: 10iz9 (button) (small blind) folded on the Flop
Seat 6: dimetruk (big blind) collected (850)


PokerStars Hand #226615192688: Tournament #3190325009, $13.70+$1.30 USD Hold'em No Limit - Level VII (100/200) - 2021/05/09 23:43:19 MSK [2021/05/09 16:43:19 ET]
Table '3190325009 1' 9-max Seat #6 is the button
Seat 2: 10iz9 (10690 in chips)
Seat 6: dimetruk (2810 in chips)
10iz9: posts the ante 25
dimetruk: posts the ante 25
dimetruk: posts small blind 100
10iz9: posts big blind 200
*** HOLE CARDS ***
Dealt to dimetruk [Qs Jd]
dimetruk: raises 2585 to 2785 and is all-in
10iz9: calls 2585
*** FLOP *** [Qd 6c 6s]
*** TURN *** [Qd 6c 6s] [9d]
*** RIVER *** [Qd 6c 6s 9d] [Ac]
*** SHOW DOWN ***
10iz9: shows [Ks Kh] (two pair, Kings and Sixes)
dimetruk: shows [Qs Jd] (two pair, Queens and Sixes)
10iz9 collected 5620 from pot
dimetruk finished the tournament in 2nd place and received $36.99.
10iz9 wins the tournament and receives $61.65 - congratulations!
*** SUMMARY ***
Total pot 5620 | Rake 0
Board [Qd 6c 6s 9d Ac]
Seat 2: 10iz9 (big blind) showed [Ks Kh] and won (5620) with two pair, Kings and Sixes
Seat 6: dimetruk (button) (small blind) showed [Qs Jd] and lost with two pair, Queens and Sixes


PokerStars Hand #226687841439: Tournament #3192016076, $13.79+$1.21 USD Hold'em No Limit - Level II (15/30) - 2021/05/12 16:30:36 MSK [2021/05/12 9:30:36 ET]
Table '3192016076 1' 6-max Seat #5 is the button
Seat 1: dimetruk (1490 in chips)
Seat 2: poutek (1382 in chips)
Seat 3: BigTunna99 (1171 in chips)
Seat 4: FedeBa18 (2234 in chips)
Seat 5: bagira43 (1152 in chips)
Seat 6: Carloss86 (1571 in chips)
dimetruk: posts the ante 4
poutek: posts the ante 4
BigTunna99: posts the ante 4
FedeBa18: posts the ante 4
bagira43: posts the ante 4
Carloss86: posts the ante 4
Carloss86: posts small blind 15
dimetruk: posts big blind 30
*** HOLE CARDS ***
Dealt to dimetruk [Qc 5h]
poutek: folds
BigTunna99: folds
FedeBa18: folds
bagira43: raises 60 to 90
Carloss86: calls 75
dimetruk: calls 60
*** FLOP *** [7s 4c 8d]
Carloss86: checks
dimetruk: checks
bagira43: bets 294
Carloss86: calls 294
dimetruk: folds
*** TURN *** [7s 4c 8d] [9d]
Carloss86: checks
bagira43: bets 764 and is all-in
Carloss86: calls 764
*** RIVER *** [7s 4c 8d 9d] [2c]
*** SHOW DOWN ***
Carloss86: shows [4s 4d] (three of a kind, Fours)
bagira43: shows [Ac 8h] (a pair of Eights)
Carloss86 collected 2410 from pot
bagira43 finished the tournament in 6th place
*** SUMMARY ***
Total pot 2410 | Rake 0
Board [7s 4c 8d 9d 2c]
Seat 1: dimetruk (big blind) folded on the Flop
Seat 2: poutek folded before Flop (didn't bet)
Seat 3: BigTunna99 folded before Flop (didn't bet)
Seat 4: FedeBa18 folded before Flop (didn't bet)
Seat 5: bagira43 (button) showed [Ac 8h] and lost with a pair of Eights
Seat 6: Carloss86 (small blind) showed [4s 4d] and won (2410) with three of a kind, Fours


PokerStars Hand #226687869352: Tournament #3192016076, $13.79+$1.21 USD Hold'em No Limit - Level II (15/30) - 2021/05/12 16:32:09 MSK [2021/05/12 9:32:09 ET]
Table '3192016076 1' 6-max Seat #6 is the button
Seat 1: dimetruk (1396 in chips)
Seat 2: poutek (1378 in chips)
Seat 3: BigTunna99 (1167 in chips)
Seat 4: FedeBa18 (2230 in chips)
Seat 6: Carloss86 (2829 in chips)
dimetruk: posts the ante 4
poutek: posts the ante 4
BigTunna99: posts the ante 4
FedeBa18: posts the ante 4
Carloss86: posts the ante 4
dimetruk: posts small blind 15
poutek: posts big blind 30
*** HOLE CARDS ***
Dealt to dimetruk [3h 9c]
BigTunna99: folds
FedeBa18: folds
Carloss86: folds
dimetruk: calls 15
poutek: checks
*** FLOP *** [6d 3d 6s]
dimetruk: bets 30
poutek: calls 30
*** TURN *** [6d 3d 6s] [6c]
dimetruk: bets 70
poutek: calls 70
*** RIVER *** [6d 3d 6s 6c] [5d]
dimetruk: checks
poutek: bets 137
dimetruk: calls 137
*** SHOW DOWN ***
poutek: shows [5s Kc] (a full house, Sixes full of Fives)
dimetruk: mucks hand
poutek collected 554 from pot
*** SUMMARY ***
Total pot 554 | Rake 0
Board [6d 3d 6s 6c 5d]
Seat 1: dimetruk (small blind) mucked [3h 9c]
Seat 2: poutek (big blind) showed [5s Kc] and won (554) with a full house, Sixes full of Fives
Seat 3: BigTunna99 folded before Flop (didn't bet)
Seat 4: FedeBa18 folded before Flop (didn't bet)
Seat 6: Carloss86 (button) folded before Flop (didn't bet)


PokerStars Hand #226687923153: Tournament #3192016076, $13.79+$1.21 USD Hold'em No Limit - Level II (15/30) - 2021/05/12 16:35:08 MSK [2021/05/12 9:35:08 ET]
Table '3192016076 1' 6-max Seat #6 is the button
Seat 1: dimetruk (1079 in chips)
Seat 2: poutek (1740 in chips)
Seat 3: BigTunna99 (1382 in chips)
Seat 4: FedeBa18 (2165 in chips)
Seat 6: Carloss86 (2634 in chips)
dimetruk: posts the ante 4
poutek: posts the ante 4
BigTunna99: posts the ante 4
FedeBa18: posts the ante 4
Carloss86: posts the ante 4
dimetruk: posts small blind 15
poutek: posts big blind 30
*** HOLE CARDS ***
Dealt to dimetruk [Ah 7h]
BigTunna99: folds
FedeBa18: folds
Carloss86: folds
dimetruk: raises 30 to 60
poutek: calls 30
*** FLOP *** [Kd Th Ad]
dimetruk: bets 49
poutek: folds
Uncalled bet (49) returned to dimetruk
dimetruk collected 140 from pot
dimetruk: doesn't show hand
*** SUMMARY ***
Total pot 140 | Rake 0
Board [Kd Th Ad]
Seat 1: dimetruk (small blind) collected (140)
Seat 2: poutek (big blind) folded on the Flop
Seat 3: BigTunna99 folded before Flop (didn't bet)
Seat 4: FedeBa18 folded before Flop (didn't bet)
Seat 6: Carloss86 (button) folded before Flop (didn't bet)


PokerStars Hand #226687930942: Tournament #3192016076, $13.79+$1.21 USD Hold'em No Limit - Level II (15/30) - 2021/05/12 16:35:34 MSK [2021/05/12 9:35:34 ET]
Table '3192016076 1' 6-max Seat #1 is the button
Seat 1: dimetruk (1155 in chips)
Seat 2: poutek (1676 in chips)
Seat 3: BigTunna99 (1378 in chips)
Seat 4: FedeBa18 (2161 in chips)
Seat 6: Carloss86 (2630 in chips)
dimetruk: posts the ante 4
poutek: posts the ante 4
BigTunna99: posts the ante 4
FedeBa18: posts the ante 4
Carloss86: posts the ante 4
poutek: posts small blind 15
BigTunna99: posts big blind 30
*** HOLE CARDS ***
Dealt to dimetruk [Ad 6h]
FedeBa18: folds
Carloss86: folds
dimetruk: raises 30 to 60
poutek: folds
BigTunna99: calls 30
*** FLOP *** [7h Qs 3s]
BigTunna99: checks
dimetruk: checks
*** TURN *** [7h Qs 3s] [2c]
BigTunna99: bets 102
dimetruk: folds
Uncalled bet (102) returned to BigTunna99
BigTunna99 collected 155 from pot
BigTunna99: doesn't show hand
*** SUMMARY ***
Total pot 155 | Rake 0
Board [7h Qs 3s 2c]
Seat 1: dimetruk (button) folded on the Turn
Seat 2: poutek (small blind) folded before Flop
Seat 3: BigTunna99 (big blind) collected (155)
Seat 4: FedeBa18 folded before Flop (didn't bet)
Seat 6: Carloss86 folded before Flop (didn't bet)


PokerStars Hand #226687983505: Tournament #3192016076, $13.79+$1.21 USD Hold'em No Limit - Level II (15/30) - 2021/05/12 16:37:59 MSK [2021/05/12 9:37:59 ET]
Table '3192016076 1' 6-max Seat #4 is the button
Seat 1: dimetruk (1083 in chips)
Seat 2: poutek (1649 in chips)
Seat 3: BigTunna99 (1371 in chips)
Seat 4: FedeBa18 (2410 in chips)
Seat 6: Carloss86 (2487 in chips)
dimetruk: posts the ante 4
poutek: posts the ante 4
BigTunna99: posts the ante 4
FedeBa18: posts the ante 4
Carloss86: posts the ante 4
Carloss86: posts small blind 15
dimetruk: posts big blind 30
*** HOLE CARDS ***
Dealt to dimetruk [4c Js]
poutek: folds
BigTunna99: folds
FedeBa18: folds
Carloss86: raises 60 to 90
dimetruk: calls 60
*** FLOP *** [Ad 6d 6c]
Carloss86: bets 66
dimetruk: folds
Uncalled bet (66) returned to Carloss86
Carloss86 collected 200 from pot
Carloss86: doesn't show hand
*** SUMMARY ***
Total pot 200 | Rake 0
Board [Ad 6d 6c]
Seat 1: dimetruk (big blind) folded on the Flop
Seat 2: poutek folded before Flop (didn't bet)
Seat 3: BigTunna99 folded before Flop (didn't bet)
Seat 4: FedeBa18 (button) folded before Flop (didn't bet)
Seat 6: Carloss86 (small blind) collected (200)


PokerStars Hand #226688023482: Tournament #3192016076, $13.79+$1.21 USD Hold'em No Limit - Level II (15/30) - 2021/05/12 16:40:08 MSK [2021/05/12 9:40:08 ET]
Table '3192016076 1' 6-max Seat #3 is the button
Seat 1: dimetruk (1027 in chips)
Seat 2: poutek (1853 in chips)
Seat 3: BigTunna99 (1175 in chips)
Seat 4: FedeBa18 (2364 in chips)
Seat 6: Carloss86 (2581 in chips)
dimetruk: posts the ante 4
poutek: posts the ante 4
BigTunna99: posts the ante 4
FedeBa18: posts the ante 4
Carloss86: posts the ante 4
FedeBa18: posts small blind 15
Carloss86: posts big blind 30
*** HOLE CARDS ***
Dealt to dimetruk [Ac As]
dimetruk: raises 30 to 60
poutek: folds
BigTunna99: folds
FedeBa18: calls 45
Carloss86: calls 30
*** FLOP *** [6c Ah 7h]
FedeBa18: checks
Carloss86: checks
dimetruk: bets 70
FedeBa18: folds
Carloss86: folds
Uncalled bet (70) returned to dimetruk
dimetruk collected 200 from pot
dimetruk: doesn't show hand
*** SUMMARY ***
Total pot 200 | Rake 0
Board [6c Ah 7h]
Seat 1: dimetruk collected (200)
Seat 2: poutek folded before Flop (didn't bet)
Seat 3: BigTunna99 (button) folded before Flop (didn't bet)
Seat 4: FedeBa18 (small blind) folded on the Flop
Seat 6: Carloss86 (big blind) folded on the Flop


PokerStars Hand #226688100396: Tournament #3192016076, $13.79+$1.21 USD Hold'em No Limit - Level III (25/50) - 2021/05/12 16:43:56 MSK [2021/05/12 9:43:56 ET]
Table '3192016076 1' 6-max Seat #2 is the button
Seat 1: dimetruk (1070 in chips)
Seat 2: poutek (1731 in chips)
Seat 3: BigTunna99 (2132 in chips)
Seat 4: FedeBa18 (1473 in chips)
Seat 6: Carloss86 (2594 in chips)
dimetruk: posts the ante 6
poutek: posts the ante 6
BigTunna99: posts the ante 6
FedeBa18: posts the ante 6
Carloss86: posts the ante 6
BigTunna99: posts small blind 25
FedeBa18: posts big blind 50
*** HOLE CARDS ***
Dealt to dimetruk [Ts Tc]
Carloss86: folds
dimetruk: raises 50 to 100
poutek: folds
BigTunna99: raises 2026 to 2126 and is all-in
FedeBa18: folds
dimetruk: calls 964 and is all-in
Uncalled bet (1062) returned to BigTunna99
*** FLOP *** [Qc 5h 2d]
*** TURN *** [Qc 5h 2d] [7d]
*** RIVER *** [Qc 5h 2d 7d] [8d]
*** SHOW DOWN ***
BigTunna99: shows [Ks Qs] (a pair of Queens)
dimetruk: shows [Ts Tc] (a pair of Tens)
BigTunna99 collected 2208 from pot
dimetruk finished the tournament in 5th place
*** SUMMARY ***
Total pot 2208 | Rake 0
Board [Qc 5h 2d 7d 8d]
Seat 1: dimetruk showed [Ts Tc] and lost with a pair of Tens
Seat 2: poutek (button) folded before Flop (didn't bet)
Seat 3: BigTunna99 (small blind) showed [Ks Qs] and won (2208) with a pair of Queens
Seat 4: FedeBa18 (big blind) folded before Flop
Seat 6: Carloss86 folded before Flop (didn't bet)


PokerStars Hand #226690056374: Tournament #3192070875, $13.79+$1.21 USD Hold'em No Limit - Level I (10/20) - 2021/05/12 18:20:55 MSK [2021/05/12 11:20:55 ET]
Table '3192070875 1' 6-max Seat #1 is the button
Seat 1: StealersEnd (1500 in chips)
Seat 2: BigTunna99 (1500 in chips)
Seat 3: bobanaxx (1500 in chips)
Seat 4: dimetruk (1500 in chips)
Seat 5: JManuel94 (1500 in chips)
Seat 6: Honey666x (1500 in chips)
StealersEnd: posts the ante 3
BigTunna99: posts the ante 3
bobanaxx: posts the ante 3
dimetruk: posts the ante 3
JManuel94: posts the ante 3
Honey666x: posts the ante 3
BigTunna99: posts small blind 10
bobanaxx: posts big blind 20
*** HOLE CARDS ***
Dealt to dimetruk [Kc As]
dimetruk: raises 20 to 40
JManuel94: raises 60 to 100
Honey666x: calls 100
StealersEnd: folds
BigTunna99: folds
bobanaxx: folds
dimetruk: raises 1397 to 1497 and is all-in
JManuel94: calls 1397 and is all-in
Honey666x: folds
*** FLOP *** [Ks 7s 2s]
*** TURN *** [Ks 7s 2s] [5h]
*** RIVER *** [Ks 7s 2s 5h] [6h]
*** SHOW DOWN ***
dimetruk: shows [Kc As] (a pair of Kings)
JManuel94: shows [Qh Qc] (a pair of Queens)
dimetruk collected 3142 from pot
JManuel94 finished the tournament in 6th place
*** SUMMARY ***
Total pot 3142 | Rake 0
Board [Ks 7s 2s 5h 6h]
Seat 1: StealersEnd (button) folded before Flop (didn't bet)
Seat 2: BigTunna99 (small blind) folded before Flop
Seat 3: bobanaxx (big blind) folded before Flop
Seat 4: dimetruk showed [Kc As] and won (3142) with a pair of Kings
Seat 5: JManuel94 showed [Qh Qc] and lost with a pair of Queens
Seat 6: Honey666x folded before Flop


PokerStars Hand #226690077296: Tournament #3192070875, $13.79+$1.21 USD Hold'em No Limit - Level I (10/20) - 2021/05/12 18:21:50 MSK [2021/05/12 11:21:50 ET]
Table '3192070875 1' 6-max Seat #2 is the button
Seat 1: StealersEnd (1497 in chips)
Seat 2: BigTunna99 (1487 in chips)
Seat 3: bobanaxx (1477 in chips)
Seat 4: dimetruk (3142 in chips)
Seat 6: Honey666x (1397 in chips)
StealersEnd: posts the ante 3
BigTunna99: posts the ante 3
bobanaxx: posts the ante 3
dimetruk: posts the ante 3
Honey666x: posts the ante 3
bobanaxx: posts small blind 10
dimetruk: posts big blind 20
*** HOLE CARDS ***
Dealt to dimetruk [Th 3s]
Honey666x: raises 20 to 40
StealersEnd: folds
BigTunna99: folds
bobanaxx: folds
dimetruk: calls 20
*** FLOP *** [5h 4c Qs]
dimetruk: checks
Honey666x: bets 105
dimetruk: folds
Uncalled bet (105) returned to Honey666x
Honey666x collected 105 from pot
*** SUMMARY ***
Total pot 105 | Rake 0
Board [5h 4c Qs]
Seat 1: StealersEnd folded before Flop (didn't bet)
Seat 2: BigTunna99 (button) folded before Flop (didn't bet)
Seat 3: bobanaxx (small blind) folded before Flop
Seat 4: dimetruk (big blind) folded on the Flop
Seat 6: Honey666x collected (105)


PokerStars Hand #226690100815: Tournament #3192070875, $13.79+$1.21 USD Hold'em No Limit - Level I (10/20) - 2021/05/12 18:22:52 MSK [2021/05/12 11:22:52 ET]
Table '3192070875 1' 6-max Seat #4 is the button
Seat 1: StealersEnd (1586 in chips)
Seat 2: BigTunna99 (1481 in chips)
Seat 3: bobanaxx (1461 in chips)
Seat 4: dimetruk (3086 in chips)
Seat 6: Honey666x (1386 in chips)
StealersEnd: posts the ante 3
BigTunna99: posts the ante 3
bobanaxx: posts the ante 3
dimetruk: posts the ante 3
Honey666x: posts the ante 3
Honey666x: posts small blind 10
StealersEnd: posts big blind 20
*** HOLE CARDS ***
Dealt to dimetruk [Kh Tc]
BigTunna99: folds
bobanaxx is disconnected
bobanaxx has timed out while disconnected
bobanaxx: folds
bobanaxx is sitting out
dimetruk: raises 45 to 65
Honey666x: folds
StealersEnd: calls 45
*** FLOP *** [Ks 2h 9c]
StealersEnd: bets 50
dimetruk: calls 50
*** TURN *** [Ks 2h 9c] [6s]
StealersEnd: bets 90
dimetruk: calls 90
*** RIVER *** [Ks 2h 9c 6s] [Ad]
StealersEnd: checks
dimetruk: checks
*** SHOW DOWN ***
StealersEnd: shows [Jc Qs] (high card Ace)
dimetruk: shows [Kh Tc] (a pair of Kings)
dimetruk collected 435 from pot
*** SUMMARY ***
Total pot 435 | Rake 0
Board [Ks 2h 9c 6s Ad]
Seat 1: StealersEnd (big blind) showed [Jc Qs] and lost with high card Ace
Seat 2: BigTunna99 folded before Flop (didn't bet)
Seat 3: bobanaxx folded before Flop (didn't bet)
Seat 4: dimetruk (button) showed [Kh Tc] and won (435) with a pair of Kings
Seat 6: Honey666x (small blind) folded before Flop


PokerStars Hand #226690124536: Tournament #3192070875, $13.79+$1.21 USD Hold'em No Limit - Level I (10/20) - 2021/05/12 18:23:55 MSK [2021/05/12 11:23:55 ET]
Table '3192070875 1' 6-max Seat #1 is the button
Seat 1: StealersEnd (1355 in chips)
Seat 2: BigTunna99 (1510 in chips)
Seat 3: bobanaxx (1455 in chips) is sitting out
Seat 4: dimetruk (3310 in chips)
Seat 6: Honey666x (1370 in chips)
StealersEnd: posts the ante 3
BigTunna99: posts the ante 3
bobanaxx: posts the ante 3
dimetruk: posts the ante 3
Honey666x: posts the ante 3
BigTunna99: posts small blind 10
bobanaxx: posts big blind 20
*** HOLE CARDS ***
Dealt to dimetruk [8c Jc]
dimetruk: raises 20 to 40
Honey666x: calls 40
StealersEnd: folds
BigTunna99: folds
bobanaxx: folds
*** FLOP *** [7c 6d Ad]
dimetruk: bets 44
Honey666x: calls 44
*** TURN *** [7c 6d Ad] [5d]
dimetruk: bets 75
Honey666x: calls 75
*** RIVER *** [7c 6d Ad 5d] [6h]
dimetruk: checks
Honey666x: bets 182
dimetruk: folds
Uncalled bet (182) returned to Honey666x
Honey666x collected 363 from pot
*** SUMMARY ***
Total pot 363 | Rake 0
Board [7c 6d Ad 5d 6h]
Seat 1: StealersEnd (button) folded before Flop (didn't bet)
Seat 2: BigTunna99 (small blind) folded before Flop
Seat 3: bobanaxx (big blind) folded before Flop
Seat 4: dimetruk folded on the River
Seat 6: Honey666x collected (363)


PokerStars Hand #226690137980: Tournament #3192070875, $13.79+$1.21 USD Hold'em No Limit - Level I (10/20) - 2021/05/12 18:24:30 MSK [2021/05/12 11:24:30 ET]
Table '3192070875 1' 6-max Seat #2 is the button
Seat 1: StealersEnd (1352 in chips)
Seat 2: BigTunna99 (1497 in chips)
Seat 3: bobanaxx (1432 in chips) is sitting out
Seat 4: dimetruk (3148 in chips)
Seat 6: Honey666x (1571 in chips)
StealersEnd: posts the ante 3
BigTunna99: posts the ante 3
bobanaxx: posts the ante 3
dimetruk: posts the ante 3
Honey666x: posts the ante 3
bobanaxx: posts small blind 10
dimetruk: posts big blind 20
*** HOLE CARDS ***
Dealt to dimetruk [5h 8c]
Honey666x: folds
StealersEnd: folds
BigTunna99: raises 40 to 60
bobanaxx: folds
dimetruk: calls 40
*** FLOP *** [Jd Ac 3c]
dimetruk: checks
BigTunna99: bets 47
dimetruk: folds
Uncalled bet (47) returned to BigTunna99
BigTunna99 collected 145 from pot
BigTunna99: doesn't show hand
*** SUMMARY ***
Total pot 145 | Rake 0
Board [Jd Ac 3c]
Seat 1: StealersEnd folded before Flop (didn't bet)
Seat 2: BigTunna99 (button) collected (145)
Seat 3: bobanaxx (small blind) folded before Flop
Seat 4: dimetruk (big blind) folded on the Flop
Seat 6: Honey666x folded before Flop (didn't bet)


PokerStars Hand #226690398012: Tournament #3192070875, $13.79+$1.21 USD Hold'em No Limit - Level II (15/30) - 2021/05/12 18:35:58 MSK [2021/05/12 11:35:58 ET]
Table '3192070875 1' 6-max Seat #2 is the button
Seat 2: BigTunna99 (2141 in chips)
Seat 3: bobanaxx (2092 in chips)
Seat 4: dimetruk (2968 in chips)
Seat 6: Honey666x (1799 in chips)
BigTunna99: posts the ante 4
bobanaxx: posts the ante 4
dimetruk: posts the ante 4
Honey666x: posts the ante 4
bobanaxx: posts small blind 15
dimetruk: posts big blind 30
*** HOLE CARDS ***
Dealt to dimetruk [Qc 8c]
Honey666x: folds
BigTunna99: folds
bobanaxx: calls 15
dimetruk: checks
*** FLOP *** [Th 7s Td]
bobanaxx: checks
dimetruk: checks
*** TURN *** [Th 7s Td] [Kh]
bobanaxx: checks
dimetruk: checks
*** RIVER *** [Th 7s Td Kh] [Qs]
bobanaxx: checks
dimetruk: checks
*** SHOW DOWN ***
bobanaxx: shows [8d 7c] (two pair, Tens and Sevens)
dimetruk: shows [Qc 8c] (two pair, Queens and Tens)
dimetruk collected 76 from pot
*** SUMMARY ***
Total pot 76 | Rake 0
Board [Th 7s Td Kh Qs]
Seat 2: BigTunna99 (button) folded before Flop (didn't bet)
Seat 3: bobanaxx (small blind) showed [8d 7c] and lost with two pair, Tens and Sevens
Seat 4: dimetruk (big blind) showed [Qc 8c] and won (76) with two pair, Queens and Tens
Seat 6: Honey666x folded before Flop (didn't bet)


PokerStars Hand #226690452551: Tournament #3192070875, $13.79+$1.21 USD Hold'em No Limit - Level II (15/30) - 2021/05/12 18:38:21 MSK [2021/05/12 11:38:21 ET]
Table '3192070875 1' 6-max Seat #2 is the button
Seat 2: BigTunna99 (2164 in chips)
Seat 3: bobanaxx (1944 in chips)
Seat 4: dimetruk (2983 in chips)
Seat 6: Honey666x (1909 in chips)
BigTunna99: posts the ante 4
bobanaxx: posts the ante 4
dimetruk: posts the ante 4
Honey666x: posts the ante 4
bobanaxx: posts small blind 15
dimetruk: posts big blind 30
*** HOLE CARDS ***
Dealt to dimetruk [6d 7d]
Honey666x: calls 30
BigTunna99: folds
bobanaxx: folds
dimetruk: checks
*** FLOP *** [Th 2h 9h]
dimetruk: checks
Honey666x: bets 91
dimetruk: folds
Uncalled bet (91) returned to Honey666x
Honey666x collected 91 from pot
*** SUMMARY ***
Total pot 91 | Rake 0
Board [Th 2h 9h]
Seat 2: BigTunna99 (button) folded before Flop (didn't bet)
Seat 3: bobanaxx (small blind) folded before Flop
Seat 4: dimetruk (big blind) folded on the Flop
Seat 6: Honey666x collected (91)


PokerStars Hand #226690477718: Tournament #3192070875, $13.79+$1.21 USD Hold'em No Limit - Level II (15/30) - 2021/05/12 18:39:27 MSK [2021/05/12 11:39:27 ET]
Table '3192070875 1' 6-max Seat #4 is the button
Seat 2: BigTunna99 (2156 in chips)
Seat 3: bobanaxx (1861 in chips)
Seat 4: dimetruk (2930 in chips)
Seat 6: Honey666x (2053 in chips)
BigTunna99: posts the ante 4
bobanaxx: posts the ante 4
dimetruk: posts the ante 4
Honey666x: posts the ante 4
Honey666x: posts small blind 15
BigTunna99: posts big blind 30
*** HOLE CARDS ***
Dealt to dimetruk [Ah 7d]
bobanaxx: folds
dimetruk: raises 30 to 60
Honey666x: calls 45
BigTunna99: calls 30
*** FLOP *** [Tc 9d 6c]
Honey666x: checks
BigTunna99: checks
dimetruk: checks
*** TURN *** [Tc 9d 6c] [Jd]
Honey666x: checks
BigTunna99: checks
dimetruk: checks
*** RIVER *** [Tc 9d 6c Jd] [6h]
Honey666x: checks
BigTunna99: checks
dimetruk: bets 171
Honey666x: folds
BigTunna99: folds
Uncalled bet (171) returned to dimetruk
dimetruk collected 196 from pot
dimetruk: doesn't show hand
*** SUMMARY ***
Total pot 196 | Rake 0
Board [Tc 9d 6c Jd 6h]
Seat 2: BigTunna99 (big blind) folded on the River
Seat 3: bobanaxx folded before Flop (didn't bet)
Seat 4: dimetruk (button) collected (196)
Seat 6: Honey666x (small blind) folded on the River


PokerStars Hand #226690528536: Tournament #3192070875, $13.79+$1.21 USD Hold'em No Limit - Level III (25/50) - 2021/05/12 18:41:21 MSK [2021/05/12 11:41:21 ET]
Table '3192070875 1' 6-max Seat #2 is the button
Seat 2: BigTunna99 (2073 in chips)
Seat 3: bobanaxx (2390 in chips)
Seat 4: dimetruk (3058 in chips)
Seat 6: Honey666x (1479 in chips)
BigTunna99: posts the ante 6
bobanaxx: posts the ante 6
dimetruk: posts the ante 6
Honey666x: posts the ante 6
bobanaxx: posts small blind 25
dimetruk: posts big blind 50
*** HOLE CARDS ***
Dealt to dimetruk [Ks 4h]
Honey666x: calls 50
BigTunna99: calls 50
bobanaxx: folds
dimetruk: checks
*** FLOP *** [8s 9h Js]
dimetruk: checks
Honey666x: bets 50
BigTunna99: folds
dimetruk: folds
Uncalled bet (50) returned to Honey666x
Honey666x collected 199 from pot
*** SUMMARY ***
Total pot 199 | Rake 0
Board [8s 9h Js]
Seat 2: BigTunna99 (button) folded on the Flop
Seat 3: bobanaxx (small blind) folded before Flop
Seat 4: dimetruk (big blind) folded on the Flop
Seat 6: Honey666x collected (199)


PokerStars Hand #226690554272: Tournament #3192070875, $13.79+$1.21 USD Hold'em No Limit - Level III (25/50) - 2021/05/12 18:42:28 MSK [2021/05/12 11:42:28 ET]
Table '3192070875 1' 6-max Seat #4 is the button
Seat 2: BigTunna99 (2258 in chips)
Seat 3: bobanaxx (2353 in chips)
Seat 4: dimetruk (2971 in chips)
Seat 6: Honey666x (1418 in chips)
BigTunna99: posts the ante 6
bobanaxx: posts the ante 6
dimetruk: posts the ante 6
Honey666x: posts the ante 6
Honey666x: posts small blind 25
BigTunna99: posts big blind 50
*** HOLE CARDS ***
Dealt to dimetruk [Kc Js]
bobanaxx: folds
dimetruk: raises 50 to 100
Honey666x: folds
BigTunna99: calls 50
*** FLOP *** [8s 3d 5h]
BigTunna99: checks
dimetruk: checks
*** TURN *** [8s 3d 5h] [9h]
BigTunna99: bets 164
dimetruk: folds
Uncalled bet (164) returned to BigTunna99
BigTunna99 collected 249 from pot
BigTunna99: doesn't show hand
*** SUMMARY ***
Total pot 249 | Rake 0
Board [8s 3d 5h 9h]
Seat 2: BigTunna99 (big blind) collected (249)
Seat 3: bobanaxx folded before Flop (didn't bet)
Seat 4: dimetruk (button) folded on the Turn
Seat 6: Honey666x (small blind) folded before Flop


PokerStars Hand #226690586636: Tournament #3192070875, $13.79+$1.21 USD Hold'em No Limit - Level III (25/50) - 2021/05/12 18:43:52 MSK [2021/05/12 11:43:52 ET]
Table '3192070875 1' 6-max Seat #2 is the button
Seat 2: BigTunna99 (2370 in chips)
Seat 3: bobanaxx (2291 in chips)
Seat 4: dimetruk (2859 in chips)
Seat 6: Honey666x (1480 in chips)
BigTunna99: posts the ante 6
bobanaxx: posts the ante 6
dimetruk: posts the ante 6
Honey666x: posts the ante 6
bobanaxx: posts small blind 25
dimetruk: posts big blind 50
*** HOLE CARDS ***
Dealt to dimetruk [9h 6s]
Honey666x: calls 50
BigTunna99: calls 50
bobanaxx: calls 25
dimetruk: checks
*** FLOP *** [Qs 8c 2d]
bobanaxx: checks
dimetruk: checks
Honey666x: bets 112
BigTunna99: folds
bobanaxx: raises 246 to 358
dimetruk: folds
Honey666x: calls 246
*** TURN *** [Qs 8c 2d] [3s]
bobanaxx: bets 350
Honey666x: raises 716 to 1066 and is all-in
bobanaxx: calls 716
*** RIVER *** [Qs 8c 2d 3s] [5d]
*** SHOW DOWN ***
bobanaxx: shows [8h 8s] (three of a kind, Eights)
Honey666x: shows [8d 9s] (a pair of Eights)
bobanaxx collected 3072 from pot
Honey666x finished the tournament in 4th place
*** SUMMARY ***
Total pot 3072 | Rake 0
Board [Qs 8c 2d 3s 5d]
Seat 2: BigTunna99 (button) folded on the Flop
Seat 3: bobanaxx (small blind) showed [8h 8s] and won (3072) with three of a kind, Eights
Seat 4: dimetruk (big blind) folded on the Flop
Seat 6: Honey666x showed [8d 9s] and lost with a pair of Eights


PokerStars Hand #226690642715: Tournament #3192070875, $13.79+$1.21 USD Hold'em No Limit - Level III (25/50) - 2021/05/12 18:46:20 MSK [2021/05/12 11:46:20 ET]
Table '3192070875 1' 6-max Seat #2 is the button
Seat 2: BigTunna99 (2270 in chips)
Seat 3: bobanaxx (3871 in chips)
Seat 4: dimetruk (2859 in chips)
BigTunna99: posts the ante 6
bobanaxx: posts the ante 6
dimetruk: posts the ante 6
bobanaxx: posts small blind 25
dimetruk: posts big blind 50
*** HOLE CARDS ***
Dealt to dimetruk [2s Ac]
BigTunna99: raises 60 to 110
bobanaxx: folds
dimetruk: calls 60
*** FLOP *** [7s 2h Jc]
dimetruk: checks
BigTunna99: bets 86
dimetruk: calls 86
*** TURN *** [7s 2h Jc] [3c]
dimetruk: checks
BigTunna99: bets 218
dimetruk: calls 218
*** RIVER *** [7s 2h Jc 3c] [8h]
dimetruk: checks
BigTunna99: bets 436
dimetruk: folds
Uncalled bet (436) returned to BigTunna99
BigTunna99 collected 871 from pot
BigTunna99: doesn't show hand
*** SUMMARY ***
Total pot 871 | Rake 0
Board [7s 2h Jc 3c 8h]
Seat 2: BigTunna99 (button) collected (871)
Seat 3: bobanaxx (small blind) folded before Flop
Seat 4: dimetruk (big blind) folded on the River


PokerStars Hand #226690709294: Tournament #3192070875, $13.79+$1.21 USD Hold'em No Limit - Level III (25/50) - 2021/05/12 18:48:51 MSK [2021/05/12 11:48:51 ET]
Table '3192070875 1' 6-max Seat #2 is the button
Seat 2: BigTunna99 (3304 in chips)
Seat 3: bobanaxx (3294 in chips)
Seat 4: dimetruk (2402 in chips)
BigTunna99: posts the ante 6
bobanaxx: posts the ante 6
dimetruk: posts the ante 6
bobanaxx: posts small blind 25
dimetruk: posts big blind 50
*** HOLE CARDS ***
Dealt to dimetruk [3s 3c]
BigTunna99: raises 60 to 110
bobanaxx: folds
dimetruk: calls 60
*** FLOP *** [9d Td Qd]
dimetruk: checks
BigTunna99: bets 86
dimetruk: folds
Uncalled bet (86) returned to BigTunna99
BigTunna99 collected 263 from pot
BigTunna99: doesn't show hand
*** SUMMARY ***
Total pot 263 | Rake 0
Board [9d Td Qd]
Seat 2: BigTunna99 (button) collected (263)
Seat 3: bobanaxx (small blind) folded before Flop
Seat 4: dimetruk (big blind) folded on the Flop


PokerStars Hand #226690792894: Tournament #3192070875, $13.79+$1.21 USD Hold'em No Limit - Level IV (40/80) - 2021/05/12 18:52:30 MSK [2021/05/12 11:52:30 ET]
Table '3192070875 1' 6-max Seat #2 is the button
Seat 2: BigTunna99 (2393 in chips)
Seat 3: bobanaxx (4155 in chips)
Seat 4: dimetruk (2452 in chips)
BigTunna99: posts the ante 10
bobanaxx: posts the ante 10
dimetruk: posts the ante 10
bobanaxx: posts small blind 40
dimetruk: posts big blind 80
*** HOLE CARDS ***
Dealt to dimetruk [4h Ad]
BigTunna99: folds
bobanaxx: raises 160 to 240
dimetruk: calls 160
*** FLOP *** [Jh 2d Tc]
bobanaxx: bets 281
dimetruk: folds
Uncalled bet (281) returned to bobanaxx
bobanaxx collected 510 from pot
*** SUMMARY ***
Total pot 510 | Rake 0
Board [Jh 2d Tc]
Seat 2: BigTunna99 (button) folded before Flop (didn't bet)
Seat 3: bobanaxx (small blind) collected (510)
Seat 4: dimetruk (big blind) folded on the Flop


PokerStars Hand #226690804043: Tournament #3192070875, $13.79+$1.21 USD Hold'em No Limit - Level IV (40/80) - 2021/05/12 18:52:59 MSK [2021/05/12 11:52:59 ET]
Table '3192070875 1' 6-max Seat #4 is the button
Seat 2: BigTunna99 (2293 in chips)
Seat 3: bobanaxx (4555 in chips)
Seat 4: dimetruk (2152 in chips)
BigTunna99: posts the ante 10
bobanaxx: posts the ante 10
dimetruk: posts the ante 10
BigTunna99: posts small blind 40
bobanaxx: posts big blind 80
*** HOLE CARDS ***
Dealt to dimetruk [8s Qc]
dimetruk: raises 80 to 160
BigTunna99: folds
bobanaxx: calls 80
*** FLOP *** [Ad Jh Kd]
bobanaxx: checks
dimetruk: bets 137
bobanaxx: calls 137
*** TURN *** [Ad Jh Kd] [Tc]
bobanaxx: checks
dimetruk: checks
*** RIVER *** [Ad Jh Kd Tc] [Td]
bobanaxx: bets 365
dimetruk: calls 365
*** SHOW DOWN ***
bobanaxx: shows [8c Qs] (a straight, Ten to Ace)
dimetruk: shows [8s Qc] (a straight, Ten to Ace)
bobanaxx collected 697 from pot
dimetruk collected 697 from pot
*** SUMMARY ***
Total pot 1394 | Rake 0
Board [Ad Jh Kd Tc Td]
Seat 2: BigTunna99 (small blind) folded before Flop
Seat 3: bobanaxx (big blind) showed [8c Qs] and won (697) with a straight, Ten to Ace
Seat 4: dimetruk (button) showed [8s Qc] and won (697) with a straight, Ten to Ace


PokerStars Hand #226690858657: Tournament #3192070875, $13.79+$1.21 USD Hold'em No Limit - Level IV (40/80) - 2021/05/12 18:55:30 MSK [2021/05/12 11:55:30 ET]
Table '3192070875 1' 6-max Seat #3 is the button
Seat 2: BigTunna99 (1867 in chips)
Seat 3: bobanaxx (5196 in chips)
Seat 4: dimetruk (1937 in chips)
BigTunna99: posts the ante 10
bobanaxx: posts the ante 10
dimetruk: posts the ante 10
dimetruk: posts small blind 40
BigTunna99: posts big blind 80
*** HOLE CARDS ***
Dealt to dimetruk [5d 5h]
bobanaxx: raises 100 to 180
dimetruk: calls 140
BigTunna99: folds
*** FLOP *** [Jd 8c Qd]
dimetruk: checks
bobanaxx: bets 155
dimetruk: folds
Uncalled bet (155) returned to bobanaxx
bobanaxx collected 470 from pot
*** SUMMARY ***
Total pot 470 | Rake 0
Board [Jd 8c Qd]
Seat 2: BigTunna99 (big blind) folded before Flop
Seat 3: bobanaxx (button) collected (470)
Seat 4: dimetruk (small blind) folded on the Flop


PokerStars Hand #226690949181: Tournament #3192070875, $13.79+$1.21 USD Hold'em No Limit - Level IV (40/80) - 2021/05/12 19:00:27 MSK [2021/05/12 12:00:27 ET]
Table '3192070875 1' 6-max Seat #3 is the button
Seat 2: BigTunna99 (1312 in chips)
Seat 3: bobanaxx (6015 in chips)
Seat 4: dimetruk (1673 in chips)
BigTunna99: posts the ante 10
bobanaxx: posts the ante 10
dimetruk: posts the ante 10
dimetruk: posts small blind 40
BigTunna99: posts big blind 80
*** HOLE CARDS ***
Dealt to dimetruk [Ah Ac]
bobanaxx: raises 80 to 160
dimetruk: raises 240 to 400
BigTunna99: folds
bobanaxx: calls 240
*** FLOP *** [Ts 8d Ad]
dimetruk: checks
bobanaxx: checks
*** TURN *** [Ts 8d Ad] [Tc]
dimetruk: checks
bobanaxx: bets 300
dimetruk: calls 300
*** RIVER *** [Ts 8d Ad Tc] [9h]
dimetruk: checks
bobanaxx: checks
*** SHOW DOWN ***
dimetruk: shows [Ah Ac] (a full house, Aces full of Tens)
bobanaxx: mucks hand
dimetruk collected 1510 from pot
*** SUMMARY ***
Total pot 1510 | Rake 0
Board [Ts 8d Ad Tc 9h]
Seat 2: BigTunna99 (big blind) folded before Flop
Seat 3: bobanaxx (button) mucked [4d 7d]
Seat 4: dimetruk (small blind) showed [Ah Ac] and won (1510) with a full house, Aces full of Tens


PokerStars Hand #226690977170: Tournament #3192070875, $13.79+$1.21 USD Hold'em No Limit - Level V (60/120) - 2021/05/12 19:01:46 MSK [2021/05/12 12:01:46 ET]
Table '3192070875 1' 6-max Seat #2 is the button
Seat 2: BigTunna99 (1372 in chips)
Seat 3: bobanaxx (5170 in chips)
Seat 4: dimetruk (2458 in chips)
BigTunna99: posts the ante 15
bobanaxx: posts the ante 15
dimetruk: posts the ante 15
bobanaxx: posts small blind 60
dimetruk: posts big blind 120
*** HOLE CARDS ***
Dealt to dimetruk [Tc 9c]
BigTunna99: folds
bobanaxx: raises 240 to 360
dimetruk: calls 240
*** FLOP *** [2d Qh Qc]
bobanaxx: bets 252
dimetruk: folds
Uncalled bet (252) returned to bobanaxx
bobanaxx collected 765 from pot
*** SUMMARY ***
Total pot 765 | Rake 0
Board [2d Qh Qc]
Seat 2: BigTunna99 (button) folded before Flop (didn't bet)
Seat 3: bobanaxx (small blind) collected (765)
Seat 4: dimetruk (big blind) folded on the Flop


PokerStars Hand #226691100756: Tournament #3192070875, $13.79+$1.21 USD Hold'em No Limit - Level V (60/120) - 2021/05/12 19:07:03 MSK [2021/05/12 12:07:03 ET]
Table '3192070875 1' 6-max Seat #2 is the button
Seat 2: BigTunna99 (839 in chips)
Seat 3: bobanaxx (6318 in chips)
Seat 4: dimetruk (1843 in chips)
BigTunna99: posts the ante 15
bobanaxx: posts the ante 15
dimetruk: posts the ante 15
bobanaxx: posts small blind 60
dimetruk: posts big blind 120
*** HOLE CARDS ***
Dealt to dimetruk [Jd Kd]
BigTunna99: raises 420 to 540
bobanaxx: folds
dimetruk: raises 1288 to 1828 and is all-in
BigTunna99: calls 284 and is all-in
Uncalled bet (1004) returned to dimetruk
*** FLOP *** [4d 2c Ts]
*** TURN *** [4d 2c Ts] [2h]
*** RIVER *** [4d 2c Ts 2h] [9s]
*** SHOW DOWN ***
dimetruk: shows [Jd Kd] (a pair of Deuces)
BigTunna99: shows [6c Ah] (a pair of Deuces - Ace kicker)
BigTunna99 collected 1753 from pot
*** SUMMARY ***
Total pot 1753 | Rake 0
Board [4d 2c Ts 2h 9s]
Seat 2: BigTunna99 (button) showed [6c Ah] and won (1753) with a pair of Deuces
Seat 3: bobanaxx (small blind) folded before Flop
Seat 4: dimetruk (big blind) showed [Jd Kd] and lost with a pair of Deuces


PokerStars Hand #226691135534: Tournament #3192070875, $13.79+$1.21 USD Hold'em No Limit - Level V (60/120) - 2021/05/12 19:08:31 MSK [2021/05/12 12:08:31 ET]
Table '3192070875 1' 6-max Seat #3 is the button
Seat 2: BigTunna99 (1303 in chips)
Seat 3: bobanaxx (6918 in chips)
Seat 4: dimetruk (779 in chips)
BigTunna99: posts the ante 15
bobanaxx: posts the ante 15
dimetruk: posts the ante 15
dimetruk: posts small blind 60
BigTunna99: posts big blind 120
*** HOLE CARDS ***
Dealt to dimetruk [9h 9s]
bobanaxx: raises 6783 to 6903 and is all-in
dimetruk: calls 704 and is all-in
BigTunna99: folds
Uncalled bet (6139) returned to bobanaxx
*** FLOP *** [2s Tc Kc]
*** TURN *** [2s Tc Kc] [Js]
*** RIVER *** [2s Tc Kc Js] [Ah]
*** SHOW DOWN ***
dimetruk: shows [9h 9s] (a pair of Nines)
bobanaxx: shows [Ad 7s] (a pair of Aces)
bobanaxx collected 1693 from pot
dimetruk finished the tournament in 3rd place
*** SUMMARY ***
Total pot 1693 | Rake 0
Board [2s Tc Kc Js Ah]
Seat 2: BigTunna99 (big blind) folded before Flop
Seat 3: bobanaxx (button) showed [Ad 7s] and won (1693) with a pair of Aces
Seat 4: dimetruk (small blind) showed [9h 9s] and lost with a pair of Nines


PokerStars Hand #226690431422: Tournament #3192074823, $13.70+$1.30 USD Hold'em No Limit - Level III (25/50) - 2021/05/12 18:37:25 MSK [2021/05/12 11:37:25 ET]
Table '3192074823 1' 9-max Seat #8 is the button
Seat 1: yooogg (1450 in chips)
Seat 2: RagztoRiches (2835 in chips)
Seat 3: BigTunna99 (2633 in chips)
Seat 5: pokerpro019 (1850 in chips)
Seat 6: dimetruk (1425 in chips)
Seat 7: ALEKSEY2713 (868 in chips)
Seat 8: TheHulk7 (1712 in chips)
Seat 9: dineyy (727 in chips)
yooogg: posts the ante 6
RagztoRiches: posts the ante 6
BigTunna99: posts the ante 6
pokerpro019: posts the ante 6
dimetruk: posts the ante 6
ALEKSEY2713: posts the ante 6
TheHulk7: posts the ante 6
dineyy: posts the ante 6
dineyy: posts small blind 25
yooogg: posts big blind 50
*** HOLE CARDS ***
Dealt to dimetruk [Ac 7d]
RagztoRiches: folds
BigTunna99: folds
pokerpro019: folds
dimetruk: raises 50 to 100
ALEKSEY2713: folds
TheHulk7: folds
dineyy: folds
yooogg: calls 50
*** FLOP *** [5c 9h Th]
yooogg: checks
dimetruk: checks
*** TURN *** [5c 9h Th] [8c]
yooogg: bets 200
dimetruk: folds
Uncalled bet (200) returned to yooogg
yooogg collected 273 from pot
yooogg: doesn't show hand
*** SUMMARY ***
Total pot 273 | Rake 0
Board [5c 9h Th 8c]
Seat 1: yooogg (big blind) collected (273)
Seat 2: RagztoRiches folded before Flop (didn't bet)
Seat 3: BigTunna99 folded before Flop (didn't bet)
Seat 5: pokerpro019 folded before Flop (didn't bet)
Seat 6: dimetruk folded on the Turn
Seat 7: ALEKSEY2713 folded before Flop (didn't bet)
Seat 8: TheHulk7 (button) folded before Flop (didn't bet)
Seat 9: dineyy (small blind) folded before Flop


PokerStars Hand #226690463026: Tournament #3192074823, $13.70+$1.30 USD Hold'em No Limit - Level III (25/50) - 2021/05/12 18:38:48 MSK [2021/05/12 11:38:48 ET]
Table '3192074823 1' 9-max Seat #1 is the button
Seat 1: yooogg (1586 in chips)
Seat 2: RagztoRiches (2773 in chips)
Seat 3: BigTunna99 (2621 in chips)
Seat 5: pokerpro019 (1838 in chips)
Seat 6: dimetruk (1213 in chips)
Seat 7: ALEKSEY2713 (856 in chips)
Seat 8: TheHulk7 (1700 in chips)
Seat 9: dineyy (913 in chips)
yooogg: posts the ante 6
RagztoRiches: posts the ante 6
BigTunna99: posts the ante 6
pokerpro019: posts the ante 6
dimetruk: posts the ante 6
ALEKSEY2713: posts the ante 6
TheHulk7: posts the ante 6
dineyy: posts the ante 6
RagztoRiches: posts small blind 25
BigTunna99: posts big blind 50
*** HOLE CARDS ***
Dealt to dimetruk [Qc Ad]
pokerpro019: folds
dimetruk: raises 50 to 100
ALEKSEY2713: raises 750 to 850 and is all-in
TheHulk7: folds
dineyy: folds
yooogg: folds
RagztoRiches: folds
BigTunna99: folds
dimetruk: calls 750
*** FLOP *** [3h 9s Jd]
*** TURN *** [3h 9s Jd] [4d]
*** RIVER *** [3h 9s Jd 4d] [2d]
*** SHOW DOWN ***
dimetruk: shows [Qc Ad] (high card Ace)
ALEKSEY2713: shows [Qh Ac] (high card Ace)
dimetruk collected 912 from pot
ALEKSEY2713 collected 911 from pot
*** SUMMARY ***
Total pot 1823 | Rake 0
Board [3h 9s Jd 4d 2d]
Seat 1: yooogg (button) folded before Flop (didn't bet)
Seat 2: RagztoRiches (small blind) folded before Flop
Seat 3: BigTunna99 (big blind) folded before Flop
Seat 5: pokerpro019 folded before Flop (didn't bet)
Seat 6: dimetruk showed [Qc Ad] and won (912) with high card Ace
Seat 7: ALEKSEY2713 showed [Qh Ac] and won (911) with high card Ace
Seat 8: TheHulk7 folded before Flop (didn't bet)
Seat 9: dineyy folded before Flop (didn't bet)


PokerStars Hand #226690487044: Tournament #3192074823, $13.70+$1.30 USD Hold'em No Limit - Level III (25/50) - 2021/05/12 18:39:51 MSK [2021/05/12 11:39:51 ET]
Table '3192074823 1' 9-max Seat #3 is the button
Seat 1: yooogg (1574 in chips)
Seat 2: RagztoRiches (2736 in chips)
Seat 3: BigTunna99 (2534 in chips)
Seat 5: pokerpro019 (1776 in chips)
Seat 6: dimetruk (1386 in chips)
Seat 7: ALEKSEY2713 (905 in chips)
Seat 8: TheHulk7 (1688 in chips)
Seat 9: dineyy (901 in chips)
yooogg: posts the ante 6
RagztoRiches: posts the ante 6
BigTunna99: posts the ante 6
pokerpro019: posts the ante 6
dimetruk: posts the ante 6
ALEKSEY2713: posts the ante 6
TheHulk7: posts the ante 6
dineyy: posts the ante 6
pokerpro019: posts small blind 25
dimetruk: posts big blind 50
*** HOLE CARDS ***
Dealt to dimetruk [8s 9d]
ALEKSEY2713: folds
TheHulk7: folds
dineyy: folds
yooogg: folds
RagztoRiches: folds
BigTunna99: raises 60 to 110
pokerpro019: calls 85
dimetruk: calls 60
*** FLOP *** [Jc Ks Td]
pokerpro019: bets 378
dimetruk: folds
BigTunna99: calls 378
*** TURN *** [Jc Ks Td] [6s]
pokerpro019: bets 567
BigTunna99: calls 567
*** RIVER *** [Jc Ks Td 6s] [Qh]
pokerpro019: checks
BigTunna99: checks
*** SHOW DOWN ***
pokerpro019: shows [Jh Kd] (two pair, Kings and Jacks)
BigTunna99: mucks hand
pokerpro019 collected 2268 from pot
*** SUMMARY ***
Total pot 2268 | Rake 0
Board [Jc Ks Td 6s Qh]
Seat 1: yooogg folded before Flop (didn't bet)
Seat 2: RagztoRiches folded before Flop (didn't bet)
Seat 3: BigTunna99 (button) mucked [Kh 7h]
Seat 5: pokerpro019 (small blind) showed [Jh Kd] and won (2268) with two pair, Kings and Jacks
Seat 6: dimetruk (big blind) folded on the Flop
Seat 7: ALEKSEY2713 folded before Flop (didn't bet)
Seat 8: TheHulk7 folded before Flop (didn't bet)
Seat 9: dineyy folded before Flop (didn't bet)


PokerStars Hand #226690720110: Tournament #3192074823, $13.70+$1.30 USD Hold'em No Limit - Level IV (40/80) - 2021/05/12 18:49:19 MSK [2021/05/12 11:49:19 ET]
Table '3192074823 1' 9-max Seat #2 is the button
Seat 2: RagztoRiches (2896 in chips)
Seat 5: pokerpro019 (2717 in chips)
Seat 6: dimetruk (1029 in chips)
Seat 7: ALEKSEY2713 (2365 in chips)
Seat 8: TheHulk7 (2965 in chips)
Seat 9: dineyy (1528 in chips)
RagztoRiches: posts the ante 10
pokerpro019: posts the ante 10
dimetruk: posts the ante 10
ALEKSEY2713: posts the ante 10
TheHulk7: posts the ante 10
dineyy: posts the ante 10
pokerpro019: posts small blind 40
dimetruk: posts big blind 80
*** HOLE CARDS ***
Dealt to dimetruk [5c Kh]
ALEKSEY2713: folds
TheHulk7: folds
dineyy: raises 100 to 180
RagztoRiches: calls 180
pokerpro019: folds
dimetruk: calls 100
*** FLOP *** [4d 6d Kd]
dimetruk: checks
dineyy: checks
RagztoRiches: bets 206
dimetruk: raises 633 to 839 and is all-in
dineyy: folds
RagztoRiches: calls 633
*** TURN *** [4d 6d Kd] [Th]
*** RIVER *** [4d 6d Kd Th] [7s]
*** SHOW DOWN ***
dimetruk: shows [5c Kh] (a pair of Kings)
RagztoRiches: shows [Kc Ks] (three of a kind, Kings)
RagztoRiches collected 2318 from pot
dimetruk finished the tournament in 6th place
*** SUMMARY ***
Total pot 2318 | Rake 0
Board [4d 6d Kd Th 7s]
Seat 2: RagztoRiches (button) showed [Kc Ks] and won (2318) with three of a kind, Kings
Seat 5: pokerpro019 (small blind) folded before Flop
Seat 6: dimetruk (big blind) showed [5c Kh] and lost with a pair of Kings
Seat 7: ALEKSEY2713 folded before Flop (didn't bet)
Seat 8: TheHulk7 folded before Flop (didn't bet)
Seat 9: dineyy folded on the Flop


PokerStars Hand #226714831364: Tournament #3192613092, $13.70+$1.30 USD Hold'em No Limit - Level II (15/30) - 2021/05/13 15:21:27 MSK [2021/05/13 8:21:27 ET]
Table '3192613092 1' 9-max Seat #9 is the button
Seat 1: factor801 (1312 in chips)
Seat 2: dimetruk (1466 in chips)
Seat 3: pokerpro019 (1557 in chips)
Seat 4: samosvk97 (2266 in chips)
Seat 5: Dafenarmar (1359 in chips)
Seat 6: tucker04565 (1503 in chips)
Seat 7: Dewaele_M (984 in chips)
Seat 8: AAhobbit (1537 in chips)
Seat 9: cloclo386 (1516 in chips)
factor801: posts the ante 4
dimetruk: posts the ante 4
pokerpro019: posts the ante 4
samosvk97: posts the ante 4
Dafenarmar: posts the ante 4
tucker04565: posts the ante 4
Dewaele_M: posts the ante 4
AAhobbit: posts the ante 4
cloclo386: posts the ante 4
factor801: posts small blind 15
dimetruk: posts big blind 30
*** HOLE CARDS ***
Dealt to dimetruk [Jc 4d]
pokerpro019: folds
samosvk97: folds
Dafenarmar: folds
tucker04565: raises 30 to 60
Dewaele_M: calls 60
AAhobbit: folds
cloclo386: calls 60
factor801: folds
dimetruk: calls 30
*** FLOP *** [2h Js 5s]
dimetruk: checks
tucker04565: checks
Dewaele_M: checks
cloclo386: bets 150
dimetruk: calls 150
tucker04565: folds
Dewaele_M: calls 150
*** TURN *** [2h Js 5s] [9s]
dimetruk: checks
Dewaele_M: checks
cloclo386: bets 420
dimetruk: folds
Dewaele_M: folds
Uncalled bet (420) returned to cloclo386
cloclo386 collected 741 from pot
cloclo386: shows [9c 9d] (three of a kind, Nines)
*** SUMMARY ***
Total pot 741 | Rake 0
Board [2h Js 5s 9s]
Seat 1: factor801 (small blind) folded before Flop
Seat 2: dimetruk (big blind) folded on the Turn
Seat 3: pokerpro019 folded before Flop (didn't bet)
Seat 4: samosvk97 folded before Flop (didn't bet)
Seat 5: Dafenarmar folded before Flop (didn't bet)
Seat 6: tucker04565 folded on the Flop
Seat 7: Dewaele_M folded on the Turn
Seat 8: AAhobbit folded before Flop (didn't bet)
Seat 9: cloclo386 (button) collected (741)


PokerStars Hand #226715318985: Tournament #3192613092, $13.70+$1.30 USD Hold'em No Limit - Level IV (40/80) - 2021/05/13 15:47:47 MSK [2021/05/13 8:47:47 ET]
Table '3192613092 1' 9-max Seat #1 is the button
Seat 1: factor801 (769 in chips)
Seat 2: dimetruk (873 in chips)
Seat 3: pokerpro019 (1103 in chips)
Seat 4: samosvk97 (3021 in chips)
Seat 9: cloclo386 (7734 in chips)
factor801: posts the ante 10
dimetruk: posts the ante 10
pokerpro019: posts the ante 10
samosvk97: posts the ante 10
cloclo386: posts the ante 10
dimetruk: posts small blind 40
pokerpro019: posts big blind 80
*** HOLE CARDS ***
Dealt to dimetruk [Qh Ac]
samosvk97: raises 100 to 180
cloclo386: folds
factor801: folds
dimetruk: raises 683 to 863 and is all-in
pokerpro019: folds
samosvk97: calls 683
*** FLOP *** [8h 6c 4h]
*** TURN *** [8h 6c 4h] [5h]
*** RIVER *** [8h 6c 4h 5h] [6d]
*** SHOW DOWN ***
dimetruk: shows [Qh Ac] (a pair of Sixes)
samosvk97: shows [4c 4d] (a full house, Fours full of Sixes)
samosvk97 collected 1856 from pot
dimetruk finished the tournament in 5th place
*** SUMMARY ***
Total pot 1856 | Rake 0
Board [8h 6c 4h 5h 6d]
Seat 1: factor801 (button) folded before Flop (didn't bet)
Seat 2: dimetruk (small blind) showed [Qh Ac] and lost with a pair of Sixes
Seat 3: pokerpro019 (big blind) folded before Flop
Seat 4: samosvk97 showed [4c 4d] and won (1856) with a full house, Fours full of Sixes
Seat 9: cloclo386 folded before Flop (didn't bet)


PokerStars Hand #227033285592: Tournament #3199808034, $27.58+$2.42 USD Hold'em No Limit - Level I (10/20) - 2021/05/24 21:32:31 MSK [2021/05/24 14:32:31 ET]
Table '3199808034 1' 6-max Seat #2 is the button
Seat 1: Blacker6a (1497 in chips)
Seat 2: ScousePro (1487 in chips)
Seat 3: Noogaii (1477 in chips)
Seat 4: ninjapolarcamel (1545 in chips)
Seat 5: alex-021599 (1497 in chips)
Seat 6: dimetruk (1497 in chips)
Blacker6a: posts the ante 3
ScousePro: posts the ante 3
Noogaii: posts the ante 3
ninjapolarcamel: posts the ante 3
alex-021599: posts the ante 3
dimetruk: posts the ante 3
Noogaii: posts small blind 10
ninjapolarcamel: posts big blind 20
*** HOLE CARDS ***
Dealt to dimetruk [Kc Kd]
alex-021599: folds
dimetruk: raises 20 to 40
Blacker6a: folds
ScousePro: folds
Noogaii: folds
ninjapolarcamel: calls 20
*** FLOP *** [3h 7h 9s]
ninjapolarcamel: checks
dimetruk: bets 72
ninjapolarcamel: folds
Uncalled bet (72) returned to dimetruk
dimetruk collected 108 from pot
dimetruk: doesn't show hand
*** SUMMARY ***
Total pot 108 | Rake 0
Board [3h 7h 9s]
Seat 1: Blacker6a folded before Flop (didn't bet)
Seat 2: ScousePro (button) folded before Flop (didn't bet)
Seat 3: Noogaii (small blind) folded before Flop
Seat 4: ninjapolarcamel (big blind) folded on the Flop
Seat 5: alex-021599 folded before Flop (didn't bet)
Seat 6: dimetruk collected (108)


PokerStars Hand #227033317889: Tournament #3199808034, $27.58+$2.42 USD Hold'em No Limit - Level I (10/20) - 2021/05/24 21:33:32 MSK [2021/05/24 14:33:32 ET]
Table '3199808034 1' 6-max Seat #4 is the button
Seat 1: Blacker6a (1491 in chips)
Seat 2: ScousePro (1481 in chips)
Seat 3: Noogaii (1461 in chips)
Seat 4: ninjapolarcamel (1489 in chips)
Seat 5: alex-021599 (1519 in chips)
Seat 6: dimetruk (1559 in chips)
Blacker6a: posts the ante 3
ScousePro: posts the ante 3
Noogaii: posts the ante 3
ninjapolarcamel: posts the ante 3
alex-021599: posts the ante 3
dimetruk: posts the ante 3
alex-021599: posts small blind 10
dimetruk: posts big blind 20
*** HOLE CARDS ***
Dealt to dimetruk [9c 9d]
Blacker6a: folds
ScousePro: folds
Noogaii: raises 30 to 50
ninjapolarcamel: calls 50
alex-021599: folds
dimetruk: calls 30
*** FLOP *** [7h 3s 5s]
dimetruk: checks
Noogaii: bets 89
ninjapolarcamel: raises 89 to 178
dimetruk: folds
Noogaii: calls 89
*** TURN *** [7h 3s 5s] [Qd]
Noogaii: checks
ninjapolarcamel: bets 260
Noogaii: calls 260
*** RIVER *** [7h 3s 5s Qd] [2h]
Noogaii: checks
ninjapolarcamel: bets 998 and is all-in
Noogaii: folds
Uncalled bet (998) returned to ninjapolarcamel
ninjapolarcamel collected 1054 from pot
ninjapolarcamel: doesn't show hand
*** SUMMARY ***
Total pot 1054 | Rake 0
Board [7h 3s 5s Qd 2h]
Seat 1: Blacker6a folded before Flop (didn't bet)
Seat 2: ScousePro folded before Flop (didn't bet)
Seat 3: Noogaii folded on the River
Seat 4: ninjapolarcamel (button) collected (1054)
Seat 5: alex-021599 (small blind) folded before Flop
Seat 6: dimetruk (big blind) folded on the Flop


PokerStars Hand #227033415529: Tournament #3199808034, $27.58+$2.42 USD Hold'em No Limit - Level I (10/20) - 2021/05/24 21:36:39 MSK [2021/05/24 14:36:39 ET]
Table '3199808034 1' 6-max Seat #1 is the button
Seat 1: Blacker6a (1688 in chips)
Seat 2: ScousePro (1452 in chips)
Seat 3: Noogaii (964 in chips)
Seat 4: ninjapolarcamel (1906 in chips)
Seat 5: alex-021599 (1500 in chips)
Seat 6: dimetruk (1490 in chips)
Blacker6a: posts the ante 3
ScousePro: posts the ante 3
Noogaii: posts the ante 3
ninjapolarcamel: posts the ante 3
alex-021599: posts the ante 3
dimetruk: posts the ante 3
ScousePro: posts small blind 10
Noogaii: posts big blind 20
*** HOLE CARDS ***
Dealt to dimetruk [9h Kh]
ninjapolarcamel: folds
alex-021599: folds
dimetruk: raises 20 to 40
Blacker6a: folds
ScousePro: folds
Noogaii: calls 20
*** FLOP *** [7h Js 4c]
Noogaii: checks
dimetruk: bets 54
Noogaii: calls 54
*** TURN *** [7h Js 4c] [8d]
Noogaii: checks
dimetruk: bets 108
Noogaii: folds
Uncalled bet (108) returned to dimetruk
dimetruk collected 216 from pot
dimetruk: doesn't show hand
*** SUMMARY ***
Total pot 216 | Rake 0
Board [7h Js 4c 8d]
Seat 1: Blacker6a (button) folded before Flop (didn't bet)
Seat 2: ScousePro (small blind) folded before Flop
Seat 3: Noogaii (big blind) folded on the Turn
Seat 4: ninjapolarcamel folded before Flop (didn't bet)
Seat 5: alex-021599 folded before Flop (didn't bet)
Seat 6: dimetruk collected (216)


PokerStars Hand #227033461070: Tournament #3199808034, $27.58+$2.42 USD Hold'em No Limit - Level I (10/20) - 2021/05/24 21:37:58 MSK [2021/05/24 14:37:58 ET]
Table '3199808034 1' 6-max Seat #2 is the button
Seat 1: Blacker6a (1685 in chips)
Seat 2: ScousePro (1439 in chips)
Seat 3: Noogaii (867 in chips)
Seat 4: ninjapolarcamel (1903 in chips)
Seat 5: alex-021599 (1497 in chips)
Seat 6: dimetruk (1609 in chips)
Blacker6a: posts the ante 3
ScousePro: posts the ante 3
Noogaii: posts the ante 3
ninjapolarcamel: posts the ante 3
alex-021599: posts the ante 3
dimetruk: posts the ante 3
Noogaii: posts small blind 10
ninjapolarcamel: posts big blind 20
*** HOLE CARDS ***
Dealt to dimetruk [Kh Ad]
alex-021599: calls 20
dimetruk: raises 40 to 60
Blacker6a: folds
ScousePro: folds
Noogaii: folds
ninjapolarcamel: folds
alex-021599: calls 40
*** FLOP *** [As Qd Jd]
alex-021599: checks
dimetruk: bets 59
alex-021599: folds
Uncalled bet (59) returned to dimetruk
dimetruk collected 168 from pot
dimetruk: doesn't show hand
*** SUMMARY ***
Total pot 168 | Rake 0
Board [As Qd Jd]
Seat 1: Blacker6a folded before Flop (didn't bet)
Seat 2: ScousePro (button) folded before Flop (didn't bet)
Seat 3: Noogaii (small blind) folded before Flop
Seat 4: ninjapolarcamel (big blind) folded before Flop
Seat 5: alex-021599 folded on the Flop
Seat 6: dimetruk collected (168)


PokerStars Hand #227033534180: Tournament #3199808034, $27.58+$2.42 USD Hold'em No Limit - Level I (10/20) - 2021/05/24 21:40:16 MSK [2021/05/24 14:40:16 ET]
Table '3199808034 1' 6-max Seat #4 is the button
Seat 1: Blacker6a (1679 in chips)
Seat 2: ScousePro (1433 in chips)
Seat 3: Noogaii (807 in chips)
Seat 4: ninjapolarcamel (1833 in chips)
Seat 5: alex-021599 (1537 in chips)
Seat 6: dimetruk (1711 in chips)
Blacker6a: posts the ante 3
ScousePro: posts the ante 3
Noogaii: posts the ante 3
ninjapolarcamel: posts the ante 3
alex-021599: posts the ante 3
dimetruk: posts the ante 3
alex-021599: posts small blind 10
dimetruk: posts big blind 20
*** HOLE CARDS ***
Dealt to dimetruk [7h 6h]
Blacker6a: folds
ScousePro: raises 40 to 60
Noogaii: folds
ninjapolarcamel: folds
alex-021599: folds
dimetruk: calls 40
*** FLOP *** [6c 2d 5s]
dimetruk: checks
ScousePro: bets 60
dimetruk: calls 60
*** TURN *** [6c 2d 5s] [As]
dimetruk: checks
ScousePro: bets 123
dimetruk: calls 123
*** RIVER *** [6c 2d 5s As] [Kd]
dimetruk: checks
ScousePro: checks
*** SHOW DOWN ***
dimetruk: shows [7h 6h] (a pair of Sixes)
ScousePro: shows [Tc Kc] (a pair of Kings)
ScousePro collected 514 from pot
*** SUMMARY ***
Total pot 514 | Rake 0
Board [6c 2d 5s As Kd]
Seat 1: Blacker6a folded before Flop (didn't bet)
Seat 2: ScousePro showed [Tc Kc] and won (514) with a pair of Kings
Seat 3: Noogaii folded before Flop (didn't bet)
Seat 4: ninjapolarcamel (button) folded before Flop (didn't bet)
Seat 5: alex-021599 (small blind) folded before Flop
Seat 6: dimetruk (big blind) showed [7h 6h] and lost with a pair of Sixes


PokerStars Hand #227033687908: Tournament #3199808034, $27.58+$2.42 USD Hold'em No Limit - Level II (15/30) - 2021/05/24 21:44:50 MSK [2021/05/24 14:44:50 ET]
Table '3199808034 1' 6-max Seat #2 is the button
Seat 1: Blacker6a (1410 in chips)
Seat 2: ScousePro (1645 in chips)
Seat 3: Noogaii (1625 in chips)
Seat 4: ninjapolarcamel (1394 in chips)
Seat 5: alex-021599 (1482 in chips)
Seat 6: dimetruk (1444 in chips)
Blacker6a: posts the ante 4
ScousePro: posts the ante 4
Noogaii: posts the ante 4
ninjapolarcamel: posts the ante 4
alex-021599: posts the ante 4
dimetruk: posts the ante 4
Noogaii: posts small blind 15
ninjapolarcamel: posts big blind 30
*** HOLE CARDS ***
Dealt to dimetruk [Qc Ks]
alex-021599: calls 30
dimetruk: raises 60 to 90
Blacker6a: folds
ScousePro: folds
Noogaii: folds
ninjapolarcamel: folds
alex-021599: calls 60
*** FLOP *** [2d Kd 8s]
alex-021599: checks
dimetruk: bets 125
alex-021599: folds
Uncalled bet (125) returned to dimetruk
dimetruk collected 249 from pot
dimetruk: doesn't show hand
*** SUMMARY ***
Total pot 249 | Rake 0
Board [2d Kd 8s]
Seat 1: Blacker6a folded before Flop (didn't bet)
Seat 2: ScousePro (button) folded before Flop (didn't bet)
Seat 3: Noogaii (small blind) folded before Flop
Seat 4: ninjapolarcamel (big blind) folded before Flop
Seat 5: alex-021599 folded on the Flop
Seat 6: dimetruk collected (249)


PokerStars Hand #227033738096: Tournament #3199808034, $27.58+$2.42 USD Hold'em No Limit - Level II (15/30) - 2021/05/24 21:46:09 MSK [2021/05/24 14:46:09 ET]
Table '3199808034 1' 6-max Seat #4 is the button
Seat 1: Blacker6a (1402 in chips)
Seat 2: ScousePro (1637 in chips)
Seat 3: Noogaii (1602 in chips)
Seat 4: ninjapolarcamel (1470 in chips)
Seat 5: alex-021599 (1354 in chips)
Seat 6: dimetruk (1535 in chips)
Blacker6a: posts the ante 4
ScousePro: posts the ante 4
Noogaii: posts the ante 4
ninjapolarcamel: posts the ante 4
alex-021599: posts the ante 4
dimetruk: posts the ante 4
alex-021599: posts small blind 15
dimetruk: posts big blind 30
*** HOLE CARDS ***
Dealt to dimetruk [8c Th]
Blacker6a: folds
ScousePro: folds
Noogaii: folds
ninjapolarcamel: folds
alex-021599: raises 30 to 60
dimetruk: calls 30
*** FLOP *** [Ah Jd 3c]
alex-021599: bets 60
dimetruk: folds
Uncalled bet (60) returned to alex-021599
alex-021599 collected 144 from pot
*** SUMMARY ***
Total pot 144 | Rake 0
Board [Ah Jd 3c]
Seat 1: Blacker6a folded before Flop (didn't bet)
Seat 2: ScousePro folded before Flop (didn't bet)
Seat 3: Noogaii folded before Flop (didn't bet)
Seat 4: ninjapolarcamel (button) folded before Flop (didn't bet)
Seat 5: alex-021599 (small blind) collected (144)
Seat 6: dimetruk (big blind) folded on the Flop


PokerStars Hand #227033752539: Tournament #3199808034, $27.58+$2.42 USD Hold'em No Limit - Level II (15/30) - 2021/05/24 21:46:37 MSK [2021/05/24 14:46:37 ET]
Table '3199808034 1' 6-max Seat #5 is the button
Seat 1: Blacker6a (1398 in chips)
Seat 2: ScousePro (1633 in chips)
Seat 3: Noogaii (1598 in chips)
Seat 4: ninjapolarcamel (1466 in chips)
Seat 5: alex-021599 (1434 in chips)
Seat 6: dimetruk (1471 in chips)
Blacker6a: posts the ante 4
ScousePro: posts the ante 4
Noogaii: posts the ante 4
ninjapolarcamel: posts the ante 4
alex-021599: posts the ante 4
dimetruk: posts the ante 4
dimetruk: posts small blind 15
Blacker6a: posts big blind 30
*** HOLE CARDS ***
Dealt to dimetruk [Ts 9c]
ScousePro: folds
Noogaii: folds
ninjapolarcamel has timed out
ninjapolarcamel: folds
ninjapolarcamel is sitting out
alex-021599: folds
dimetruk: raises 30 to 60
Blacker6a: calls 30
*** FLOP *** [Qd Jh 2d]
ninjapolarcamel has returned
dimetruk: bets 50
Blacker6a: folds
Uncalled bet (50) returned to dimetruk
dimetruk collected 144 from pot
dimetruk: doesn't show hand
*** SUMMARY ***
Total pot 144 | Rake 0
Board [Qd Jh 2d]
Seat 1: Blacker6a (big blind) folded on the Flop
Seat 2: ScousePro folded before Flop (didn't bet)
Seat 3: Noogaii folded before Flop (didn't bet)
Seat 4: ninjapolarcamel folded before Flop (didn't bet)
Seat 5: alex-021599 (button) folded before Flop (didn't bet)
Seat 6: dimetruk (small blind) collected (144)


PokerStars Hand #227034004036: Tournament #3199808034, $27.58+$2.42 USD Hold'em No Limit - Level III (25/50) - 2021/05/24 21:54:29 MSK [2021/05/24 14:54:29 ET]
Table '3199808034 1' 6-max Seat #5 is the button
Seat 1: Blacker6a (2545 in chips)
Seat 3: Noogaii (1442 in chips)
Seat 4: ninjapolarcamel (1826 in chips)
Seat 5: alex-021599 (1645 in chips)
Seat 6: dimetruk (1542 in chips)
Blacker6a: posts the ante 6
Noogaii: posts the ante 6
ninjapolarcamel: posts the ante 6
alex-021599: posts the ante 6
dimetruk: posts the ante 6
dimetruk: posts small blind 25
Blacker6a: posts big blind 50
*** HOLE CARDS ***
Dealt to dimetruk [6s Th]
Noogaii: folds
ninjapolarcamel: calls 50
alex-021599: folds
dimetruk: calls 25
Blacker6a: checks
*** FLOP *** [9s 5s 4c]
dimetruk: checks
Blacker6a: checks
ninjapolarcamel: checks
*** TURN *** [9s 5s 4c] [5h]
dimetruk: bets 90
Blacker6a: calls 90
ninjapolarcamel: folds
*** RIVER *** [9s 5s 4c 5h] [Ad]
dimetruk: bets 241
Blacker6a: raises 284 to 525
dimetruk: folds
Uncalled bet (284) returned to Blacker6a
Blacker6a collected 842 from pot
Blacker6a: doesn't show hand
*** SUMMARY ***
Total pot 842 | Rake 0
Board [9s 5s 4c 5h Ad]
Seat 1: Blacker6a (big blind) collected (842)
Seat 3: Noogaii folded before Flop (didn't bet)
Seat 4: ninjapolarcamel folded on the Turn
Seat 5: alex-021599 (button) folded before Flop (didn't bet)
Seat 6: dimetruk (small blind) folded on the River


PokerStars Hand #227034062337: Tournament #3199808034, $27.58+$2.42 USD Hold'em No Limit - Level III (25/50) - 2021/05/24 21:56:47 MSK [2021/05/24 14:56:47 ET]
Table '3199808034 1' 6-max Seat #4 is the button
Seat 1: Blacker6a (1094 in chips)
Seat 3: Noogaii (1343 in chips)
Seat 4: ninjapolarcamel (3750 in chips)
Seat 5: alex-021599 (1676 in chips)
Seat 6: dimetruk (1137 in chips)
Blacker6a: posts the ante 6
Noogaii: posts the ante 6
ninjapolarcamel: posts the ante 6
alex-021599: posts the ante 6
dimetruk: posts the ante 6
alex-021599: posts small blind 25
dimetruk: posts big blind 50
*** HOLE CARDS ***
Dealt to dimetruk [7s 7c]
Blacker6a: folds
Noogaii: folds
ninjapolarcamel: calls 50
alex-021599: folds
dimetruk: raises 1081 to 1131 and is all-in
ninjapolarcamel: calls 1081
*** FLOP *** [Jc Ac Ks]
*** TURN *** [Jc Ac Ks] [9c]
*** RIVER *** [Jc Ac Ks 9c] [2s]
*** SHOW DOWN ***
dimetruk: shows [7s 7c] (a pair of Sevens)
ninjapolarcamel: shows [8s Th] (high card Ace)
dimetruk collected 2317 from pot
*** SUMMARY ***
Total pot 2317 | Rake 0
Board [Jc Ac Ks 9c 2s]
Seat 1: Blacker6a folded before Flop (didn't bet)
Seat 3: Noogaii folded before Flop (didn't bet)
Seat 4: ninjapolarcamel (button) showed [8s Th] and lost with high card Ace
Seat 5: alex-021599 (small blind) folded before Flop
Seat 6: dimetruk (big blind) showed [7s 7c] and won (2317) with a pair of Sevens


PokerStars Hand #227034154552: Tournament #3199808034, $27.58+$2.42 USD Hold'em No Limit - Level III (25/50) - 2021/05/24 22:00:39 MSK [2021/05/24 15:00:39 ET]
Table '3199808034 1' 6-max Seat #4 is the button
Seat 1: Blacker6a (1094 in chips)
Seat 3: Noogaii (2884 in chips)
Seat 4: ninjapolarcamel (1183 in chips)
Seat 5: alex-021599 (1571 in chips)
Seat 6: dimetruk (2268 in chips)
Blacker6a: posts the ante 6
Noogaii: posts the ante 6
ninjapolarcamel: posts the ante 6
alex-021599: posts the ante 6
dimetruk: posts the ante 6
alex-021599: posts small blind 25
dimetruk: posts big blind 50
*** HOLE CARDS ***
Dealt to dimetruk [Qd Qc]
Blacker6a: folds
Noogaii: raises 50 to 100
ninjapolarcamel: raises 1077 to 1177 and is all-in
alex-021599: folds
dimetruk: raises 1085 to 2262 and is all-in
Noogaii: folds
Uncalled bet (1085) returned to dimetruk
*** FLOP *** [7s 6h Jh]
*** TURN *** [7s 6h Jh] [2h]
*** RIVER *** [7s 6h Jh 2h] [8h]
*** SHOW DOWN ***
dimetruk: shows [Qd Qc] (a pair of Queens)
ninjapolarcamel: shows [Ah Td] (a flush, Ace high)
ninjapolarcamel collected 2509 from pot
*** SUMMARY ***
Total pot 2509 | Rake 0
Board [7s 6h Jh 2h 8h]
Seat 1: Blacker6a folded before Flop (didn't bet)
Seat 3: Noogaii folded before Flop
Seat 4: ninjapolarcamel (button) showed [Ah Td] and won (2509) with a flush, Ace high
Seat 5: alex-021599 (small blind) folded before Flop
Seat 6: dimetruk (big blind) showed [Qd Qc] and lost with a pair of Queens


PokerStars Hand #227034384007: Tournament #3199808034, $27.58+$2.42 USD Hold'em No Limit - Level IV (40/80) - 2021/05/24 22:07:45 MSK [2021/05/24 15:07:45 ET]
Table '3199808034 1' 6-max Seat #3 is the button
Seat 1: Blacker6a (2432 in chips)
Seat 3: Noogaii (3944 in chips)
Seat 4: ninjapolarcamel (1836 in chips)
Seat 6: dimetruk (788 in chips)
Blacker6a: posts the ante 10
Noogaii: posts the ante 10
ninjapolarcamel: posts the ante 10
dimetruk: posts the ante 10
ninjapolarcamel: posts small blind 40
dimetruk: posts big blind 80
*** HOLE CARDS ***
Dealt to dimetruk [3d 5h]
Blacker6a: raises 80 to 160
Noogaii: folds
ninjapolarcamel: folds
dimetruk: calls 80
*** FLOP *** [9s Js 2h]
dimetruk: checks
Blacker6a: checks
*** TURN *** [9s Js 2h] [3c]
dimetruk: bets 618 and is all-in
Blacker6a: calls 618
*** RIVER *** [9s Js 2h 3c] [Td]
*** SHOW DOWN ***
dimetruk: shows [3d 5h] (a pair of Threes)
Blacker6a: shows [7s 7c] (a pair of Sevens)
Blacker6a collected 1636 from pot
dimetruk finished the tournament in 4th place
*** SUMMARY ***
Total pot 1636 | Rake 0
Board [9s Js 2h 3c Td]
Seat 1: Blacker6a showed [7s 7c] and won (1636) with a pair of Sevens
Seat 3: Noogaii (button) folded before Flop (didn't bet)
Seat 4: ninjapolarcamel (small blind) folded before Flop
Seat 6: dimetruk (big blind) showed [3d 5h] and lost with a pair of Threes


PokerStars Hand #227059116321: Tournament #3200883791, $27.40+$2.60 USD Hold'em No Limit - Level I (10/20) - 2021/05/25 21:03:33 MSK [2021/05/25 14:03:33 ET]
Table '3200883791 1' 9-max Seat #2 is the button
Seat 1: ShaiC`akes (1497 in chips)
Seat 2: dclucasPS (1487 in chips)
Seat 3: RedRafflesia (1477 in chips)
Seat 4: dimetruk (1497 in chips)
Seat 5: ScousePro (1497 in chips)
Seat 6: LordZeus11 (1497 in chips)
Seat 7: ClownHead11 (1497 in chips)
Seat 8: Vanquish1958 (1437 in chips)
Seat 9: HurriedSnail (1614 in chips)
ShaiC`akes: posts the ante 3
dclucasPS: posts the ante 3
RedRafflesia: posts the ante 3
dimetruk: posts the ante 3
ScousePro: posts the ante 3
LordZeus11: posts the ante 3
ClownHead11: posts the ante 3
Vanquish1958: posts the ante 3
HurriedSnail: posts the ante 3
RedRafflesia: posts small blind 10
dimetruk: posts big blind 20
*** HOLE CARDS ***
Dealt to dimetruk [9s 2s]
ScousePro: folds
LordZeus11: folds
ClownHead11: folds
Vanquish1958: folds
HurriedSnail: folds
ShaiC`akes: folds
dclucasPS: folds
RedRafflesia: calls 10
dimetruk: checks
*** FLOP *** [6h Qh 7c]
RedRafflesia: bets 24
dimetruk: folds
Uncalled bet (24) returned to RedRafflesia
RedRafflesia collected 67 from pot
RedRafflesia: doesn't show hand
*** SUMMARY ***
Total pot 67 | Rake 0
Board [6h Qh 7c]
Seat 1: ShaiC`akes folded before Flop (didn't bet)
Seat 2: dclucasPS (button) folded before Flop (didn't bet)
Seat 3: RedRafflesia (small blind) collected (67)
Seat 4: dimetruk (big blind) folded on the Flop
Seat 5: ScousePro folded before Flop (didn't bet)
Seat 6: LordZeus11 folded before Flop (didn't bet)
Seat 7: ClownHead11 folded before Flop (didn't bet)
Seat 8: Vanquish1958 folded before Flop (didn't bet)
Seat 9: HurriedSnail folded before Flop (didn't bet)


PokerStars Hand #227059348683: Tournament #3200883791, $27.40+$2.60 USD Hold'em No Limit - Level I (10/20) - 2021/05/25 21:10:50 MSK [2021/05/25 14:10:50 ET]
Table '3200883791 1' 9-max Seat #2 is the button
Seat 1: ShaiC`akes (1497 in chips)
Seat 2: dclucasPS (1423 in chips)
Seat 3: RedRafflesia (1608 in chips)
Seat 4: dimetruk (1443 in chips)
Seat 5: ScousePro (1443 in chips)
Seat 6: LordZeus11 (1497 in chips)
Seat 8: Vanquish1958 (1601 in chips)
Seat 9: HurriedSnail (2988 in chips)
ShaiC`akes: posts the ante 3
dclucasPS: posts the ante 3
RedRafflesia: posts the ante 3
dimetruk: posts the ante 3
ScousePro: posts the ante 3
LordZeus11: posts the ante 3
Vanquish1958: posts the ante 3
HurriedSnail: posts the ante 3
RedRafflesia: posts small blind 10
dimetruk: posts big blind 20
*** HOLE CARDS ***
Dealt to dimetruk [7c 9s]
ScousePro: raises 40 to 60
LordZeus11: folds
Vanquish1958: folds
HurriedSnail: folds
ShaiC`akes: folds
dclucasPS: folds
RedRafflesia: folds
dimetruk: calls 40
*** FLOP *** [Ks Jh 5c]
dimetruk: checks
ScousePro: checks
*** TURN *** [Ks Jh 5c] [4c]
dimetruk: checks
ScousePro: checks
*** RIVER *** [Ks Jh 5c 4c] [Th]
dimetruk: bets 120
ScousePro: calls 120
*** SHOW DOWN ***
dimetruk: shows [7c 9s] (high card King)
ScousePro: shows [Qh Qd] (a pair of Queens)
ScousePro collected 394 from pot
*** SUMMARY ***
Total pot 394 | Rake 0
Board [Ks Jh 5c 4c Th]
Seat 1: ShaiC`akes folded before Flop (didn't bet)
Seat 2: dclucasPS (button) folded before Flop (didn't bet)
Seat 3: RedRafflesia (small blind) folded before Flop
Seat 4: dimetruk (big blind) showed [7c 9s] and lost with high card King
Seat 5: ScousePro showed [Qh Qd] and won (394) with a pair of Queens
Seat 6: LordZeus11 folded before Flop (didn't bet)
Seat 8: Vanquish1958 folded before Flop (didn't bet)
Seat 9: HurriedSnail folded before Flop (didn't bet)


PokerStars Hand #227059541175: Tournament #3200883791, $27.40+$2.60 USD Hold'em No Limit - Level II (15/30) - 2021/05/25 21:17:22 MSK [2021/05/25 14:17:22 ET]
Table '3200883791 1' 9-max Seat #2 is the button
Seat 1: ShaiC`akes (1500 in chips)
Seat 2: dclucasPS (1338 in chips)
Seat 3: RedRafflesia (1295 in chips)
Seat 4: dimetruk (1131 in chips)
Seat 5: ScousePro (1602 in chips)
Seat 8: Vanquish1958 (1471 in chips)
Seat 9: HurriedSnail (5163 in chips)
ShaiC`akes: posts the ante 4
dclucasPS: posts the ante 4
RedRafflesia: posts the ante 4
dimetruk: posts the ante 4
ScousePro: posts the ante 4
Vanquish1958: posts the ante 4
HurriedSnail: posts the ante 4
RedRafflesia: posts small blind 15
dimetruk: posts big blind 30
*** HOLE CARDS ***
Dealt to dimetruk [6h Jh]
ScousePro: raises 47 to 77
Vanquish1958: folds
HurriedSnail: calls 77
ShaiC`akes: calls 77
dclucasPS: folds
RedRafflesia: folds
dimetruk: calls 47
*** FLOP *** [2d 5d 7d]
dimetruk: checks
ScousePro: checks
HurriedSnail: bets 176
ShaiC`akes: folds
dimetruk: folds
ScousePro: folds
Uncalled bet (176) returned to HurriedSnail
HurriedSnail collected 351 from pot
HurriedSnail: doesn't show hand
*** SUMMARY ***
Total pot 351 | Rake 0
Board [2d 5d 7d]
Seat 1: ShaiC`akes folded on the Flop
Seat 2: dclucasPS (button) folded before Flop (didn't bet)
Seat 3: RedRafflesia (small blind) folded before Flop
Seat 4: dimetruk (big blind) folded on the Flop
Seat 5: ScousePro folded on the Flop
Seat 8: Vanquish1958 folded before Flop (didn't bet)
Seat 9: HurriedSnail collected (351)


PokerStars Hand #227059601917: Tournament #3200883791, $27.40+$2.60 USD Hold'em No Limit - Level II (15/30) - 2021/05/25 21:19:24 MSK [2021/05/25 14:19:24 ET]
Table '3200883791 1' 9-max Seat #4 is the button
Seat 1: ShaiC`akes (1415 in chips)
Seat 2: dclucasPS (1330 in chips)
Seat 3: RedRafflesia (1272 in chips)
Seat 4: dimetruk (1031 in chips)
Seat 5: ScousePro (1457 in chips)
Seat 8: Vanquish1958 (1463 in chips)
Seat 9: HurriedSnail (5532 in chips)
ShaiC`akes: posts the ante 4
dclucasPS: posts the ante 4
RedRafflesia: posts the ante 4
dimetruk: posts the ante 4
ScousePro: posts the ante 4
Vanquish1958: posts the ante 4
HurriedSnail: posts the ante 4
ScousePro: posts small blind 15
Vanquish1958: posts big blind 30
*** HOLE CARDS ***
Dealt to dimetruk [5d 5c]
HurriedSnail: folds
ShaiC`akes: folds
dclucasPS: folds
RedRafflesia: raises 40 to 70
dimetruk: calls 70
ScousePro: folds
Vanquish1958: calls 40
*** FLOP *** [4s 7s Ks]
Vanquish1958: checks
RedRafflesia: checks
dimetruk: bets 127
Vanquish1958: folds
RedRafflesia: folds
Uncalled bet (127) returned to dimetruk
dimetruk collected 253 from pot
dimetruk: doesn't show hand
*** SUMMARY ***
Total pot 253 | Rake 0
Board [4s 7s Ks]
Seat 1: ShaiC`akes folded before Flop (didn't bet)
Seat 2: dclucasPS folded before Flop (didn't bet)
Seat 3: RedRafflesia folded on the Flop
Seat 4: dimetruk (button) collected (253)
Seat 5: ScousePro (small blind) folded before Flop
Seat 8: Vanquish1958 (big blind) folded on the Flop
Seat 9: HurriedSnail folded before Flop (didn't bet)


PokerStars Hand #227059622137: Tournament #3200883791, $27.40+$2.60 USD Hold'em No Limit - Level II (15/30) - 2021/05/25 21:20:05 MSK [2021/05/25 14:20:05 ET]
Table '3200883791 1' 9-max Seat #5 is the button
Seat 1: ShaiC`akes (1411 in chips)
Seat 2: dclucasPS (1326 in chips)
Seat 3: RedRafflesia (1198 in chips)
Seat 4: dimetruk (1210 in chips)
Seat 5: ScousePro (1438 in chips)
Seat 8: Vanquish1958 (1389 in chips)
Seat 9: HurriedSnail (5528 in chips)
ShaiC`akes: posts the ante 4
dclucasPS: posts the ante 4
RedRafflesia: posts the ante 4
dimetruk: posts the ante 4
ScousePro: posts the ante 4
Vanquish1958: posts the ante 4
HurriedSnail: posts the ante 4
Vanquish1958: posts small blind 15
HurriedSnail: posts big blind 30
*** HOLE CARDS ***
Dealt to dimetruk [Ac Tc]
ShaiC`akes: folds
dclucasPS: folds
RedRafflesia: folds
dimetruk: raises 30 to 60
ScousePro: folds
Vanquish1958: calls 45
HurriedSnail: calls 30
*** FLOP *** [6c 6s 3s]
Vanquish1958: checks
HurriedSnail: bets 104
dimetruk: folds
Vanquish1958: folds
Uncalled bet (104) returned to HurriedSnail
HurriedSnail collected 208 from pot
*** SUMMARY ***
Total pot 208 | Rake 0
Board [6c 6s 3s]
Seat 1: ShaiC`akes folded before Flop (didn't bet)
Seat 2: dclucasPS folded before Flop (didn't bet)
Seat 3: RedRafflesia folded before Flop (didn't bet)
Seat 4: dimetruk folded on the Flop
Seat 5: ScousePro (button) folded before Flop (didn't bet)
Seat 8: Vanquish1958 (small blind) folded on the Flop
Seat 9: HurriedSnail (big blind) collected (208)


PokerStars Hand #227059657765: Tournament #3200883791, $27.40+$2.60 USD Hold'em No Limit - Level II (15/30) - 2021/05/25 21:21:17 MSK [2021/05/25 14:21:17 ET]
Table '3200883791 1' 9-max Seat #9 is the button
Seat 1: ShaiC`akes (1446 in chips)
Seat 2: dclucasPS (1318 in chips)
Seat 3: RedRafflesia (1190 in chips)
Seat 4: dimetruk (1142 in chips)
Seat 5: ScousePro (1430 in chips)
Seat 8: Vanquish1958 (1321 in chips)
Seat 9: HurriedSnail (5653 in chips)
ShaiC`akes: posts the ante 4
dclucasPS: posts the ante 4
RedRafflesia: posts the ante 4
dimetruk: posts the ante 4
ScousePro: posts the ante 4
Vanquish1958: posts the ante 4
HurriedSnail: posts the ante 4
ShaiC`akes: posts small blind 15
dclucasPS: posts big blind 30
*** HOLE CARDS ***
Dealt to dimetruk [Kd Ah]
RedRafflesia: folds
dimetruk: raises 30 to 60
ScousePro: folds
Vanquish1958: folds
HurriedSnail: calls 60
ShaiC`akes: folds
dclucasPS: folds
*** FLOP *** [Kh Ks 5c]
dimetruk: bets 68
HurriedSnail: folds
Uncalled bet (68) returned to dimetruk
dimetruk collected 193 from pot
dimetruk: doesn't show hand
*** SUMMARY ***
Total pot 193 | Rake 0
Board [Kh Ks 5c]
Seat 1: ShaiC`akes (small blind) folded before Flop
Seat 2: dclucasPS (big blind) folded before Flop
Seat 3: RedRafflesia folded before Flop (didn't bet)
Seat 4: dimetruk collected (193)
Seat 5: ScousePro folded before Flop (didn't bet)
Seat 8: Vanquish1958 folded before Flop (didn't bet)
Seat 9: HurriedSnail (button) folded on the Flop


PokerStars Hand #227059686371: Tournament #3200883791, $27.40+$2.60 USD Hold'em No Limit - Level II (15/30) - 2021/05/25 21:22:15 MSK [2021/05/25 14:22:15 ET]
Table '3200883791 1' 9-max Seat #2 is the button
Seat 1: ShaiC`akes (1423 in chips)
Seat 2: dclucasPS (1265 in chips)
Seat 3: RedRafflesia (1152 in chips)
Seat 4: dimetruk (1267 in chips)
Seat 5: ScousePro (1422 in chips)
Seat 8: Vanquish1958 (1238 in chips)
Seat 9: HurriedSnail (5733 in chips)
ShaiC`akes: posts the ante 4
dclucasPS: posts the ante 4
RedRafflesia: posts the ante 4
dimetruk: posts the ante 4
ScousePro: posts the ante 4
Vanquish1958: posts the ante 4
HurriedSnail: posts the ante 4
RedRafflesia: posts small blind 15
dimetruk: posts big blind 30
*** HOLE CARDS ***
Dealt to dimetruk [Ah Qc]
ScousePro: folds
Vanquish1958: folds
HurriedSnail: folds
ShaiC`akes: folds
dclucasPS: folds
RedRafflesia: calls 15
dimetruk: raises 67 to 97
RedRafflesia: calls 67
*** FLOP *** [4c 9c 4s]
RedRafflesia: checks
dimetruk: bets 111
RedRafflesia: calls 111
*** TURN *** [4c 9c 4s] [7h]
RedRafflesia: checks
dimetruk: checks
*** RIVER *** [4c 9c 4s 7h] [5s]
RedRafflesia: checks
dimetruk: checks
*** SHOW DOWN ***
RedRafflesia: shows [Ad 7c] (two pair, Sevens and Fours)
dimetruk: mucks hand
RedRafflesia collected 444 from pot
*** SUMMARY ***
Total pot 444 | Rake 0
Board [4c 9c 4s 7h 5s]
Seat 1: ShaiC`akes folded before Flop (didn't bet)
Seat 2: dclucasPS (button) folded before Flop (didn't bet)
Seat 3: RedRafflesia (small blind) showed [Ad 7c] and won (444) with two pair, Sevens and Fours
Seat 4: dimetruk (big blind) mucked [Ah Qc]
Seat 5: ScousePro folded before Flop (didn't bet)
Seat 8: Vanquish1958 folded before Flop (didn't bet)
Seat 9: HurriedSnail folded before Flop (didn't bet)


PokerStars Hand #227059752186: Tournament #3200883791, $27.40+$2.60 USD Hold'em No Limit - Level III (25/50) - 2021/05/25 21:24:28 MSK [2021/05/25 14:24:28 ET]
Table '3200883791 1' 9-max Seat #4 is the button
Seat 1: ShaiC`akes (1413 in chips)
Seat 2: dclucasPS (1255 in chips)
Seat 3: RedRafflesia (1378 in chips)
Seat 4: dimetruk (949 in chips)
Seat 5: ScousePro (1554 in chips)
Seat 8: Vanquish1958 (1228 in chips)
Seat 9: HurriedSnail (5723 in chips)
ShaiC`akes: posts the ante 6
dclucasPS: posts the ante 6
RedRafflesia: posts the ante 6
dimetruk: posts the ante 6
ScousePro: posts the ante 6
Vanquish1958: posts the ante 6
HurriedSnail: posts the ante 6
ScousePro: posts small blind 25
Vanquish1958: posts big blind 50
*** HOLE CARDS ***
Dealt to dimetruk [Kh Qh]
HurriedSnail: folds
ShaiC`akes: folds
dclucasPS: folds
RedRafflesia: folds
dimetruk: raises 893 to 943 and is all-in
ScousePro: raises 605 to 1548 and is all-in
Vanquish1958: folds
Uncalled bet (605) returned to ScousePro
*** FLOP *** [Qd 4s 6d]
*** TURN *** [Qd 4s 6d] [7s]
*** RIVER *** [Qd 4s 6d 7s] [9d]
*** SHOW DOWN ***
ScousePro: shows [As Ks] (high card Ace)
dimetruk: shows [Kh Qh] (a pair of Queens)
dimetruk collected 1978 from pot
*** SUMMARY ***
Total pot 1978 | Rake 0
Board [Qd 4s 6d 7s 9d]
Seat 1: ShaiC`akes folded before Flop (didn't bet)
Seat 2: dclucasPS folded before Flop (didn't bet)
Seat 3: RedRafflesia folded before Flop (didn't bet)
Seat 4: dimetruk (button) showed [Kh Qh] and won (1978) with a pair of Queens
Seat 5: ScousePro (small blind) showed [As Ks] and lost with high card Ace
Seat 8: Vanquish1958 (big blind) folded before Flop
Seat 9: HurriedSnail folded before Flop (didn't bet)


PokerStars Hand #227059766509: Tournament #3200883791, $27.40+$2.60 USD Hold'em No Limit - Level III (25/50) - 2021/05/25 21:24:57 MSK [2021/05/25 14:24:57 ET]
Table '3200883791 1' 9-max Seat #5 is the button
Seat 1: ShaiC`akes (1407 in chips)
Seat 2: dclucasPS (1249 in chips)
Seat 3: RedRafflesia (1372 in chips)
Seat 4: dimetruk (1978 in chips)
Seat 5: ScousePro (605 in chips)
Seat 8: Vanquish1958 (1172 in chips)
Seat 9: HurriedSnail (5717 in chips)
ShaiC`akes: posts the ante 6
dclucasPS: posts the ante 6
RedRafflesia: posts the ante 6
dimetruk: posts the ante 6
ScousePro: posts the ante 6
Vanquish1958: posts the ante 6
HurriedSnail: posts the ante 6
Vanquish1958: posts small blind 25
HurriedSnail: posts big blind 50
*** HOLE CARDS ***
Dealt to dimetruk [Td Ac]
ShaiC`akes: folds
dclucasPS: folds
RedRafflesia: folds
dimetruk: raises 50 to 100
ScousePro: folds
Vanquish1958: folds
HurriedSnail: calls 50
*** FLOP *** [4d 6h 3d]
HurriedSnail: bets 200
dimetruk: folds
Uncalled bet (200) returned to HurriedSnail
HurriedSnail collected 267 from pot
*** SUMMARY ***
Total pot 267 | Rake 0
Board [4d 6h 3d]
Seat 1: ShaiC`akes folded before Flop (didn't bet)
Seat 2: dclucasPS folded before Flop (didn't bet)
Seat 3: RedRafflesia folded before Flop (didn't bet)
Seat 4: dimetruk folded on the Flop
Seat 5: ScousePro (button) folded before Flop (didn't bet)
Seat 8: Vanquish1958 (small blind) folded before Flop
Seat 9: HurriedSnail (big blind) collected (267)


PokerStars Hand #227060105131: Tournament #3200883791, $27.40+$2.60 USD Hold'em No Limit - Level IV (40/80) - 2021/05/25 21:36:08 MSK [2021/05/25 14:36:08 ET]
Table '3200883791 1' 9-max Seat #1 is the button
Seat 1: ShaiC`akes (3438 in chips)
Seat 3: RedRafflesia (717 in chips)
Seat 4: dimetruk (1747 in chips)
Seat 5: ScousePro (2104 in chips)
Seat 9: HurriedSnail (5494 in chips)
ShaiC`akes: posts the ante 10
RedRafflesia: posts the ante 10
dimetruk: posts the ante 10
ScousePro: posts the ante 10
HurriedSnail: posts the ante 10
RedRafflesia: posts small blind 40
dimetruk: posts big blind 80
*** HOLE CARDS ***
Dealt to dimetruk [8d 2c]
ScousePro: folds
HurriedSnail: calls 80
ShaiC`akes: folds
RedRafflesia: folds
dimetruk: checks
*** FLOP *** [Qd Jc 2h]
dimetruk: checks
HurriedSnail: bets 80
dimetruk: calls 80
*** TURN *** [Qd Jc 2h] [4c]
dimetruk: checks
HurriedSnail: bets 205
dimetruk: folds
Uncalled bet (205) returned to HurriedSnail
HurriedSnail collected 410 from pot
HurriedSnail: doesn't show hand
*** SUMMARY ***
Total pot 410 | Rake 0
Board [Qd Jc 2h 4c]
Seat 1: ShaiC`akes (button) folded before Flop (didn't bet)
Seat 3: RedRafflesia (small blind) folded before Flop
Seat 4: dimetruk (big blind) folded on the Turn
Seat 5: ScousePro folded before Flop (didn't bet)
Seat 9: HurriedSnail collected (410)


PokerStars Hand #227060249658: Tournament #3200883791, $27.40+$2.60 USD Hold'em No Limit - Level IV (40/80) - 2021/05/25 21:40:53 MSK [2021/05/25 14:40:53 ET]
Table '3200883791 1' 9-max Seat #9 is the button
Seat 1: ShaiC`akes (3646 in chips)
Seat 4: dimetruk (1507 in chips)
Seat 5: ScousePro (2095 in chips)
Seat 9: HurriedSnail (6252 in chips)
ShaiC`akes: posts the ante 10
dimetruk: posts the ante 10
ScousePro: posts the ante 10
HurriedSnail: posts the ante 10
ShaiC`akes: posts small blind 40
dimetruk: posts big blind 80
*** HOLE CARDS ***
Dealt to dimetruk [7d Kc]
ScousePro: folds
HurriedSnail: calls 80
ShaiC`akes: folds
dimetruk: checks
*** FLOP *** [6h Ad 2c]
dimetruk: checks
HurriedSnail: checks
*** TURN *** [6h Ad 2c] [Ac]
dimetruk: bets 84
HurriedSnail: raises 84 to 168
dimetruk: folds
Uncalled bet (84) returned to HurriedSnail
HurriedSnail collected 408 from pot
HurriedSnail: doesn't show hand
*** SUMMARY ***
Total pot 408 | Rake 0
Board [6h Ad 2c Ac]
Seat 1: ShaiC`akes (small blind) folded before Flop
Seat 4: dimetruk (big blind) folded on the Turn
Seat 5: ScousePro folded before Flop (didn't bet)
Seat 9: HurriedSnail (button) collected (408)


PokerStars Hand #227060336518: Tournament #3200883791, $27.40+$2.60 USD Hold'em No Limit - Level V (60/120) - 2021/05/25 21:43:30 MSK [2021/05/25 14:43:30 ET]
Table '3200883791 1' 9-max Seat #9 is the button
Seat 1: ShaiC`akes (3831 in chips)
Seat 4: dimetruk (1468 in chips)
Seat 5: ScousePro (1700 in chips)
Seat 9: HurriedSnail (6501 in chips)
ShaiC`akes: posts the ante 15
dimetruk: posts the ante 15
ScousePro: posts the ante 15
HurriedSnail: posts the ante 15
ShaiC`akes: posts small blind 60
dimetruk: posts big blind 120
*** HOLE CARDS ***
Dealt to dimetruk [Kc 8c]
ScousePro: folds
HurriedSnail: raises 120 to 240
ShaiC`akes: folds
dimetruk: calls 120
*** FLOP *** [2s Qh 4h]
dimetruk: checks
HurriedSnail: bets 6246 and is all-in
dimetruk: folds
Uncalled bet (6246) returned to HurriedSnail
HurriedSnail collected 600 from pot
HurriedSnail: doesn't show hand
*** SUMMARY ***
Total pot 600 | Rake 0
Board [2s Qh 4h]
Seat 1: ShaiC`akes (small blind) folded before Flop
Seat 4: dimetruk (big blind) folded on the Flop
Seat 5: ScousePro folded before Flop (didn't bet)
Seat 9: HurriedSnail (button) collected (600)


PokerStars Hand #227060372206: Tournament #3200883791, $27.40+$2.60 USD Hold'em No Limit - Level V (60/120) - 2021/05/25 21:44:39 MSK [2021/05/25 14:44:39 ET]
Table '3200883791 1' 9-max Seat #9 is the button
Seat 1: ShaiC`akes (3831 in chips)
Seat 4: dimetruk (1108 in chips)
Seat 5: ScousePro (1460 in chips)
Seat 9: HurriedSnail (7101 in chips)
ShaiC`akes: posts the ante 15
dimetruk: posts the ante 15
ScousePro: posts the ante 15
HurriedSnail: posts the ante 15
ShaiC`akes: posts small blind 60
dimetruk: posts big blind 120
*** HOLE CARDS ***
Dealt to dimetruk [Ks Jc]
ScousePro: folds
HurriedSnail: raises 120 to 240
ShaiC`akes: folds
dimetruk: raises 853 to 1093 and is all-in
HurriedSnail: calls 853
*** FLOP *** [3d Ts Th]
*** TURN *** [3d Ts Th] [2c]
*** RIVER *** [3d Ts Th 2c] [Ah]
*** SHOW DOWN ***
dimetruk: shows [Ks Jc] (a pair of Tens)
HurriedSnail: shows [Kh Tc] (three of a kind, Tens)
HurriedSnail collected 2306 from pot
dimetruk finished the tournament in 4th place
*** SUMMARY ***
Total pot 2306 | Rake 0
Board [3d Ts Th 2c Ah]
Seat 1: ShaiC`akes (small blind) folded before Flop
Seat 4: dimetruk (big blind) showed [Ks Jc] and lost with a pair of Tens
Seat 5: ScousePro folded before Flop (didn't bet)
Seat 9: HurriedSnail (button) showed [Kh Tc] and won (2306) with three of a kind, Tens


PokerStars Hand #227059658957: Tournament #3200903456, $13.70+$1.30 USD Hold'em No Limit - Level I (10/20) - 2021/05/25 21:21:19 MSK [2021/05/25 14:21:19 ET]
Table '3200903456 1' 9-max Seat #6 is the button
Seat 1: ScousePro (1485 in chips)
Seat 2: AKsEffekt (1295 in chips)
Seat 3: JourneyWell (1759 in chips)
Seat 4: dimetruk (1455 in chips)
Seat 5: FANTO812 (1600 in chips)
Seat 6: 3veeno (1288 in chips)
Seat 7: BigTunna99 (1641 in chips)
Seat 8: RedRafflesia (1492 in chips)
Seat 9: thanksdk (1485 in chips)
ScousePro: posts the ante 3
AKsEffekt: posts the ante 3
JourneyWell: posts the ante 3
dimetruk: posts the ante 3
FANTO812: posts the ante 3
3veeno: posts the ante 3
BigTunna99: posts the ante 3
RedRafflesia: posts the ante 3
thanksdk: posts the ante 3
BigTunna99: posts small blind 10
RedRafflesia: posts big blind 20
*** HOLE CARDS ***
Dealt to dimetruk [3s 3h]
thanksdk: folds
ScousePro: raises 40 to 60
AKsEffekt: folds
JourneyWell: folds
dimetruk: calls 60
FANTO812: calls 60
3veeno: folds
BigTunna99: folds
RedRafflesia: calls 40
*** FLOP *** [4d 7h Qc]
RedRafflesia: checks
ScousePro: bets 120
dimetruk: folds
FANTO812: calls 120
RedRafflesia: folds
*** TURN *** [4d 7h Qc] [Ks]
ScousePro: checks
FANTO812: checks
*** RIVER *** [4d 7h Qc Ks] [Qh]
ScousePro: bets 195
FANTO812: calls 195
*** SHOW DOWN ***
ScousePro: shows [As Qs] (three of a kind, Queens)
FANTO812: mucks hand
ScousePro collected 907 from pot
*** SUMMARY ***
Total pot 907 | Rake 0
Board [4d 7h Qc Ks Qh]
Seat 1: ScousePro showed [As Qs] and won (907) with three of a kind, Queens
Seat 2: AKsEffekt folded before Flop (didn't bet)
Seat 3: JourneyWell folded before Flop (didn't bet)
Seat 4: dimetruk folded on the Flop
Seat 5: FANTO812 mucked [Ts Tc]
Seat 6: 3veeno (button) folded before Flop (didn't bet)
Seat 7: BigTunna99 (small blind) folded before Flop
Seat 8: RedRafflesia (big blind) folded on the Flop
Seat 9: thanksdk folded before Flop (didn't bet)


PokerStars Hand #227059930100: Tournament #3200903456, $13.70+$1.30 USD Hold'em No Limit - Level II (15/30) - 2021/05/25 21:30:28 MSK [2021/05/25 14:30:28 ET]
Table '3200903456 1' 9-max Seat #2 is the button
Seat 1: ScousePro (1952 in chips)
Seat 2: AKsEffekt (816 in chips)
Seat 3: JourneyWell (1655 in chips)
Seat 4: dimetruk (1378 in chips)
Seat 5: FANTO812 (1438 in chips)
Seat 7: BigTunna99 (3282 in chips)
Seat 8: RedRafflesia (1396 in chips)
Seat 9: thanksdk (1583 in chips)
ScousePro: posts the ante 4
AKsEffekt: posts the ante 4
JourneyWell: posts the ante 4
dimetruk: posts the ante 4
FANTO812: posts the ante 4
BigTunna99: posts the ante 4
RedRafflesia: posts the ante 4
thanksdk: posts the ante 4
JourneyWell: posts small blind 15
dimetruk: posts big blind 30
*** HOLE CARDS ***
Dealt to dimetruk [6s 5d]
FANTO812: raises 30 to 60
BigTunna99: folds
RedRafflesia: folds
thanksdk: folds
ScousePro: folds
AKsEffekt: folds
JourneyWell: calls 45
dimetruk: calls 30
*** FLOP *** [Kd 4d 2h]
JourneyWell: checks
dimetruk: checks
FANTO812: checks
*** TURN *** [Kd 4d 2h] [9s]
JourneyWell: checks
dimetruk: bets 74
FANTO812: calls 74
JourneyWell: folds
*** RIVER *** [Kd 4d 2h 9s] [Kc]
dimetruk: bets 241
FANTO812: calls 241
*** SHOW DOWN ***
dimetruk: shows [6s 5d] (a pair of Kings)
FANTO812: shows [Qc 9c] (two pair, Kings and Nines)
FANTO812 collected 842 from pot
*** SUMMARY ***
Total pot 842 | Rake 0
Board [Kd 4d 2h 9s Kc]
Seat 1: ScousePro folded before Flop (didn't bet)
Seat 2: AKsEffekt (button) folded before Flop (didn't bet)
Seat 3: JourneyWell (small blind) folded on the Turn
Seat 4: dimetruk (big blind) showed [6s 5d] and lost with a pair of Kings
Seat 5: FANTO812 showed [Qc 9c] and won (842) with two pair, Kings and Nines
Seat 7: BigTunna99 folded before Flop (didn't bet)
Seat 8: RedRafflesia folded before Flop (didn't bet)
Seat 9: thanksdk folded before Flop (didn't bet)


PokerStars Hand #227059995474: Tournament #3200903456, $13.70+$1.30 USD Hold'em No Limit - Level II (15/30) - 2021/05/25 21:32:39 MSK [2021/05/25 14:32:39 ET]
Table '3200903456 1' 9-max Seat #5 is the button
Seat 1: ScousePro (1940 in chips)
Seat 2: AKsEffekt (804 in chips)
Seat 3: JourneyWell (1583 in chips)
Seat 4: dimetruk (976 in chips)
Seat 5: FANTO812 (1773 in chips)
Seat 7: BigTunna99 (3317 in chips)
Seat 8: RedRafflesia (1536 in chips)
Seat 9: thanksdk (1571 in chips)
ScousePro: posts the ante 4
AKsEffekt: posts the ante 4
JourneyWell: posts the ante 4
dimetruk: posts the ante 4
FANTO812: posts the ante 4
BigTunna99: posts the ante 4
RedRafflesia: posts the ante 4
thanksdk: posts the ante 4
BigTunna99: posts small blind 15
RedRafflesia: posts big blind 30
*** HOLE CARDS ***
Dealt to dimetruk [Jc Jh]
thanksdk: folds
ScousePro: folds
AKsEffekt: folds
JourneyWell: folds
dimetruk: raises 30 to 60
FANTO812: folds
BigTunna99: folds
RedRafflesia: calls 30
*** FLOP *** [5d Qd 7c]
RedRafflesia: checks
dimetruk: checks
*** TURN *** [5d Qd 7c] [5h]
RedRafflesia: checks
dimetruk: bets 58
RedRafflesia: folds
Uncalled bet (58) returned to dimetruk
dimetruk collected 167 from pot
dimetruk: doesn't show hand
*** SUMMARY ***
Total pot 167 | Rake 0
Board [5d Qd 7c 5h]
Seat 1: ScousePro folded before Flop (didn't bet)
Seat 2: AKsEffekt folded before Flop (didn't bet)
Seat 3: JourneyWell folded before Flop (didn't bet)
Seat 4: dimetruk collected (167)
Seat 5: FANTO812 (button) folded before Flop (didn't bet)
Seat 7: BigTunna99 (small blind) folded before Flop
Seat 8: RedRafflesia (big blind) folded on the Turn
Seat 9: thanksdk folded before Flop (didn't bet)


PokerStars Hand #227060129141: Tournament #3200903456, $13.70+$1.30 USD Hold'em No Limit - Level II (15/30) - 2021/05/25 21:36:56 MSK [2021/05/25 14:36:56 ET]
Table '3200903456 1' 9-max Seat #2 is the button
Seat 1: ScousePro (1875 in chips)
Seat 2: AKsEffekt (1754 in chips)
Seat 3: JourneyWell (886 in chips)
Seat 4: dimetruk (1063 in chips)
Seat 5: FANTO812 (1693 in chips)
Seat 7: BigTunna99 (3282 in chips)
Seat 8: RedRafflesia (1441 in chips)
Seat 9: thanksdk (1506 in chips)
ScousePro: posts the ante 4
AKsEffekt: posts the ante 4
JourneyWell: posts the ante 4
dimetruk: posts the ante 4
FANTO812: posts the ante 4
BigTunna99: posts the ante 4
RedRafflesia: posts the ante 4
thanksdk: posts the ante 4
JourneyWell: posts small blind 15
dimetruk: posts big blind 30
*** HOLE CARDS ***
Dealt to dimetruk [3d 9h]
FANTO812: folds
BigTunna99: folds
RedRafflesia: folds
thanksdk: folds
ScousePro: folds
AKsEffekt: folds
JourneyWell: raises 30 to 60
dimetruk: calls 30
*** FLOP *** [As 8s 7h]
JourneyWell: bets 60
dimetruk: folds
Uncalled bet (60) returned to JourneyWell
JourneyWell collected 152 from pot
*** SUMMARY ***
Total pot 152 | Rake 0
Board [As 8s 7h]
Seat 1: ScousePro folded before Flop (didn't bet)
Seat 2: AKsEffekt (button) folded before Flop (didn't bet)
Seat 3: JourneyWell (small blind) collected (152)
Seat 4: dimetruk (big blind) folded on the Flop
Seat 5: FANTO812 folded before Flop (didn't bet)
Seat 7: BigTunna99 folded before Flop (didn't bet)
Seat 8: RedRafflesia folded before Flop (didn't bet)
Seat 9: thanksdk folded before Flop (didn't bet)


PokerStars Hand #227060145912: Tournament #3200903456, $13.70+$1.30 USD Hold'em No Limit - Level III (25/50) - 2021/05/25 21:37:29 MSK [2021/05/25 14:37:29 ET]
Table '3200903456 1' 9-max Seat #3 is the button
Seat 1: ScousePro (1871 in chips)
Seat 2: AKsEffekt (1750 in chips)
Seat 3: JourneyWell (974 in chips)
Seat 4: dimetruk (999 in chips)
Seat 5: FANTO812 (1689 in chips)
Seat 7: BigTunna99 (3278 in chips)
Seat 8: RedRafflesia (1437 in chips)
Seat 9: thanksdk (1502 in chips)
ScousePro: posts the ante 6
AKsEffekt: posts the ante 6
JourneyWell: posts the ante 6
dimetruk: posts the ante 6
FANTO812: posts the ante 6
BigTunna99: posts the ante 6
RedRafflesia: posts the ante 6
thanksdk: posts the ante 6
dimetruk: posts small blind 25
FANTO812: posts big blind 50
*** HOLE CARDS ***
Dealt to dimetruk [2d Jd]
BigTunna99: folds
RedRafflesia: folds
thanksdk: folds
ScousePro: folds
AKsEffekt: folds
JourneyWell: folds
dimetruk: raises 50 to 100
FANTO812: calls 50
*** FLOP *** [8h 6h 4d]
dimetruk: checks
FANTO812: checks
*** TURN *** [8h 6h 4d] [6c]
dimetruk: bets 166
FANTO812: calls 166
*** RIVER *** [8h 6h 4d 6c] [4s]
dimetruk: checks
FANTO812: checks
*** SHOW DOWN ***
dimetruk: shows [2d Jd] (two pair, Sixes and Fours)
FANTO812: mucks hand
dimetruk collected 580 from pot
*** SUMMARY ***
Total pot 580 | Rake 0
Board [8h 6h 4d 6c 4s]
Seat 1: ScousePro folded before Flop (didn't bet)
Seat 2: AKsEffekt folded before Flop (didn't bet)
Seat 3: JourneyWell (button) folded before Flop (didn't bet)
Seat 4: dimetruk (small blind) showed [2d Jd] and won (580) with two pair, Sixes and Fours
Seat 5: FANTO812 (big blind) mucked [7h 9d]
Seat 7: BigTunna99 folded before Flop (didn't bet)
Seat 8: RedRafflesia folded before Flop (didn't bet)
Seat 9: thanksdk folded before Flop (didn't bet)


PokerStars Hand #227060180760: Tournament #3200903456, $13.70+$1.30 USD Hold'em No Limit - Level III (25/50) - 2021/05/25 21:38:38 MSK [2021/05/25 14:38:38 ET]
Table '3200903456 1' 9-max Seat #5 is the button
Seat 1: ScousePro (1859 in chips)
Seat 2: AKsEffekt (1738 in chips)
Seat 3: JourneyWell (912 in chips)
Seat 4: dimetruk (1474 in chips)
Seat 5: FANTO812 (1386 in chips)
Seat 7: BigTunna99 (3216 in chips)
Seat 8: RedRafflesia (1425 in chips)
Seat 9: thanksdk (1490 in chips)
ScousePro: posts the ante 6
AKsEffekt: posts the ante 6
JourneyWell: posts the ante 6
dimetruk: posts the ante 6
FANTO812: posts the ante 6
BigTunna99: posts the ante 6
RedRafflesia: posts the ante 6
thanksdk: posts the ante 6
BigTunna99: posts small blind 25
RedRafflesia: posts big blind 50
*** HOLE CARDS ***
Dealt to dimetruk [8s As]
thanksdk has timed out
thanksdk: folds
thanksdk is sitting out
ScousePro: folds
AKsEffekt: folds
thanksdk has returned
JourneyWell: calls 50
dimetruk: raises 100 to 150
FANTO812: folds
BigTunna99: folds
RedRafflesia: folds
JourneyWell: calls 100
*** FLOP *** [5h Kh 7c]
JourneyWell: checks
dimetruk: bets 200
JourneyWell: folds
Uncalled bet (200) returned to dimetruk
dimetruk collected 423 from pot
dimetruk: doesn't show hand
*** SUMMARY ***
Total pot 423 | Rake 0
Board [5h Kh 7c]
Seat 1: ScousePro folded before Flop (didn't bet)
Seat 2: AKsEffekt folded before Flop (didn't bet)
Seat 3: JourneyWell folded on the Flop
Seat 4: dimetruk collected (423)
Seat 5: FANTO812 (button) folded before Flop (didn't bet)
Seat 7: BigTunna99 (small blind) folded before Flop
Seat 8: RedRafflesia (big blind) folded before Flop
Seat 9: thanksdk folded before Flop (didn't bet)


PokerStars Hand #227060211755: Tournament #3200903456, $13.70+$1.30 USD Hold'em No Limit - Level III (25/50) - 2021/05/25 21:39:39 MSK [2021/05/25 14:39:39 ET]
Table '3200903456 1' 9-max Seat #7 is the button
Seat 1: ScousePro (1853 in chips)
Seat 2: AKsEffekt (1732 in chips)
Seat 3: JourneyWell (756 in chips)
Seat 4: dimetruk (1741 in chips)
Seat 5: FANTO812 (1380 in chips)
Seat 7: BigTunna99 (3185 in chips)
Seat 8: RedRafflesia (1369 in chips)
Seat 9: thanksdk (1484 in chips)
ScousePro: posts the ante 6
AKsEffekt: posts the ante 6
JourneyWell: posts the ante 6
dimetruk: posts the ante 6
FANTO812: posts the ante 6
BigTunna99: posts the ante 6
RedRafflesia: posts the ante 6
thanksdk: posts the ante 6
RedRafflesia: posts small blind 25
thanksdk: posts big blind 50
*** HOLE CARDS ***
Dealt to dimetruk [Ac Ah]
ScousePro: folds
AKsEffekt: folds
JourneyWell: raises 150 to 200
dimetruk: calls 200
FANTO812: folds
BigTunna99: folds
RedRafflesia: folds
thanksdk: folds
*** FLOP *** [8d 9h 9d]
JourneyWell: bets 550 and is all-in
dimetruk: calls 550
*** TURN *** [8d 9h 9d] [9s]
*** RIVER *** [8d 9h 9d 9s] [5c]
*** SHOW DOWN ***
JourneyWell: shows [Jc Ks] (three of a kind, Nines)
dimetruk: shows [Ac Ah] (a full house, Nines full of Aces)
dimetruk collected 1623 from pot
JourneyWell finished the tournament in 8th place
*** SUMMARY ***
Total pot 1623 | Rake 0
Board [8d 9h 9d 9s 5c]
Seat 1: ScousePro folded before Flop (didn't bet)
Seat 2: AKsEffekt folded before Flop (didn't bet)
Seat 3: JourneyWell showed [Jc Ks] and lost with three of a kind, Nines
Seat 4: dimetruk showed [Ac Ah] and won (1623) with a full house, Nines full of Aces
Seat 5: FANTO812 folded before Flop (didn't bet)
Seat 7: BigTunna99 (button) folded before Flop (didn't bet)
Seat 8: RedRafflesia (small blind) folded before Flop
Seat 9: thanksdk (big blind) folded before Flop


PokerStars Hand #227060245456: Tournament #3200903456, $13.70+$1.30 USD Hold'em No Limit - Level III (25/50) - 2021/05/25 21:40:45 MSK [2021/05/25 14:40:45 ET]
Table '3200903456 1' 9-max Seat #9 is the button
Seat 1: ScousePro (1791 in chips)
Seat 2: AKsEffekt (1720 in chips)
Seat 4: dimetruk (2602 in chips)
Seat 5: FANTO812 (1485 in chips)
Seat 7: BigTunna99 (3173 in chips)
Seat 8: RedRafflesia (1332 in chips)
Seat 9: thanksdk (1397 in chips)
ScousePro: posts the ante 6
AKsEffekt: posts the ante 6
dimetruk: posts the ante 6
FANTO812: posts the ante 6
BigTunna99: posts the ante 6
RedRafflesia: posts the ante 6
thanksdk: posts the ante 6
ScousePro: posts small blind 25
AKsEffekt: posts big blind 50
*** HOLE CARDS ***
Dealt to dimetruk [Ad 5d]
dimetruk: raises 50 to 100
FANTO812: folds
BigTunna99: folds
RedRafflesia: folds
thanksdk: folds
ScousePro: folds
AKsEffekt: calls 50
*** FLOP *** [6c 8s 7s]
AKsEffekt: checks
dimetruk: checks
*** TURN *** [6c 8s 7s] [As]
AKsEffekt: checks
dimetruk: bets 134
AKsEffekt: raises 216 to 350
dimetruk: calls 216
*** RIVER *** [6c 8s 7s As] [Qc]
AKsEffekt: bets 575
dimetruk: folds
Uncalled bet (575) returned to AKsEffekt
AKsEffekt collected 967 from pot
AKsEffekt: doesn't show hand
*** SUMMARY ***
Total pot 967 | Rake 0
Board [6c 8s 7s As Qc]
Seat 1: ScousePro (small blind) folded before Flop
Seat 2: AKsEffekt (big blind) collected (967)
Seat 4: dimetruk folded on the River
Seat 5: FANTO812 folded before Flop (didn't bet)
Seat 7: BigTunna99 folded before Flop (didn't bet)
Seat 8: RedRafflesia folded before Flop (didn't bet)
Seat 9: thanksdk (button) folded before Flop (didn't bet)


PokerStars Hand #227060624063: Tournament #3200903456, $13.70+$1.30 USD Hold'em No Limit - Level IV (40/80) - 2021/05/25 21:52:43 MSK [2021/05/25 14:52:43 ET]
Table '3200903456 1' 9-max Seat #1 is the button
Seat 1: ScousePro (1764 in chips)
Seat 2: AKsEffekt (2323 in chips)
Seat 4: dimetruk (2407 in chips)
Seat 7: BigTunna99 (3415 in chips)
Seat 8: RedRafflesia (1144 in chips)
Seat 9: thanksdk (2447 in chips)
ScousePro: posts the ante 10
AKsEffekt: posts the ante 10
dimetruk: posts the ante 10
BigTunna99: posts the ante 10
RedRafflesia: posts the ante 10
thanksdk: posts the ante 10
AKsEffekt: posts small blind 40
dimetruk: posts big blind 80
*** HOLE CARDS ***
Dealt to dimetruk [7c 7s]
BigTunna99: raises 96 to 176
RedRafflesia: folds
thanksdk: folds
ScousePro: folds
AKsEffekt: folds
dimetruk: calls 96
*** FLOP *** [Jd 3h 3s]
dimetruk: checks
BigTunna99: bets 149
dimetruk: calls 149
*** TURN *** [Jd 3h 3s] [Td]
dimetruk: checks
BigTunna99: bets 375
dimetruk: calls 375
*** RIVER *** [Jd 3h 3s Td] [Jc]
dimetruk: checks
BigTunna99: checks
*** SHOW DOWN ***
dimetruk: shows [7c 7s] (two pair, Jacks and Sevens)
BigTunna99: shows [Th Tc] (a full house, Tens full of Jacks)
BigTunna99 collected 1500 from pot
*** SUMMARY ***
Total pot 1500 | Rake 0
Board [Jd 3h 3s Td Jc]
Seat 1: ScousePro (button) folded before Flop (didn't bet)
Seat 2: AKsEffekt (small blind) folded before Flop
Seat 4: dimetruk (big blind) showed [7c 7s] and lost with two pair, Jacks and Sevens
Seat 7: BigTunna99 showed [Th Tc] and won (1500) with a full house, Tens full of Jacks
Seat 8: RedRafflesia folded before Flop (didn't bet)
Seat 9: thanksdk folded before Flop (didn't bet)


PokerStars Hand #227060916388: Tournament #3200903456, $13.70+$1.30 USD Hold'em No Limit - Level V (60/120) - 2021/05/25 22:03:44 MSK [2021/05/25 15:03:44 ET]
Table '3200903456 1' 9-max Seat #2 is the button
Seat 2: AKsEffekt (1588 in chips)
Seat 4: dimetruk (1242 in chips)
Seat 7: BigTunna99 (4306 in chips)
Seat 9: thanksdk (6364 in chips)
AKsEffekt: posts the ante 15
dimetruk: posts the ante 15
BigTunna99: posts the ante 15
thanksdk: posts the ante 15
dimetruk: posts small blind 60
BigTunna99: posts big blind 120
*** HOLE CARDS ***
Dealt to dimetruk [Kd 8d]
thanksdk: folds
AKsEffekt: folds
dimetruk: raises 1107 to 1227 and is all-in
BigTunna99: calls 1107
*** FLOP *** [Js 6d Tc]
*** TURN *** [Js 6d Tc] [Kc]
*** RIVER *** [Js 6d Tc Kc] [3h]
*** SHOW DOWN ***
dimetruk: shows [Kd 8d] (a pair of Kings)
BigTunna99: shows [Qh Kh] (a pair of Kings - Queen kicker)
BigTunna99 collected 2514 from pot
dimetruk finished the tournament in 4th place
*** SUMMARY ***
Total pot 2514 | Rake 0
Board [Js 6d Tc Kc 3h]
Seat 2: AKsEffekt (button) folded before Flop (didn't bet)
Seat 4: dimetruk (small blind) showed [Kd 8d] and lost with a pair of Kings
Seat 7: BigTunna99 (big blind) showed [Qh Kh] and won (2514) with a pair of Kings
Seat 9: thanksdk folded before Flop (didn't bet)


PokerStars Hand #227139351898: Tournament #3202694837, $13.70+$1.30 USD Hold'em No Limit - Level I (10/20) - 2021/05/28 22:17:43 MSK [2021/05/28 15:17:43 ET]
Table '3202694837 1' 9-max Seat #5 is the button
Seat 1: Kaptajn Jack (1488 in chips)
Seat 2: 10iz9 (1107 in chips)
Seat 3: RedRafflesia (1458 in chips)
Seat 4: bever664 (2602 in chips)
Seat 5: Boon501 (1458 in chips) is sitting out
Seat 6: Auge72 (1670 in chips)
Seat 7: dimetruk (1488 in chips)
Seat 8: VenRoan (741 in chips)
Seat 9: RaulG777 (1488 in chips)
Kaptajn Jack: posts the ante 3
10iz9: posts the ante 3
RedRafflesia: posts the ante 3
bever664: posts the ante 3
Boon501: posts the ante 3
Auge72: posts the ante 3
dimetruk: posts the ante 3
VenRoan: posts the ante 3
RaulG777: posts the ante 3
Auge72: posts small blind 10
dimetruk: posts big blind 20
*** HOLE CARDS ***
Dealt to dimetruk [Ah Qd]
VenRoan: folds
RaulG777: folds
Kaptajn Jack: folds
10iz9: folds
RedRafflesia: raises 30 to 50
bever664: folds
Boon501: folds
Auge72: folds
dimetruk: calls 30
*** FLOP *** [Ad 5d Tc]
dimetruk: checks
RedRafflesia: bets 52
dimetruk: calls 52
*** TURN *** [Ad 5d Tc] [Ts]
dimetruk: checks
RedRafflesia: checks
*** RIVER *** [Ad 5d Tc Ts] [Jh]
dimetruk: checks
RedRafflesia: checks
*** SHOW DOWN ***
dimetruk: shows [Ah Qd] (two pair, Aces and Tens)
RedRafflesia: mucks hand
dimetruk collected 241 from pot
*** SUMMARY ***
Total pot 241 | Rake 0
Board [Ad 5d Tc Ts Jh]
Seat 1: Kaptajn Jack folded before Flop (didn't bet)
Seat 2: 10iz9 folded before Flop (didn't bet)
Seat 3: RedRafflesia mucked [4d 4s]
Seat 4: bever664 folded before Flop (didn't bet)
Seat 5: Boon501 (button) folded before Flop (didn't bet)
Seat 6: Auge72 (small blind) folded before Flop
Seat 7: dimetruk (big blind) showed [Ah Qd] and won (241) with two pair, Aces and Tens
Seat 8: VenRoan folded before Flop (didn't bet)
Seat 9: RaulG777 folded before Flop (didn't bet)


PokerStars Hand #227139438624: Tournament #3202694837, $13.70+$1.30 USD Hold'em No Limit - Level I (10/20) - 2021/05/28 22:20:30 MSK [2021/05/28 15:20:30 ET]
Table '3202694837 1' 9-max Seat #9 is the button
Seat 1: Kaptajn Jack (1459 in chips)
Seat 2: 10iz9 (1172 in chips)
Seat 3: RedRafflesia (1347 in chips)
Seat 4: bever664 (2225 in chips)
Seat 5: Boon501 (1449 in chips) is sitting out
Seat 6: Auge72 (2103 in chips)
Seat 7: dimetruk (1608 in chips)
Seat 9: RaulG777 (1399 in chips)
Kaptajn Jack: posts the ante 3
10iz9: posts the ante 3
RedRafflesia: posts the ante 3
bever664: posts the ante 3
Boon501: posts the ante 3
Auge72: posts the ante 3
dimetruk: posts the ante 3
RaulG777: posts the ante 3
Kaptajn Jack: posts small blind 10
10iz9: posts big blind 20
*** HOLE CARDS ***
Dealt to dimetruk [Jd Ad]
RedRafflesia: folds
bever664: folds
Boon501: folds
Auge72: raises 40 to 60
dimetruk: raises 90 to 150
RaulG777: folds
Kaptajn Jack: folds
10iz9: folds
Auge72: calls 90
*** FLOP *** [6s 8c 7s]
Auge72: checks
dimetruk: checks
*** TURN *** [6s 8c 7s] [3c]
Auge72: bets 1950 and is all-in
dimetruk: folds
Uncalled bet (1950) returned to Auge72
Auge72 collected 354 from pot
Auge72: doesn't show hand
*** SUMMARY ***
Total pot 354 | Rake 0
Board [6s 8c 7s 3c]
Seat 1: Kaptajn Jack (small blind) folded before Flop
Seat 2: 10iz9 (big blind) folded before Flop
Seat 3: RedRafflesia folded before Flop (didn't bet)
Seat 4: bever664 folded before Flop (didn't bet)
Seat 5: Boon501 folded before Flop (didn't bet)
Seat 6: Auge72 collected (354)
Seat 7: dimetruk folded on the Turn
Seat 9: RaulG777 (button) folded before Flop (didn't bet)


PokerStars Hand #227139550542: Tournament #3202694837, $13.70+$1.30 USD Hold'em No Limit - Level II (15/30) - 2021/05/28 22:24:00 MSK [2021/05/28 15:24:00 ET]
Table '3202694837 1' 9-max Seat #5 is the button
Seat 1: Kaptajn Jack (1431 in chips)
Seat 2: 10iz9 (1338 in chips)
Seat 3: RedRafflesia (1294 in chips)
Seat 4: bever664 (2125 in chips)
Seat 5: Boon501 (1386 in chips)
Seat 6: Auge72 (2245 in chips)
Seat 7: dimetruk (1440 in chips)
Seat 9: RaulG777 (1503 in chips)
Kaptajn Jack: posts the ante 4
10iz9: posts the ante 4
RedRafflesia: posts the ante 4
bever664: posts the ante 4
Boon501: posts the ante 4
Auge72: posts the ante 4
dimetruk: posts the ante 4
RaulG777: posts the ante 4
Auge72: posts small blind 15
dimetruk: posts big blind 30
*** HOLE CARDS ***
Dealt to dimetruk [4s Qs]
RaulG777: raises 30 to 60
Kaptajn Jack: folds
10iz9: folds
RedRafflesia: folds
bever664: calls 60
Boon501: folds
Auge72: folds
dimetruk: calls 30
*** FLOP *** [7c Ts Js]
dimetruk: checks
RaulG777: checks
bever664: bets 227
dimetruk: folds
RaulG777: folds
Uncalled bet (227) returned to bever664
bever664 collected 227 from pot
bever664: doesn't show hand
*** SUMMARY ***
Total pot 227 | Rake 0
Board [7c Ts Js]
Seat 1: Kaptajn Jack folded before Flop (didn't bet)
Seat 2: 10iz9 folded before Flop (didn't bet)
Seat 3: RedRafflesia folded before Flop (didn't bet)
Seat 4: bever664 collected (227)
Seat 5: Boon501 (button) folded before Flop (didn't bet)
Seat 6: Auge72 (small blind) folded before Flop
Seat 7: dimetruk (big blind) folded on the Flop
Seat 9: RaulG777 folded on the Flop


PokerStars Hand #227139785300: Tournament #3202694837, $13.70+$1.30 USD Hold'em No Limit - Level II (15/30) - 2021/05/28 22:31:10 MSK [2021/05/28 15:31:10 ET]
Table '3202694837 1' 9-max Seat #5 is the button
Seat 2: 10iz9 (1398 in chips)
Seat 3: RedRafflesia (1587 in chips)
Seat 4: bever664 (3736 in chips)
Seat 5: Boon501 (1283 in chips)
Seat 6: Auge72 (2338 in chips)
Seat 7: dimetruk (1410 in chips)
Seat 9: RaulG777 (1010 in chips)
10iz9: posts the ante 4
RedRafflesia: posts the ante 4
bever664: posts the ante 4
Boon501: posts the ante 4
Auge72: posts the ante 4
dimetruk: posts the ante 4
RaulG777: posts the ante 4
Auge72: posts small blind 15
dimetruk: posts big blind 30
*** HOLE CARDS ***
Dealt to dimetruk [Kh 9d]
RaulG777: folds
10iz9: folds
RedRafflesia: folds
bever664: folds
Boon501 has timed out
Boon501: folds
Boon501 is sitting out
Boon501 has returned
Auge72: raises 30 to 60
dimetruk: calls 30
*** FLOP *** [3d Ts Qs]
Auge72: checks
dimetruk: checks
*** TURN *** [3d Ts Qs] [5s]
Auge72: checks
dimetruk: bets 74
Auge72: calls 74
*** RIVER *** [3d Ts Qs 5s] [7s]
Auge72: checks
dimetruk: bets 255
Auge72: folds
Uncalled bet (255) returned to dimetruk
dimetruk collected 296 from pot
dimetruk: doesn't show hand
*** SUMMARY ***
Total pot 296 | Rake 0
Board [3d Ts Qs 5s 7s]
Seat 2: 10iz9 folded before Flop (didn't bet)
Seat 3: RedRafflesia folded before Flop (didn't bet)
Seat 4: bever664 folded before Flop (didn't bet)
Seat 5: Boon501 (button) folded before Flop (didn't bet)
Seat 6: Auge72 (small blind) folded on the River
Seat 7: dimetruk (big blind) collected (296)
Seat 9: RaulG777 folded before Flop (didn't bet)


PokerStars Hand #227139933102: Tournament #3202694837, $13.70+$1.30 USD Hold'em No Limit - Level III (25/50) - 2021/05/28 22:35:31 MSK [2021/05/28 15:35:31 ET]
Table '3202694837 1' 9-max Seat #6 is the button
Seat 2: 10iz9 (1611 in chips)
Seat 3: RedRafflesia (1466 in chips)
Seat 4: bever664 (3611 in chips)
Seat 5: Boon501 (1279 in chips)
Seat 6: Auge72 (2221 in chips)
Seat 7: dimetruk (1568 in chips)
Seat 9: RaulG777 (1006 in chips)
10iz9: posts the ante 6
RedRafflesia: posts the ante 6
bever664: posts the ante 6
Boon501: posts the ante 6
Auge72: posts the ante 6
dimetruk: posts the ante 6
RaulG777: posts the ante 6
dimetruk: posts small blind 25
RaulG777: posts big blind 50
*** HOLE CARDS ***
Dealt to dimetruk [8d 9s]
10iz9: folds
RedRafflesia: folds
bever664: folds
Boon501: folds
Auge72: calls 50
dimetruk: calls 25
RaulG777: checks
*** FLOP *** [Kc Ah Qc]
dimetruk: checks
RaulG777: bets 115
Auge72: calls 115
dimetruk: folds
*** TURN *** [Kc Ah Qc] [2d]
RaulG777: bets 253
Auge72: raises 253 to 506
RaulG777: raises 329 to 835 and is all-in
Auge72: calls 329
*** RIVER *** [Kc Ah Qc 2d] [Js]
*** SHOW DOWN ***
RaulG777: shows [Td Jd] (a straight, Ten to Ace)
Auge72: shows [Jh Kd] (two pair, Kings and Jacks)
RaulG777 collected 2092 from pot
*** SUMMARY ***
Total pot 2092 | Rake 0
Board [Kc Ah Qc 2d Js]
Seat 2: 10iz9 folded before Flop (didn't bet)
Seat 3: RedRafflesia folded before Flop (didn't bet)
Seat 4: bever664 folded before Flop (didn't bet)
Seat 5: Boon501 folded before Flop (didn't bet)
Seat 6: Auge72 (button) showed [Jh Kd] and lost with two pair, Kings and Jacks
Seat 7: dimetruk (small blind) folded on the Flop
Seat 9: RaulG777 (big blind) showed [Td Jd] and won (2092) with a straight, Ten to Ace


PokerStars Hand #227140074367: Tournament #3202694837, $13.70+$1.30 USD Hold'em No Limit - Level III (25/50) - 2021/05/28 22:39:39 MSK [2021/05/28 15:39:39 ET]
Table '3202694837 1' 9-max Seat #5 is the button
Seat 2: 10iz9 (1450 in chips)
Seat 3: RedRafflesia (1626 in chips)
Seat 4: bever664 (3934 in chips)
Seat 5: Boon501 (1235 in chips)
Seat 6: Auge72 (1148 in chips)
Seat 7: dimetruk (1482 in chips)
Seat 9: RaulG777 (1887 in chips)
10iz9: posts the ante 6
RedRafflesia: posts the ante 6
bever664: posts the ante 6
Boon501: posts the ante 6
Auge72: posts the ante 6
dimetruk: posts the ante 6
RaulG777: posts the ante 6
Auge72: posts small blind 25
dimetruk: posts big blind 50
*** HOLE CARDS ***
Dealt to dimetruk [5c As]
RaulG777: folds
10iz9: folds
RedRafflesia: raises 67 to 117
bever664: calls 117
Boon501: folds
Auge72: calls 92
dimetruk: calls 67
*** FLOP *** [Ad Ks 3s]
Auge72: checks
dimetruk: checks
RedRafflesia: checks
bever664: checks
*** TURN *** [Ad Ks 3s] [Ah]
Auge72: checks
dimetruk: bets 255
RedRafflesia: calls 255
bever664: folds
Auge72: folds
*** RIVER *** [Ad Ks 3s Ah] [6s]
dimetruk: checks
RedRafflesia: checks
*** SHOW DOWN ***
dimetruk: shows [5c As] (three of a kind, Aces)
RedRafflesia: mucks hand
dimetruk collected 1020 from pot
*** SUMMARY ***
Total pot 1020 | Rake 0
Board [Ad Ks 3s Ah 6s]
Seat 2: 10iz9 folded before Flop (didn't bet)
Seat 3: RedRafflesia mucked [Jd Kd]
Seat 4: bever664 folded on the Turn
Seat 5: Boon501 (button) folded before Flop (didn't bet)
Seat 6: Auge72 (small blind) folded on the Turn
Seat 7: dimetruk (big blind) showed [5c As] and won (1020) with three of a kind, Aces
Seat 9: RaulG777 folded before Flop (didn't bet)


PokerStars Hand #227140234336: Tournament #3202694837, $13.70+$1.30 USD Hold'em No Limit - Level IV (40/80) - 2021/05/28 22:44:41 MSK [2021/05/28 15:44:41 ET]
Table '3202694837 1' 9-max Seat #5 is the button
Seat 2: 10iz9 (1302 in chips)
Seat 3: RedRafflesia (1076 in chips)
Seat 4: bever664 (1815 in chips)
Seat 5: Boon501 (2724 in chips)
Seat 6: Auge72 (1854 in chips)
Seat 7: dimetruk (2237 in chips)
Seat 9: RaulG777 (1754 in chips)
10iz9: posts the ante 10
RedRafflesia: posts the ante 10
bever664: posts the ante 10
Boon501: posts the ante 10
Auge72: posts the ante 10
dimetruk: posts the ante 10
RaulG777: posts the ante 10
Auge72: posts small blind 40
dimetruk: posts big blind 80
*** HOLE CARDS ***
Dealt to dimetruk [8h 5h]
RaulG777: folds
10iz9: folds
RedRafflesia: folds
bever664: folds
Boon501: raises 96 to 176
Auge72: calls 136
dimetruk: calls 96
*** FLOP *** [Jh Ts 2c]
Auge72: checks
dimetruk: checks
Boon501: checks
*** TURN *** [Jh Ts 2c] [8c]
Auge72: checks
dimetruk: bets 209
Boon501: calls 209
Auge72: folds
*** RIVER *** [Jh Ts 2c 8c] [9d]
dimetruk: checks
Boon501: bets 616
dimetruk: folds
Uncalled bet (616) returned to Boon501
Boon501 collected 1016 from pot
Boon501: doesn't show hand
*** SUMMARY ***
Total pot 1016 | Rake 0
Board [Jh Ts 2c 8c 9d]
Seat 2: 10iz9 folded before Flop (didn't bet)
Seat 3: RedRafflesia folded before Flop (didn't bet)
Seat 4: bever664 folded before Flop (didn't bet)
Seat 5: Boon501 (button) collected (1016)
Seat 6: Auge72 (small blind) folded on the Turn
Seat 7: dimetruk (big blind) folded on the River
Seat 9: RaulG777 folded before Flop (didn't bet)


PokerStars Hand #227140385287: Tournament #3202694837, $13.70+$1.30 USD Hold'em No Limit - Level IV (40/80) - 2021/05/28 22:49:26 MSK [2021/05/28 15:49:26 ET]
Table '3202694837 1' 9-max Seat #5 is the button
Seat 2: 10iz9 (1302 in chips)
Seat 3: RedRafflesia (2112 in chips)
Seat 4: bever664 (2595 in chips)
Seat 5: Boon501 (3131 in chips)
Seat 6: Auge72 (1448 in chips)
Seat 7: dimetruk (1742 in chips)
Seat 9: RaulG777 (432 in chips)
10iz9: posts the ante 10
RedRafflesia: posts the ante 10
bever664: posts the ante 10
Boon501: posts the ante 10
Auge72: posts the ante 10
dimetruk: posts the ante 10
RaulG777: posts the ante 10
Auge72: posts small blind 40
dimetruk: posts big blind 80
*** HOLE CARDS ***
Dealt to dimetruk [8d 7s]
RaulG777: folds
10iz9: folds
RedRafflesia: raises 80 to 160
bever664: folds
Boon501: folds
Auge72: calls 120
dimetruk: calls 80
*** FLOP *** [5h 5d Qs]
Auge72: bets 80
dimetruk: folds
RedRafflesia: calls 80
*** TURN *** [5h 5d Qs] [2d]
Auge72: bets 80
RedRafflesia: calls 80
*** RIVER *** [5h 5d Qs 2d] [3h]
Auge72: bets 80
RedRafflesia: calls 80
*** SHOW DOWN ***
Auge72: shows [Qd Ts] (two pair, Queens and Fives)
RedRafflesia: mucks hand
Auge72 collected 1030 from pot
*** SUMMARY ***
Total pot 1030 | Rake 0
Board [5h 5d Qs 2d 3h]
Seat 2: 10iz9 folded before Flop (didn't bet)
Seat 3: RedRafflesia mucked [Ac Kh]
Seat 4: bever664 folded before Flop (didn't bet)
Seat 5: Boon501 (button) folded before Flop (didn't bet)
Seat 6: Auge72 (small blind) showed [Qd Ts] and won (1030) with two pair, Queens and Fives
Seat 7: dimetruk (big blind) folded on the Flop
Seat 9: RaulG777 folded before Flop (didn't bet)


PokerStars Hand #227140567001: Tournament #3202694837, $13.70+$1.30 USD Hold'em No Limit - Level V (60/120) - 2021/05/28 22:55:01 MSK [2021/05/28 15:55:01 ET]
Table '3202694837 1' 9-max Seat #6 is the button
Seat 2: 10iz9 (1652 in chips)
Seat 4: bever664 (3162 in chips)
Seat 5: Boon501 (2586 in chips)
Seat 6: Auge72 (4115 in chips)
Seat 7: dimetruk (1247 in chips)
10iz9: posts the ante 15
bever664: posts the ante 15
Boon501: posts the ante 15
Auge72: posts the ante 15
dimetruk: posts the ante 15
dimetruk: posts small blind 60
10iz9: posts big blind 120
*** HOLE CARDS ***
Dealt to dimetruk [Kc Ks]
bever664: folds
Boon501: raises 120 to 240
Auge72: folds
dimetruk: raises 992 to 1232 and is all-in
10iz9: folds
Boon501: calls 992
*** FLOP *** [Qh Qc As]
*** TURN *** [Qh Qc As] [Th]
*** RIVER *** [Qh Qc As Th] [Jh]
*** SHOW DOWN ***
dimetruk: shows [Kc Ks] (a straight, Ten to Ace)
Boon501: shows [9s Ah] (two pair, Aces and Queens)
dimetruk collected 2659 from pot
*** SUMMARY ***
Total pot 2659 | Rake 0
Board [Qh Qc As Th Jh]
Seat 2: 10iz9 (big blind) folded before Flop
Seat 4: bever664 folded before Flop (didn't bet)
Seat 5: Boon501 showed [9s Ah] and lost with two pair, Aces and Queens
Seat 6: Auge72 (button) folded before Flop (didn't bet)
Seat 7: dimetruk (small blind) showed [Kc Ks] and won (2659) with a straight, Ten to Ace


PokerStars Hand #227140711421: Tournament #3202694837, $13.70+$1.30 USD Hold'em No Limit - Level V (60/120) - 2021/05/28 23:01:08 MSK [2021/05/28 16:01:08 ET]
Table '3202694837 1' 9-max Seat #2 is the button
Seat 2: 10iz9 (1442 in chips)
Seat 4: bever664 (3012 in chips) is sitting out
Seat 5: Boon501 (1324 in chips)
Seat 6: Auge72 (4340 in chips)
Seat 7: dimetruk (2644 in chips)
10iz9: posts the ante 15
bever664: posts the ante 15
Boon501: posts the ante 15
Auge72: posts the ante 15
dimetruk: posts the ante 15
bever664: posts small blind 60
Boon501: posts big blind 120
*** HOLE CARDS ***
Dealt to dimetruk [Qh Ah]
Auge72: folds
dimetruk: raises 2509 to 2629 and is all-in
10iz9: folds
bever664: folds
Boon501: calls 1189 and is all-in
Uncalled bet (1320) returned to dimetruk
*** FLOP *** [4c Jd 7h]
*** TURN *** [4c Jd 7h] [Ts]
*** RIVER *** [4c Jd 7h Ts] [6s]
*** SHOW DOWN ***
Boon501: shows [5h 5c] (a pair of Fives)
dimetruk: shows [Qh Ah] (high card Ace)
Boon501 collected 2753 from pot
*** SUMMARY ***
Total pot 2753 | Rake 0
Board [4c Jd 7h Ts 6s]
Seat 2: 10iz9 (button) folded before Flop (didn't bet)
Seat 4: bever664 (small blind) folded before Flop
Seat 5: Boon501 (big blind) showed [5h 5c] and won (2753) with a pair of Fives
Seat 6: Auge72 folded before Flop (didn't bet)
Seat 7: dimetruk showed [Qh Ah] and lost with high card Ace


PokerStars Hand #227140962692: Tournament #3202694837, $13.70+$1.30 USD Hold'em No Limit - Level VI (80/160) - 2021/05/28 23:08:40 MSK [2021/05/28 16:08:40 ET]
Table '3202694837 1' 9-max Seat #6 is the button
Seat 1: poky147 (4678 in chips)
Seat 2: 10iz9 (1077 in chips)
Seat 3: tuborg123456 (3536 in chips)
Seat 4: bever664 (3487 in chips)
Seat 5: Boon501 (1731 in chips)
Seat 6: Auge72 (2094 in chips)
Seat 7: dimetruk (1695 in chips)
Seat 8: VanNekuryuk (3279 in chips)
Seat 9: RagztoRiches (5423 in chips)
poky147: posts the ante 20
10iz9: posts the ante 20
tuborg123456: posts the ante 20
bever664: posts the ante 20
Boon501: posts the ante 20
Auge72: posts the ante 20
dimetruk: posts the ante 20
VanNekuryuk: posts the ante 20
RagztoRiches: posts the ante 20
dimetruk: posts small blind 80
VanNekuryuk: posts big blind 160
*** HOLE CARDS ***
Dealt to dimetruk [8s 8c]
RagztoRiches: folds
poky147: folds
10iz9: folds
tuborg123456: folds
bever664: calls 160
Boon501: folds
Auge72: folds
dimetruk: raises 1515 to 1675 and is all-in
VanNekuryuk: folds
bever664: calls 1515
*** FLOP *** [Ac 2c Jd]
*** TURN *** [Ac 2c Jd] [As]
*** RIVER *** [Ac 2c Jd As] [Ah]
*** SHOW DOWN ***
dimetruk: shows [8s 8c] (a full house, Aces full of Eights)
bever664: shows [6s 6d] (a full house, Aces full of Sixes)
dimetruk collected 3690 from pot
*** SUMMARY ***
Total pot 3690 | Rake 0
Board [Ac 2c Jd As Ah]
Seat 1: poky147 folded before Flop (didn't bet)
Seat 2: 10iz9 folded before Flop (didn't bet)
Seat 3: tuborg123456 folded before Flop (didn't bet)
Seat 4: bever664 showed [6s 6d] and lost with a full house, Aces full of Sixes
Seat 5: Boon501 folded before Flop (didn't bet)
Seat 6: Auge72 (button) folded before Flop (didn't bet)
Seat 7: dimetruk (small blind) showed [8s 8c] and won (3690) with a full house, Aces full of Eights
Seat 8: VanNekuryuk (big blind) folded before Flop
Seat 9: RagztoRiches folded before Flop (didn't bet)


PokerStars Hand #227141120315: Tournament #3202694837, $13.70+$1.30 USD Hold'em No Limit - Level VI (80/160) - 2021/05/28 23:13:38 MSK [2021/05/28 16:13:38 ET]
Table '3202694837 1' 9-max Seat #8 is the button
Seat 1: poky147 (9346 in chips)
Seat 3: tuborg123456 (3276 in chips)
Seat 4: bever664 (3252 in chips)
Seat 5: Boon501 (1311 in chips)
Seat 7: dimetruk (3290 in chips)
Seat 8: VanNekuryuk (2619 in chips)
Seat 9: RagztoRiches (3906 in chips)
poky147: posts the ante 20
tuborg123456: posts the ante 20
bever664: posts the ante 20
Boon501: posts the ante 20
dimetruk: posts the ante 20
VanNekuryuk: posts the ante 20
RagztoRiches: posts the ante 20
RagztoRiches: posts small blind 80
poky147: posts big blind 160
*** HOLE CARDS ***
Dealt to dimetruk [As Ad]
tuborg123456: folds
bever664: calls 160
Boon501: raises 1131 to 1291 and is all-in
dimetruk: raises 1979 to 3270 and is all-in
VanNekuryuk: folds
RagztoRiches: folds
poky147: folds
bever664: folds
Uncalled bet (1979) returned to dimetruk
*** FLOP *** [Jd 4h Td]
*** TURN *** [Jd 4h Td] [Qs]
*** RIVER *** [Jd 4h Td Qs] [Th]
*** SHOW DOWN ***
Boon501: shows [4c Ac] (two pair, Tens and Fours)
dimetruk: shows [As Ad] (two pair, Aces and Tens)
dimetruk collected 3122 from pot
Boon501 finished the tournament in 7th place
*** SUMMARY ***
Total pot 3122 | Rake 0
Board [Jd 4h Td Qs Th]
Seat 1: poky147 (big blind) folded before Flop
Seat 3: tuborg123456 folded before Flop (didn't bet)
Seat 4: bever664 folded before Flop
Seat 5: Boon501 showed [4c Ac] and lost with two pair, Tens and Fours
Seat 7: dimetruk showed [As Ad] and won (3122) with two pair, Aces and Tens
Seat 8: VanNekuryuk (button) folded before Flop (didn't bet)
Seat 9: RagztoRiches (small blind) folded before Flop


PokerStars Hand #227141168372: Tournament #3202694837, $13.70+$1.30 USD Hold'em No Limit - Level VI (80/160) - 2021/05/28 23:15:08 MSK [2021/05/28 16:15:08 ET]
Table '3202694837 1' 9-max Seat #3 is the button
Seat 1: poky147 (9046 in chips)
Seat 3: tuborg123456 (444 in chips)
Seat 4: bever664 (6124 in chips)
Seat 7: dimetruk (5061 in chips)
Seat 8: VanNekuryuk (2559 in chips)
Seat 9: RagztoRiches (3766 in chips)
poky147: posts the ante 20
tuborg123456: posts the ante 20
bever664: posts the ante 20
dimetruk: posts the ante 20
VanNekuryuk: posts the ante 20
RagztoRiches: posts the ante 20
bever664: posts small blind 80
dimetruk: posts big blind 160
*** HOLE CARDS ***
Dealt to dimetruk [Jh Jd]
VanNekuryuk: raises 160 to 320
RagztoRiches: folds
poky147: folds
tuborg123456: raises 104 to 424 and is all-in
bever664: calls 344
dimetruk: raises 4617 to 5041 and is all-in
VanNekuryuk: folds
bever664: folds
Uncalled bet (4617) returned to dimetruk
*** FLOP *** [6d 8h Ac]
*** TURN *** [6d 8h Ac] [3d]
*** RIVER *** [6d 8h Ac 3d] [4s]
*** SHOW DOWN ***
dimetruk: shows [Jh Jd] (a pair of Jacks)
tuborg123456: shows [Js As] (a pair of Aces)
tuborg123456 collected 1712 from pot
*** SUMMARY ***
Total pot 1712 | Rake 0
Board [6d 8h Ac 3d 4s]
Seat 1: poky147 folded before Flop (didn't bet)
Seat 3: tuborg123456 (button) showed [Js As] and won (1712) with a pair of Aces
Seat 4: bever664 (small blind) folded before Flop
Seat 7: dimetruk (big blind) showed [Jh Jd] and lost with a pair of Jacks
Seat 8: VanNekuryuk folded before Flop
Seat 9: RagztoRiches folded before Flop (didn't bet)


PokerStars Hand #227141345087: Tournament #3202694837, $13.70+$1.30 USD Hold'em No Limit - Level VII (100/200) - 2021/05/28 23:20:13 MSK [2021/05/28 16:20:13 ET]
Table '3202694837 1' 9-max Seat #8 is the button
Seat 1: poky147 (9021 in chips)
Seat 3: tuborg123456 (2487 in chips)
Seat 4: bever664 (5645 in chips)
Seat 7: dimetruk (4862 in chips)
Seat 8: VanNekuryuk (1944 in chips)
Seat 9: RagztoRiches (3041 in chips)
poky147: posts the ante 25
tuborg123456: posts the ante 25
bever664: posts the ante 25
dimetruk: posts the ante 25
VanNekuryuk: posts the ante 25
RagztoRiches: posts the ante 25
RagztoRiches: posts small blind 100
poky147: posts big blind 200
*** HOLE CARDS ***
Dealt to dimetruk [Kd Kh]
tuborg123456: folds
bever664: folds
dimetruk: raises 200 to 400
VanNekuryuk: folds
RagztoRiches: folds
poky147: calls 200
*** FLOP *** [5c Tc 9c]
poky147: checks
dimetruk: bets 368
poky147: raises 368 to 736
dimetruk: calls 368
*** TURN *** [5c Tc 9c] [Qd]
poky147: checks
dimetruk: checks
*** RIVER *** [5c Tc 9c Qd] [8s]
poky147: bets 200
dimetruk: calls 200
*** SHOW DOWN ***
poky147: shows [Jh 6s] (a straight, Eight to Queen)
dimetruk: mucks hand
poky147 collected 2922 from pot
*** SUMMARY ***
Total pot 2922 | Rake 0
Board [5c Tc 9c Qd 8s]
Seat 1: poky147 (big blind) showed [Jh 6s] and won (2922) with a straight, Eight to Queen
Seat 3: tuborg123456 folded before Flop (didn't bet)
Seat 4: bever664 folded before Flop (didn't bet)
Seat 7: dimetruk mucked [Kd Kh]
Seat 8: VanNekuryuk (button) folded before Flop (didn't bet)
Seat 9: RagztoRiches (small blind) folded before Flop


PokerStars Hand #227141682732: Tournament #3202694837, $13.70+$1.30 USD Hold'em No Limit - Level VIII (150/300) - 2021/05/28 23:30:05 MSK [2021/05/28 16:30:05 ET]
Table '3202694837 1' 9-max Seat #8 is the button
Seat 1: poky147 (15377 in chips)
Seat 3: tuborg123456 (3212 in chips)
Seat 7: dimetruk (2301 in chips)
Seat 8: VanNekuryuk (2719 in chips)
Seat 9: RagztoRiches (3391 in chips)
poky147: posts the ante 25
tuborg123456: posts the ante 25
dimetruk: posts the ante 25
VanNekuryuk: posts the ante 25
RagztoRiches: posts the ante 25
RagztoRiches: posts small blind 150
poky147: posts big blind 300
*** HOLE CARDS ***
Dealt to dimetruk [Kh Tc]
tuborg123456: folds
dimetruk: raises 1976 to 2276 and is all-in
VanNekuryuk: folds
RagztoRiches: folds
poky147: calls 1976
*** FLOP *** [8h 2c 3s]
*** TURN *** [8h 2c 3s] [2h]
*** RIVER *** [8h 2c 3s 2h] [3h]
*** SHOW DOWN ***
poky147: shows [9c Jc] (two pair, Threes and Deuces)
dimetruk: shows [Kh Tc] (two pair, Threes and Deuces - King kicker)
dimetruk collected 4827 from pot
*** SUMMARY ***
Total pot 4827 | Rake 0
Board [8h 2c 3s 2h 3h]
Seat 1: poky147 (big blind) showed [9c Jc] and lost with two pair, Threes and Deuces
Seat 3: tuborg123456 folded before Flop (didn't bet)
Seat 7: dimetruk showed [Kh Tc] and won (4827) with two pair, Threes and Deuces
Seat 8: VanNekuryuk (button) folded before Flop (didn't bet)
Seat 9: RagztoRiches (small blind) folded before Flop


PokerStars Hand #227141703600: Tournament #3202694837, $13.70+$1.30 USD Hold'em No Limit - Level VIII (150/300) - 2021/05/28 23:30:43 MSK [2021/05/28 16:30:43 ET]
Table '3202694837 1' 9-max Seat #1 is the button
Seat 1: poky147 (12901 in chips)
Seat 3: tuborg123456 (2862 in chips)
Seat 7: dimetruk (5377 in chips)
Seat 8: VanNekuryuk (2669 in chips)
Seat 9: RagztoRiches (3191 in chips)
poky147: posts the ante 25
tuborg123456: posts the ante 25
dimetruk: posts the ante 25
VanNekuryuk: posts the ante 25
RagztoRiches: posts the ante 25
tuborg123456: posts small blind 150
dimetruk: posts big blind 300
*** HOLE CARDS ***
Dealt to dimetruk [Ac Ah]
VanNekuryuk: folds
RagztoRiches: folds
poky147: folds
tuborg123456: raises 2537 to 2837 and is all-in
dimetruk: calls 2537
*** FLOP *** [7h Kd 9s]
*** TURN *** [7h Kd 9s] [2h]
*** RIVER *** [7h Kd 9s 2h] [7d]
*** SHOW DOWN ***
tuborg123456: shows [As Qs] (a pair of Sevens)
dimetruk: shows [Ac Ah] (two pair, Aces and Sevens)
dimetruk collected 5799 from pot
tuborg123456 finished the tournament in 5th place
*** SUMMARY ***
Total pot 5799 | Rake 0
Board [7h Kd 9s 2h 7d]
Seat 1: poky147 (button) folded before Flop (didn't bet)
Seat 3: tuborg123456 (small blind) showed [As Qs] and lost with a pair of Sevens
Seat 7: dimetruk (big blind) showed [Ac Ah] and won (5799) with two pair, Aces and Sevens
Seat 8: VanNekuryuk folded before Flop (didn't bet)
Seat 9: RagztoRiches folded before Flop (didn't bet)


PokerStars Hand #227141734201: Tournament #3202694837, $13.70+$1.30 USD Hold'em No Limit - Level VIII (150/300) - 2021/05/28 23:31:38 MSK [2021/05/28 16:31:38 ET]
Table '3202694837 1' 9-max Seat #7 is the button
Seat 1: poky147 (19036 in chips)
Seat 7: dimetruk (7964 in chips)
poky147: posts the ante 25
dimetruk: posts the ante 25
dimetruk: posts small blind 150
poky147: posts big blind 300
*** HOLE CARDS ***
Dealt to dimetruk [Jc 8h]
dimetruk: calls 150
poky147: checks
*** FLOP *** [9h 2c 2d]
poky147: checks
dimetruk: bets 300
poky147: folds
Uncalled bet (300) returned to dimetruk
dimetruk collected 650 from pot
dimetruk: doesn't show hand
*** SUMMARY ***
Total pot 650 | Rake 0
Board [9h 2c 2d]
Seat 1: poky147 (big blind) folded on the Flop
Seat 7: dimetruk (button) (small blind) collected (650)


PokerStars Hand #227141772769: Tournament #3202694837, $13.70+$1.30 USD Hold'em No Limit - Level VIII (150/300) - 2021/05/28 23:32:47 MSK [2021/05/28 16:32:47 ET]
Table '3202694837 1' 9-max Seat #7 is the button
Seat 1: poky147 (19986 in chips)
Seat 7: dimetruk (7014 in chips)
poky147: posts the ante 25
dimetruk: posts the ante 25
dimetruk: posts small blind 150
poky147: posts big blind 300
*** HOLE CARDS ***
Dealt to dimetruk [Kh Kd]
dimetruk: raises 300 to 600
poky147: calls 300
*** FLOP *** [7h 4d Ah]
poky147: checks
dimetruk: checks
*** TURN *** [7h 4d Ah] [Js]
poky147: checks
dimetruk: bets 625
poky147: folds
Uncalled bet (625) returned to dimetruk
dimetruk collected 1250 from pot
dimetruk: doesn't show hand
*** SUMMARY ***
Total pot 1250 | Rake 0
Board [7h 4d Ah Js]
Seat 1: poky147 (big blind) folded on the Turn
Seat 7: dimetruk (button) (small blind) collected (1250)


PokerStars Hand #227141785417: Tournament #3202694837, $13.70+$1.30 USD Hold'em No Limit - Level VIII (150/300) - 2021/05/28 23:33:10 MSK [2021/05/28 16:33:10 ET]
Table '3202694837 1' 9-max Seat #7 is the button
Seat 1: poky147 (19186 in chips)
Seat 7: dimetruk (7814 in chips)
poky147: posts the ante 25
dimetruk: posts the ante 25
dimetruk: posts small blind 150
poky147: posts big blind 300
*** HOLE CARDS ***
Dealt to dimetruk [8s 8c]
dimetruk: raises 7489 to 7789 and is all-in
poky147: calls 7489
*** FLOP *** [Kc 4c 2d]
*** TURN *** [Kc 4c 2d] [2s]
*** RIVER *** [Kc 4c 2d 2s] [Qd]
*** SHOW DOWN ***
poky147: shows [6c Kh] (two pair, Kings and Deuces)
dimetruk: shows [8s 8c] (two pair, Eights and Deuces)
poky147 collected 15628 from pot
dimetruk finished the tournament in 2nd place and received $73.98.
poky147 wins the tournament and receives $98.64 - congratulations!
*** SUMMARY ***
Total pot 15628 | Rake 0
Board [Kc 4c 2d 2s Qd]
Seat 1: poky147 (big blind) showed [6c Kh] and won (15628) with two pair, Kings and Deuces
Seat 7: dimetruk (button) (small blind) showed [8s 8c] and lost with two pair, Eights and Deuces


PokerStars Hand #227138750038: Tournament #3203173572, $27.40+$2.60 USD Hold'em No Limit - Level I (10/20) - 2021/05/28 21:57:04 MSK [2021/05/28 14:57:04 ET]
Table '3203173572 1' 9-max Seat #3 is the button
Seat 1: thimmy11 (1494 in chips)
Seat 2: dclucasPS (1484 in chips)
Seat 3: berlin1888 (1499 in chips)
Seat 4: DeeMarse (1414 in chips)
Seat 5: dimetruk (1494 in chips)
Seat 6: Vandbro (1494 in chips)
Seat 7: vegethnizdo (1494 in chips)
Seat 8: RedRafflesia (1494 in chips)
Seat 9: leizima (1633 in chips)
thimmy11: posts the ante 3
dclucasPS: posts the ante 3
berlin1888: posts the ante 3
DeeMarse: posts the ante 3
dimetruk: posts the ante 3
Vandbro: posts the ante 3
vegethnizdo: posts the ante 3
RedRafflesia: posts the ante 3
leizima: posts the ante 3
DeeMarse: posts small blind 10
dimetruk: posts big blind 20
*** HOLE CARDS ***
Dealt to dimetruk [7d 8d]
Vandbro: folds
vegethnizdo: folds
RedRafflesia: folds
leizima: folds
thimmy11: folds
dclucasPS: folds
berlin1888: calls 20
DeeMarse: calls 10
dimetruk: checks
*** FLOP *** [7c 8s Th]
DeeMarse: bets 20
dimetruk: raises 60 to 80
berlin1888: folds
DeeMarse: calls 60
*** TURN *** [7c 8s Th] [5c]
DeeMarse: checks
dimetruk: bets 165
DeeMarse: calls 165
*** RIVER *** [7c 8s Th 5c] [7h]
DeeMarse: checks
dimetruk: bets 514
DeeMarse: folds
Uncalled bet (514) returned to dimetruk
dimetruk collected 577 from pot
dimetruk: doesn't show hand
*** SUMMARY ***
Total pot 577 | Rake 0
Board [7c 8s Th 5c 7h]
Seat 1: thimmy11 folded before Flop (didn't bet)
Seat 2: dclucasPS folded before Flop (didn't bet)
Seat 3: berlin1888 (button) folded on the Flop
Seat 4: DeeMarse (small blind) folded on the River
Seat 5: dimetruk (big blind) collected (577)
Seat 6: Vandbro folded before Flop (didn't bet)
Seat 7: vegethnizdo folded before Flop (didn't bet)
Seat 8: RedRafflesia folded before Flop (didn't bet)
Seat 9: leizima folded before Flop (didn't bet)


PokerStars Hand #227138969934: Tournament #3203173572, $27.40+$2.60 USD Hold'em No Limit - Level II (15/30) - 2021/05/28 22:05:20 MSK [2021/05/28 15:05:20 ET]
Table '3203173572 1' 9-max Seat #2 is the button
Seat 1: thimmy11 (1280 in chips)
Seat 2: dclucasPS (1484 in chips)
Seat 4: DeeMarse (1045 in chips)
Seat 5: dimetruk (1772 in chips)
Seat 6: Vandbro (2783 in chips)
Seat 7: vegethnizdo (1747 in chips)
Seat 8: RedRafflesia (1872 in chips)
Seat 9: leizima (1517 in chips)
thimmy11: posts the ante 4
dclucasPS: posts the ante 4
DeeMarse: posts the ante 4
dimetruk: posts the ante 4
Vandbro: posts the ante 4
vegethnizdo: posts the ante 4
RedRafflesia: posts the ante 4
leizima: posts the ante 4
DeeMarse: posts small blind 15
dimetruk: posts big blind 30
*** HOLE CARDS ***
Dealt to dimetruk [6h 4c]
Vandbro: folds
vegethnizdo: folds
RedRafflesia: folds
leizima: folds
thimmy11: raises 60 to 90
dclucasPS: folds
DeeMarse: folds
dimetruk: calls 60
*** FLOP *** [Td 3h 9d]
dimetruk: checks
thimmy11: bets 120
dimetruk: folds
Uncalled bet (120) returned to thimmy11
thimmy11 collected 227 from pot
thimmy11: doesn't show hand
*** SUMMARY ***
Total pot 227 | Rake 0
Board [Td 3h 9d]
Seat 1: thimmy11 collected (227)
Seat 2: dclucasPS (button) folded before Flop (didn't bet)
Seat 4: DeeMarse (small blind) folded before Flop
Seat 5: dimetruk (big blind) folded on the Flop
Seat 6: Vandbro folded before Flop (didn't bet)
Seat 7: vegethnizdo folded before Flop (didn't bet)
Seat 8: RedRafflesia folded before Flop (didn't bet)
Seat 9: leizima folded before Flop (didn't bet)


PokerStars Hand #227139029878: Tournament #3203173572, $27.40+$2.60 USD Hold'em No Limit - Level II (15/30) - 2021/05/28 22:07:18 MSK [2021/05/28 15:07:18 ET]
Table '3203173572 1' 9-max Seat #6 is the button
Seat 1: thimmy11 (1345 in chips)
Seat 2: dclucasPS (1472 in chips)
Seat 4: DeeMarse (895 in chips)
Seat 5: dimetruk (1852 in chips)
Seat 6: Vandbro (2726 in chips)
Seat 7: vegethnizdo (1672 in chips)
Seat 8: RedRafflesia (1860 in chips)
Seat 9: leizima (1678 in chips)
thimmy11: posts the ante 4
dclucasPS: posts the ante 4
DeeMarse: posts the ante 4
dimetruk: posts the ante 4
Vandbro: posts the ante 4
vegethnizdo: posts the ante 4
RedRafflesia: posts the ante 4
leizima: posts the ante 4
vegethnizdo: posts small blind 15
RedRafflesia: posts big blind 30
*** HOLE CARDS ***
Dealt to dimetruk [Js Ah]
leizima: folds
thimmy11: folds
dclucasPS: folds
DeeMarse: folds
dimetruk: raises 30 to 60
Vandbro: folds
vegethnizdo: folds
RedRafflesia: calls 30
*** FLOP *** [Kd Ad 6d]
RedRafflesia: checks
dimetruk: bets 58
RedRafflesia: calls 58
*** TURN *** [Kd Ad 6d] [Tc]
RedRafflesia: checks
dimetruk: bets 220
RedRafflesia: calls 220
*** RIVER *** [Kd Ad 6d Tc] [6s]
RedRafflesia: checks
dimetruk: checks
*** SHOW DOWN ***
RedRafflesia: shows [8s Kh] (two pair, Kings and Sixes)
dimetruk: shows [Js Ah] (two pair, Aces and Sixes)
dimetruk collected 723 from pot
*** SUMMARY ***
Total pot 723 | Rake 0
Board [Kd Ad 6d Tc 6s]
Seat 1: thimmy11 folded before Flop (didn't bet)
Seat 2: dclucasPS folded before Flop (didn't bet)
Seat 4: DeeMarse folded before Flop (didn't bet)
Seat 5: dimetruk showed [Js Ah] and won (723) with two pair, Aces and Sixes
Seat 6: Vandbro (button) folded before Flop (didn't bet)
Seat 7: vegethnizdo (small blind) folded before Flop
Seat 8: RedRafflesia (big blind) showed [8s Kh] and lost with two pair, Kings and Sixes
Seat 9: leizima folded before Flop (didn't bet)


PokerStars Hand #227139127556: Tournament #3203173572, $27.40+$2.60 USD Hold'em No Limit - Level II (15/30) - 2021/05/28 22:10:27 MSK [2021/05/28 15:10:27 ET]
Table '3203173572 1' 9-max Seat #2 is the button
Seat 1: thimmy11 (1280 in chips)
Seat 2: dclucasPS (1484 in chips)
Seat 4: DeeMarse (922 in chips)
Seat 5: dimetruk (2217 in chips)
Seat 6: Vandbro (2706 in chips)
Seat 7: vegethnizdo (1562 in chips)
Seat 8: RedRafflesia (1639 in chips)
Seat 9: leizima (1690 in chips)
thimmy11: posts the ante 4
dclucasPS: posts the ante 4
DeeMarse: posts the ante 4
dimetruk: posts the ante 4
Vandbro: posts the ante 4
vegethnizdo: posts the ante 4
RedRafflesia: posts the ante 4
leizima: posts the ante 4
DeeMarse: posts small blind 15
dimetruk: posts big blind 30
*** HOLE CARDS ***
Dealt to dimetruk [5h 8s]
Vandbro: raises 30 to 60
vegethnizdo: folds
RedRafflesia: folds
leizima: folds
thimmy11: folds
dclucasPS: folds
DeeMarse: folds
dimetruk: calls 30
*** FLOP *** [Qd Td 7c]
dimetruk: checks
Vandbro: bets 48
dimetruk: folds
Uncalled bet (48) returned to Vandbro
Vandbro collected 167 from pot
Vandbro: doesn't show hand
*** SUMMARY ***
Total pot 167 | Rake 0
Board [Qd Td 7c]
Seat 1: thimmy11 folded before Flop (didn't bet)
Seat 2: dclucasPS (button) folded before Flop (didn't bet)
Seat 4: DeeMarse (small blind) folded before Flop
Seat 5: dimetruk (big blind) folded on the Flop
Seat 6: Vandbro collected (167)
Seat 7: vegethnizdo folded before Flop (didn't bet)
Seat 8: RedRafflesia folded before Flop (didn't bet)
Seat 9: leizima folded before Flop (didn't bet)


PokerStars Hand #227139395284: Tournament #3203173572, $27.40+$2.60 USD Hold'em No Limit - Level III (25/50) - 2021/05/28 22:19:07 MSK [2021/05/28 15:19:07 ET]
Table '3203173572 1' 9-max Seat #7 is the button
Seat 1: thimmy11 (1488 in chips)
Seat 2: dclucasPS (1289 in chips)
Seat 4: DeeMarse (1421 in chips)
Seat 5: dimetruk (2230 in chips)
Seat 6: Vandbro (3004 in chips)
Seat 7: vegethnizdo (1560 in chips)
Seat 8: RedRafflesia (1484 in chips)
Seat 9: leizima (1024 in chips)
thimmy11: posts the ante 6
dclucasPS: posts the ante 6
DeeMarse: posts the ante 6
dimetruk: posts the ante 6
Vandbro: posts the ante 6
vegethnizdo: posts the ante 6
RedRafflesia: posts the ante 6
leizima: posts the ante 6
RedRafflesia: posts small blind 25
leizima: posts big blind 50
*** HOLE CARDS ***
Dealt to dimetruk [5s As]
thimmy11: folds
dclucasPS: folds
DeeMarse: folds
dimetruk: raises 50 to 100
Vandbro: folds
vegethnizdo: folds
RedRafflesia: folds
leizima: calls 50
*** FLOP *** [5h Js 8c]
leizima: checks
dimetruk: bets 137
leizima: raises 781 to 918 and is all-in
dimetruk: folds
Uncalled bet (781) returned to leizima
leizima collected 547 from pot
leizima: doesn't show hand
*** SUMMARY ***
Total pot 547 | Rake 0
Board [5h Js 8c]
Seat 1: thimmy11 folded before Flop (didn't bet)
Seat 2: dclucasPS folded before Flop (didn't bet)
Seat 4: DeeMarse folded before Flop (didn't bet)
Seat 5: dimetruk folded on the Flop
Seat 6: Vandbro folded before Flop (didn't bet)
Seat 7: vegethnizdo (button) folded before Flop (didn't bet)
Seat 8: RedRafflesia (small blind) folded before Flop
Seat 9: leizima (big blind) collected (547)


PokerStars Hand #227139477950: Tournament #3203173572, $27.40+$2.60 USD Hold'em No Limit - Level III (25/50) - 2021/05/28 22:21:45 MSK [2021/05/28 15:21:45 ET]
Table '3203173572 1' 9-max Seat #1 is the button
Seat 1: thimmy11 (1395 in chips)
Seat 2: dclucasPS (1221 in chips)
Seat 4: DeeMarse (1403 in chips)
Seat 5: dimetruk (1975 in chips)
Seat 6: Vandbro (2986 in chips)
Seat 7: vegethnizdo (1542 in chips)
Seat 8: RedRafflesia (1441 in chips)
Seat 9: leizima (1537 in chips)
thimmy11: posts the ante 6
dclucasPS: posts the ante 6
DeeMarse: posts the ante 6
dimetruk: posts the ante 6
Vandbro: posts the ante 6
vegethnizdo: posts the ante 6
RedRafflesia: posts the ante 6
leizima: posts the ante 6
dclucasPS: posts small blind 25
DeeMarse: posts big blind 50
*** HOLE CARDS ***
Dealt to dimetruk [Ks Kh]
dimetruk: raises 50 to 100
Vandbro: folds
vegethnizdo: folds
RedRafflesia: folds
leizima: folds
thimmy11: folds
dclucasPS: folds
DeeMarse: calls 50
*** FLOP *** [Kd 2c Th]
DeeMarse: checks
dimetruk: bets 96
DeeMarse: calls 96
*** TURN *** [Kd 2c Th] [5c]
DeeMarse: checks
dimetruk: bets 233
DeeMarse: folds
Uncalled bet (233) returned to dimetruk
dimetruk collected 465 from pot
dimetruk: doesn't show hand
*** SUMMARY ***
Total pot 465 | Rake 0
Board [Kd 2c Th 5c]
Seat 1: thimmy11 (button) folded before Flop (didn't bet)
Seat 2: dclucasPS (small blind) folded before Flop
Seat 4: DeeMarse (big blind) folded on the Turn
Seat 5: dimetruk collected (465)
Seat 6: Vandbro folded before Flop (didn't bet)
Seat 7: vegethnizdo folded before Flop (didn't bet)
Seat 8: RedRafflesia folded before Flop (didn't bet)
Seat 9: leizima folded before Flop (didn't bet)


PokerStars Hand #227139507530: Tournament #3203173572, $27.40+$2.60 USD Hold'em No Limit - Level III (25/50) - 2021/05/28 22:22:37 MSK [2021/05/28 15:22:37 ET]
Table '3203173572 1' 9-max Seat #2 is the button
Seat 1: thimmy11 (1389 in chips)
Seat 2: dclucasPS (1190 in chips)
Seat 4: DeeMarse (1201 in chips)
Seat 5: dimetruk (2238 in chips)
Seat 6: Vandbro (2980 in chips)
Seat 7: vegethnizdo (1536 in chips)
Seat 8: RedRafflesia (1435 in chips)
Seat 9: leizima (1531 in chips)
thimmy11: posts the ante 6
dclucasPS: posts the ante 6
DeeMarse: posts the ante 6
dimetruk: posts the ante 6
Vandbro: posts the ante 6
vegethnizdo: posts the ante 6
RedRafflesia: posts the ante 6
leizima: posts the ante 6
DeeMarse: posts small blind 25
dimetruk: posts big blind 50
*** HOLE CARDS ***
Dealt to dimetruk [4c 2d]
Vandbro: folds
vegethnizdo: folds
RedRafflesia: folds
leizima: raises 62 to 112
thimmy11: folds
dclucasPS: folds
DeeMarse: folds
dimetruk: calls 62
*** FLOP *** [6c 2h 3h]
dimetruk: checks
leizima: bets 125
dimetruk: calls 125
*** TURN *** [6c 2h 3h] [Qs]
dimetruk: checks
leizima: bets 230
dimetruk: folds
Uncalled bet (230) returned to leizima
leizima collected 547 from pot
leizima: doesn't show hand
*** SUMMARY ***
Total pot 547 | Rake 0
Board [6c 2h 3h Qs]
Seat 1: thimmy11 folded before Flop (didn't bet)
Seat 2: dclucasPS (button) folded before Flop (didn't bet)
Seat 4: DeeMarse (small blind) folded before Flop
Seat 5: dimetruk (big blind) folded on the Turn
Seat 6: Vandbro folded before Flop (didn't bet)
Seat 7: vegethnizdo folded before Flop (didn't bet)
Seat 8: RedRafflesia folded before Flop (didn't bet)
Seat 9: leizima collected (547)


PokerStars Hand #227140007235: Tournament #3203173572, $27.40+$2.60 USD Hold'em No Limit - Level V (60/120) - 2021/05/28 22:37:32 MSK [2021/05/28 15:37:32 ET]
Table '3203173572 1' 9-max Seat #2 is the button
Seat 1: thimmy11 (2311 in chips)
Seat 2: dclucasPS (2150 in chips)
Seat 4: DeeMarse (1527 in chips)
Seat 5: dimetruk (1766 in chips)
Seat 6: Vandbro (3070 in chips)
Seat 8: RedRafflesia (533 in chips)
Seat 9: leizima (2143 in chips)
thimmy11: posts the ante 15
dclucasPS: posts the ante 15
DeeMarse: posts the ante 15
dimetruk: posts the ante 15
Vandbro: posts the ante 15
RedRafflesia: posts the ante 15
leizima: posts the ante 15
DeeMarse: posts small blind 60
dimetruk: posts big blind 120
*** HOLE CARDS ***
Dealt to dimetruk [Qs 9h]
Vandbro: raises 120 to 240
RedRafflesia: folds
leizima: folds
thimmy11: folds
dclucasPS: folds
DeeMarse: folds
dimetruk: calls 120
*** FLOP *** [7d 8c 8h]
dimetruk: checks
Vandbro: checks
*** TURN *** [7d 8c 8h] [9s]
dimetruk: bets 1511 and is all-in
Vandbro: calls 1511
*** RIVER *** [7d 8c 8h 9s] [Ad]
*** SHOW DOWN ***
dimetruk: shows [Qs 9h] (two pair, Nines and Eights)
Vandbro: shows [7s 7c] (a full house, Sevens full of Eights)
Vandbro collected 3667 from pot
dimetruk finished the tournament in 7th place
*** SUMMARY ***
Total pot 3667 | Rake 0
Board [7d 8c 8h 9s Ad]
Seat 1: thimmy11 folded before Flop (didn't bet)
Seat 2: dclucasPS (button) folded before Flop (didn't bet)
Seat 4: DeeMarse (small blind) folded before Flop
Seat 5: dimetruk (big blind) showed [Qs 9h] and lost with two pair, Nines and Eights
Seat 6: Vandbro showed [7s 7c] and won (3667) with a full house, Sevens full of Eights
Seat 8: RedRafflesia folded before Flop (didn't bet)
Seat 9: leizima folded before Flop (didn't bet)


PokerStars Hand #227140473296: Tournament #3203198779, $27.58+$2.42 USD Hold'em No Limit - Level I (10/20) - 2021/05/28 22:52:02 MSK [2021/05/28 15:52:02 ET]
Table '3203198779 1' 6-max Seat #3 is the button
Seat 1: asuregohon (1494 in chips)
Seat 2: dimetruk (1484 in chips)
Seat 3: AKsEffekt (1464 in chips)
Seat 4: upsnixan (1454 in chips)
Seat 5: Monk Gallas (1962 in chips)
Seat 6: Trespuntos046 (1142 in chips)
asuregohon: posts the ante 3
dimetruk: posts the ante 3
AKsEffekt: posts the ante 3
upsnixan: posts the ante 3
Monk Gallas: posts the ante 3
Trespuntos046: posts the ante 3
upsnixan: posts small blind 10
Monk Gallas: posts big blind 20
*** HOLE CARDS ***
Dealt to dimetruk [Qc Kc]
Trespuntos046: calls 20
asuregohon: folds
dimetruk: raises 50 to 70
AKsEffekt: folds
upsnixan: folds
Monk Gallas: folds
Trespuntos046: calls 50
*** FLOP *** [Ad Kh Qh]
Trespuntos046: checks
dimetruk: bets 94
Trespuntos046: calls 94
*** TURN *** [Ad Kh Qh] [9h]
Trespuntos046: checks
dimetruk: bets 188
Trespuntos046: calls 188
*** RIVER *** [Ad Kh Qh 9h] [Ac]
Trespuntos046: checks
dimetruk: checks
*** SHOW DOWN ***
Trespuntos046: shows [6d Jd] (a pair of Aces)
dimetruk: shows [Qc Kc] (two pair, Aces and Kings)
dimetruk collected 752 from pot
*** SUMMARY ***
Total pot 752 | Rake 0
Board [Ad Kh Qh 9h Ac]
Seat 1: asuregohon folded before Flop (didn't bet)
Seat 2: dimetruk showed [Qc Kc] and won (752) with two pair, Aces and Kings
Seat 3: AKsEffekt (button) folded before Flop (didn't bet)
Seat 4: upsnixan (small blind) folded before Flop
Seat 5: Monk Gallas (big blind) folded before Flop
Seat 6: Trespuntos046 showed [6d Jd] and lost with a pair of Aces


PokerStars Hand #227140541699: Tournament #3203198779, $27.58+$2.42 USD Hold'em No Limit - Level I (10/20) - 2021/05/28 22:54:12 MSK [2021/05/28 15:54:12 ET]
Table '3203198779 1' 6-max Seat #6 is the button
Seat 1: asuregohon (1465 in chips)
Seat 2: dimetruk (1875 in chips)
Seat 3: AKsEffekt (1455 in chips) is sitting out
Seat 4: upsnixan (1541 in chips)
Seat 5: Monk Gallas (1913 in chips)
Seat 6: Trespuntos046 (751 in chips)
asuregohon: posts the ante 3
dimetruk: posts the ante 3
AKsEffekt: posts the ante 3
upsnixan: posts the ante 3
Monk Gallas: posts the ante 3
Trespuntos046: posts the ante 3
asuregohon: posts small blind 10
dimetruk: posts big blind 20
*** HOLE CARDS ***
Dealt to dimetruk [Kd 8c]
AKsEffekt: folds
upsnixan: folds
Monk Gallas: folds
Trespuntos046: calls 20
asuregohon: folds
dimetruk: checks
*** FLOP *** [Ad Ks 2h]
dimetruk: checks
Trespuntos046: checks
*** TURN *** [Ad Ks 2h] [As]
dimetruk: bets 34
Trespuntos046: calls 34
*** RIVER *** [Ad Ks 2h As] [Ah]
dimetruk: bets 91
Trespuntos046: calls 91
*** SHOW DOWN ***
dimetruk: shows [Kd 8c] (a full house, Aces full of Kings)
Trespuntos046: mucks hand
dimetruk collected 318 from pot
*** SUMMARY ***
Total pot 318 | Rake 0
Board [Ad Ks 2h As Ah]
Seat 1: asuregohon (small blind) folded before Flop
Seat 2: dimetruk (big blind) showed [Kd 8c] and won (318) with a full house, Aces full of Kings
Seat 3: AKsEffekt folded before Flop (didn't bet)
Seat 4: upsnixan folded before Flop (didn't bet)
Seat 5: Monk Gallas folded before Flop (didn't bet)
Seat 6: Trespuntos046 (button) mucked [2d Qh]


PokerStars Hand #227140585790: Tournament #3203198779, $27.58+$2.42 USD Hold'em No Limit - Level I (10/20) - 2021/05/28 22:55:46 MSK [2021/05/28 15:55:46 ET]
Table '3203198779 1' 6-max Seat #6 is the button
Seat 1: asuregohon (1417 in chips)
Seat 2: dimetruk (2028 in chips)
Seat 3: AKsEffekt (1407 in chips) is sitting out
Seat 4: upsnixan (1561 in chips)
Seat 5: Monk Gallas (1865 in chips)
Seat 6: Trespuntos046 (722 in chips)
asuregohon: posts the ante 3
dimetruk: posts the ante 3
AKsEffekt: posts the ante 3
upsnixan: posts the ante 3
Monk Gallas: posts the ante 3
Trespuntos046: posts the ante 3
asuregohon: posts small blind 10
dimetruk: posts big blind 20
*** HOLE CARDS ***
Dealt to dimetruk [Ah Jc]
AKsEffekt: folds
upsnixan: calls 20
Monk Gallas: folds
Trespuntos046: calls 20
asuregohon: folds
dimetruk: checks
*** FLOP *** [6s Qh Ts]
dimetruk: checks
upsnixan: checks
Trespuntos046: checks
*** TURN *** [6s Qh Ts] [Kd]
AKsEffekt has returned
dimetruk: bets 59
upsnixan: folds
Trespuntos046: calls 59
*** RIVER *** [6s Qh Ts Kd] [Qs]
dimetruk: bets 138
Trespuntos046: calls 138
*** SHOW DOWN ***
dimetruk: shows [Ah Jc] (a straight, Ten to Ace)
Trespuntos046: mucks hand
dimetruk collected 482 from pot
*** SUMMARY ***
Total pot 482 | Rake 0
Board [6s Qh Ts Kd Qs]
Seat 1: asuregohon (small blind) folded before Flop
Seat 2: dimetruk (big blind) showed [Ah Jc] and won (482) with a straight, Ten to Ace
Seat 3: AKsEffekt folded before Flop (didn't bet)
Seat 4: upsnixan folded on the Turn
Seat 5: Monk Gallas folded before Flop (didn't bet)
Seat 6: Trespuntos046 (button) mucked [8c Kh]


PokerStars Hand #227140645783: Tournament #3203198779, $27.58+$2.42 USD Hold'em No Limit - Level I (10/20) - 2021/05/28 22:58:26 MSK [2021/05/28 15:58:26 ET]
Table '3203198779 1' 6-max Seat #5 is the button
Seat 1: asuregohon (949 in chips)
Seat 2: dimetruk (2268 in chips)
Seat 3: AKsEffekt (1312 in chips)
Seat 4: upsnixan (1544 in chips)
Seat 5: Monk Gallas (1820 in chips)
Seat 6: Trespuntos046 (1107 in chips)
asuregohon: posts the ante 3
dimetruk: posts the ante 3
AKsEffekt: posts the ante 3
upsnixan: posts the ante 3
Monk Gallas: posts the ante 3
Trespuntos046: posts the ante 3
Trespuntos046: posts small blind 10
asuregohon: posts big blind 20
*** HOLE CARDS ***
Dealt to dimetruk [As 8c]
dimetruk: raises 20 to 40
AKsEffekt: folds
upsnixan: folds
Monk Gallas: folds
Trespuntos046: calls 30
asuregohon: calls 20
*** FLOP *** [4s Qs 5s]
Trespuntos046: checks
asuregohon: checks
dimetruk: checks
*** TURN *** [4s Qs 5s] [Ad]
Trespuntos046: bets 69
asuregohon: calls 69
dimetruk: calls 69
*** RIVER *** [4s Qs 5s Ad] [Kh]
Trespuntos046: checks
asuregohon: checks
dimetruk: checks
*** SHOW DOWN ***
Trespuntos046: shows [9d Ac] (a pair of Aces)
asuregohon: mucks hand
dimetruk: mucks hand
Trespuntos046 collected 345 from pot
*** SUMMARY ***
Total pot 345 | Rake 0
Board [4s Qs 5s Ad Kh]
Seat 1: asuregohon (big blind) mucked [3c 4d]
Seat 2: dimetruk mucked [As 8c]
Seat 3: AKsEffekt folded before Flop (didn't bet)
Seat 4: upsnixan folded before Flop (didn't bet)
Seat 5: Monk Gallas (button) folded before Flop (didn't bet)
Seat 6: Trespuntos046 (small blind) showed [9d Ac] and won (345) with a pair of Aces


PokerStars Hand #227140669199: Tournament #3203198779, $27.58+$2.42 USD Hold'em No Limit - Level I (10/20) - 2021/05/28 22:59:27 MSK [2021/05/28 15:59:27 ET]
Table '3203198779 1' 6-max Seat #6 is the button
Seat 1: asuregohon (837 in chips)
Seat 2: dimetruk (2156 in chips)
Seat 3: AKsEffekt (1309 in chips)
Seat 4: upsnixan (1541 in chips)
Seat 5: Monk Gallas (1817 in chips)
Seat 6: Trespuntos046 (1340 in chips)
asuregohon: posts the ante 3
dimetruk: posts the ante 3
AKsEffekt: posts the ante 3
upsnixan: posts the ante 3
Monk Gallas: posts the ante 3
Trespuntos046: posts the ante 3
asuregohon: posts small blind 10
dimetruk: posts big blind 20
*** HOLE CARDS ***
Dealt to dimetruk [Jd 2h]
AKsEffekt: folds
upsnixan: folds
Monk Gallas: folds
Trespuntos046: calls 20
asuregohon: folds
dimetruk: checks
*** FLOP *** [6h Kd Qd]
dimetruk: checks
Trespuntos046: checks
*** TURN *** [6h Kd Qd] [Td]
dimetruk: bets 34
Trespuntos046: raises 68 to 102
dimetruk: calls 68
*** RIVER *** [6h Kd Qd Td] [4c]
dimetruk: checks
Trespuntos046: bets 136
dimetruk: folds
Uncalled bet (136) returned to Trespuntos046
Trespuntos046 collected 272 from pot
Trespuntos046: doesn't show hand
*** SUMMARY ***
Total pot 272 | Rake 0
Board [6h Kd Qd Td 4c]
Seat 1: asuregohon (small blind) folded before Flop
Seat 2: dimetruk (big blind) folded on the River
Seat 3: AKsEffekt folded before Flop (didn't bet)
Seat 4: upsnixan folded before Flop (didn't bet)
Seat 5: Monk Gallas folded before Flop (didn't bet)
Seat 6: Trespuntos046 (button) collected (272)


PokerStars Hand #227140778197: Tournament #3203198779, $27.58+$2.42 USD Hold'em No Limit - Level II (15/30) - 2021/05/28 23:03:16 MSK [2021/05/28 16:03:16 ET]
Table '3203198779 1' 6-max Seat #5 is the button
Seat 1: asuregohon (509 in chips)
Seat 2: dimetruk (2075 in chips)
Seat 3: AKsEffekt (1256 in chips)
Seat 4: upsnixan (1577 in chips)
Seat 5: Monk Gallas (1823 in chips)
Seat 6: Trespuntos046 (1760 in chips) is sitting out
asuregohon: posts the ante 4
dimetruk: posts the ante 4
AKsEffekt: posts the ante 4
upsnixan: posts the ante 4
Monk Gallas: posts the ante 4
Trespuntos046: posts the ante 4
Trespuntos046: posts small blind 15
asuregohon: posts big blind 30
*** HOLE CARDS ***
Dealt to dimetruk [3d Ad]
dimetruk: raises 30 to 60
AKsEffekt: folds
upsnixan: folds
Monk Gallas: folds
Trespuntos046: folds
Trespuntos046 has returned
asuregohon: calls 30
*** FLOP *** [4s Qh Jd]
asuregohon: checks
dimetruk: checks
*** TURN *** [4s Qh Jd] [Js]
asuregohon: checks
dimetruk: bets 80
asuregohon: folds
Uncalled bet (80) returned to dimetruk
dimetruk collected 159 from pot
dimetruk: doesn't show hand
*** SUMMARY ***
Total pot 159 | Rake 0
Board [4s Qh Jd Js]
Seat 1: asuregohon (big blind) folded on the Turn
Seat 2: dimetruk collected (159)
Seat 3: AKsEffekt folded before Flop (didn't bet)
Seat 4: upsnixan folded before Flop (didn't bet)
Seat 5: Monk Gallas (button) folded before Flop (didn't bet)
Seat 6: Trespuntos046 (small blind) folded before Flop


PokerStars Hand #227140793899: Tournament #3203198779, $27.58+$2.42 USD Hold'em No Limit - Level II (15/30) - 2021/05/28 23:03:46 MSK [2021/05/28 16:03:46 ET]
Table '3203198779 1' 6-max Seat #6 is the button
Seat 1: asuregohon (445 in chips)
Seat 2: dimetruk (2170 in chips)
Seat 3: AKsEffekt (1252 in chips)
Seat 4: upsnixan (1573 in chips)
Seat 5: Monk Gallas (1819 in chips)
Seat 6: Trespuntos046 (1741 in chips)
asuregohon: posts the ante 4
dimetruk: posts the ante 4
AKsEffekt: posts the ante 4
upsnixan: posts the ante 4
Monk Gallas: posts the ante 4
Trespuntos046: posts the ante 4
asuregohon: posts small blind 15
dimetruk: posts big blind 30
*** HOLE CARDS ***
Dealt to dimetruk [Qh 2h]
AKsEffekt: folds
upsnixan: folds
Monk Gallas: folds
Trespuntos046: calls 30
asuregohon: folds
dimetruk: checks
*** FLOP *** [6h 8c As]
dimetruk: checks
Trespuntos046: checks
*** TURN *** [6h 8c As] [2c]
dimetruk: bets 45
Trespuntos046: calls 45
*** RIVER *** [6h 8c As 2c] [2d]
dimetruk: bets 168
Trespuntos046: calls 168
*** SHOW DOWN ***
dimetruk: shows [Qh 2h] (three of a kind, Deuces)
Trespuntos046: mucks hand
dimetruk collected 525 from pot
*** SUMMARY ***
Total pot 525 | Rake 0
Board [6h 8c As 2c 2d]
Seat 1: asuregohon (small blind) folded before Flop
Seat 2: dimetruk (big blind) showed [Qh 2h] and won (525) with three of a kind, Deuces
Seat 3: AKsEffekt folded before Flop (didn't bet)
Seat 4: upsnixan folded before Flop (didn't bet)
Seat 5: Monk Gallas folded before Flop (didn't bet)
Seat 6: Trespuntos046 (button) mucked [7d 7s]


PokerStars Hand #227140869740: Tournament #3203198779, $27.58+$2.42 USD Hold'em No Limit - Level II (15/30) - 2021/05/28 23:05:55 MSK [2021/05/28 16:05:55 ET]
Table '3203198779 1' 6-max Seat #4 is the button
Seat 1: asuregohon (582 in chips)
Seat 2: dimetruk (2421 in chips)
Seat 3: AKsEffekt (1191 in chips)
Seat 4: upsnixan (1497 in chips)
Seat 5: Monk Gallas (1887 in chips)
Seat 6: Trespuntos046 (1422 in chips) is sitting out
asuregohon: posts the ante 4
dimetruk: posts the ante 4
AKsEffekt: posts the ante 4
upsnixan: posts the ante 4
Monk Gallas: posts the ante 4
Trespuntos046: posts the ante 4
Monk Gallas: posts small blind 15
Trespuntos046: posts big blind 30
*** HOLE CARDS ***
Dealt to dimetruk [Ks Ac]
Trespuntos046 has returned
asuregohon: folds
dimetruk: raises 30 to 60
AKsEffekt: folds
upsnixan: folds
Monk Gallas: calls 45
Trespuntos046: calls 30
*** FLOP *** [3d Js 9s]
Monk Gallas: checks
Trespuntos046: checks
dimetruk: checks
*** TURN *** [3d Js 9s] [Jd]
Monk Gallas: bets 135
Trespuntos046: folds
dimetruk: calls 135
*** RIVER *** [3d Js 9s Jd] [5s]
Monk Gallas: bets 313
dimetruk: folds
Uncalled bet (313) returned to Monk Gallas
Monk Gallas collected 474 from pot
Monk Gallas: doesn't show hand
*** SUMMARY ***
Total pot 474 | Rake 0
Board [3d Js 9s Jd 5s]
Seat 1: asuregohon folded before Flop (didn't bet)
Seat 2: dimetruk folded on the River
Seat 3: AKsEffekt folded before Flop (didn't bet)
Seat 4: upsnixan (button) folded before Flop (didn't bet)
Seat 5: Monk Gallas (small blind) collected (474)
Seat 6: Trespuntos046 (big blind) folded on the Turn


PokerStars Hand #227140930224: Tournament #3203198779, $27.58+$2.42 USD Hold'em No Limit - Level II (15/30) - 2021/05/28 23:07:40 MSK [2021/05/28 16:07:40 ET]
Table '3203198779 1' 6-max Seat #6 is the button
Seat 1: asuregohon (544 in chips)
Seat 2: dimetruk (2218 in chips)
Seat 3: AKsEffekt (1183 in chips)
Seat 4: upsnixan (1489 in chips)
Seat 5: Monk Gallas (2158 in chips)
Seat 6: Trespuntos046 (1408 in chips)
asuregohon: posts the ante 4
dimetruk: posts the ante 4
AKsEffekt: posts the ante 4
upsnixan: posts the ante 4
Monk Gallas: posts the ante 4
Trespuntos046: posts the ante 4
asuregohon: posts small blind 15
dimetruk: posts big blind 30
*** HOLE CARDS ***
Dealt to dimetruk [3h 3d]
AKsEffekt: folds
upsnixan: folds
Monk Gallas: folds
Trespuntos046: calls 30
asuregohon: folds
dimetruk: checks
*** FLOP *** [6c 8c 3s]
dimetruk: checks
Trespuntos046: checks
*** TURN *** [6c 8c 3s] [7d]
dimetruk: bets 88
Trespuntos046: calls 88
*** RIVER *** [6c 8c 3s 7d] [9d]
dimetruk: bets 138
Trespuntos046: calls 138
*** SHOW DOWN ***
dimetruk: shows [3h 3d] (three of a kind, Threes)
Trespuntos046: mucks hand
dimetruk collected 551 from pot
*** SUMMARY ***
Total pot 551 | Rake 0
Board [6c 8c 3s 7d 9d]
Seat 1: asuregohon (small blind) folded before Flop
Seat 2: dimetruk (big blind) showed [3h 3d] and won (551) with three of a kind, Threes
Seat 3: AKsEffekt folded before Flop (didn't bet)
Seat 4: upsnixan folded before Flop (didn't bet)
Seat 5: Monk Gallas folded before Flop (didn't bet)
Seat 6: Trespuntos046 (button) mucked [9h Kh]


PokerStars Hand #227141127221: Tournament #3203198779, $27.58+$2.42 USD Hold'em No Limit - Level III (25/50) - 2021/05/28 23:13:51 MSK [2021/05/28 16:13:51 ET]
Table '3203198779 1' 6-max Seat #5 is the button
Seat 1: asuregohon (912 in chips)
Seat 2: dimetruk (2380 in chips)
Seat 3: AKsEffekt (1487 in chips)
Seat 4: upsnixan (1217 in chips)
Seat 5: Monk Gallas (1965 in chips)
Seat 6: Trespuntos046 (1039 in chips)
asuregohon: posts the ante 6
dimetruk: posts the ante 6
AKsEffekt: posts the ante 6
upsnixan: posts the ante 6
Monk Gallas: posts the ante 6
Trespuntos046: posts the ante 6
Trespuntos046: posts small blind 25
asuregohon: posts big blind 50
*** HOLE CARDS ***
Dealt to dimetruk [Kd Qh]
dimetruk: raises 50 to 100
AKsEffekt: folds
upsnixan: folds
Monk Gallas: folds
Trespuntos046: folds
asuregohon: calls 50
*** FLOP *** [6c Qc Ts]
asuregohon: checks
dimetruk: bets 131
asuregohon: calls 131
*** TURN *** [6c Qc Ts] [Kh]
asuregohon: checks
dimetruk: bets 2143 and is all-in
asuregohon: folds
Uncalled bet (2143) returned to dimetruk
dimetruk collected 523 from pot
dimetruk: doesn't show hand
*** SUMMARY ***
Total pot 523 | Rake 0
Board [6c Qc Ts Kh]
Seat 1: asuregohon (big blind) folded on the Turn
Seat 2: dimetruk collected (523)
Seat 3: AKsEffekt folded before Flop (didn't bet)
Seat 4: upsnixan folded before Flop (didn't bet)
Seat 5: Monk Gallas (button) folded before Flop (didn't bet)
Seat 6: Trespuntos046 (small blind) folded before Flop


PokerStars Hand #227141140724: Tournament #3203198779, $27.58+$2.42 USD Hold'em No Limit - Level III (25/50) - 2021/05/28 23:14:16 MSK [2021/05/28 16:14:16 ET]
Table '3203198779 1' 6-max Seat #6 is the button
Seat 1: asuregohon (675 in chips)
Seat 2: dimetruk (2666 in chips)
Seat 3: AKsEffekt (1481 in chips)
Seat 4: upsnixan (1211 in chips)
Seat 5: Monk Gallas (1959 in chips)
Seat 6: Trespuntos046 (1008 in chips)
asuregohon: posts the ante 6
dimetruk: posts the ante 6
AKsEffekt: posts the ante 6
upsnixan: posts the ante 6
Monk Gallas: posts the ante 6
Trespuntos046: posts the ante 6
asuregohon: posts small blind 25
dimetruk: posts big blind 50
*** HOLE CARDS ***
Dealt to dimetruk [7d 4c]
AKsEffekt: folds
upsnixan: folds
Monk Gallas: raises 50 to 100
Trespuntos046: calls 100
asuregohon: folds
dimetruk: calls 50
*** FLOP *** [6h 6c 2d]
dimetruk: checks
Monk Gallas: checks
Trespuntos046: checks
*** TURN *** [6h 6c 2d] [7h]
dimetruk: bets 181
Monk Gallas: folds
Trespuntos046: folds
Uncalled bet (181) returned to dimetruk
dimetruk collected 361 from pot
dimetruk: doesn't show hand
*** SUMMARY ***
Total pot 361 | Rake 0
Board [6h 6c 2d 7h]
Seat 1: asuregohon (small blind) folded before Flop
Seat 2: dimetruk (big blind) collected (361)
Seat 3: AKsEffekt folded before Flop (didn't bet)
Seat 4: upsnixan folded before Flop (didn't bet)
Seat 5: Monk Gallas folded on the Turn
Seat 6: Trespuntos046 (button) folded on the Turn


PokerStars Hand #227141243320: Tournament #3203198779, $27.58+$2.42 USD Hold'em No Limit - Level III (25/50) - 2021/05/28 23:17:23 MSK [2021/05/28 16:17:23 ET]
Table '3203198779 1' 6-max Seat #1 is the button
Seat 1: asuregohon (744 in chips)
Seat 2: dimetruk (2816 in chips)
Seat 3: AKsEffekt (1706 in chips)
Seat 4: upsnixan (2161 in chips)
Seat 5: Monk Gallas (1573 in chips)
asuregohon: posts the ante 6
dimetruk: posts the ante 6
AKsEffekt: posts the ante 6
upsnixan: posts the ante 6
Monk Gallas: posts the ante 6
dimetruk: posts small blind 25
AKsEffekt: posts big blind 50
*** HOLE CARDS ***
Dealt to dimetruk [8h 9d]
upsnixan: folds
Monk Gallas: folds
asuregohon: folds
dimetruk: raises 50 to 100
AKsEffekt: calls 50
*** FLOP *** [3c Ac 4c]
dimetruk: checks
AKsEffekt: bets 125
dimetruk: folds
Uncalled bet (125) returned to AKsEffekt
AKsEffekt collected 230 from pot
AKsEffekt: doesn't show hand
*** SUMMARY ***
Total pot 230 | Rake 0
Board [3c Ac 4c]
Seat 1: asuregohon (button) folded before Flop (didn't bet)
Seat 2: dimetruk (small blind) folded on the Flop
Seat 3: AKsEffekt (big blind) collected (230)
Seat 4: upsnixan folded before Flop (didn't bet)
Seat 5: Monk Gallas folded before Flop (didn't bet)


PokerStars Hand #227141323148: Tournament #3203198779, $27.58+$2.42 USD Hold'em No Limit - Level III (25/50) - 2021/05/28 23:19:34 MSK [2021/05/28 16:19:34 ET]
Table '3203198779 1' 6-max Seat #5 is the button
Seat 1: asuregohon (1495 in chips)
Seat 2: dimetruk (2692 in chips)
Seat 3: AKsEffekt (1234 in chips)
Seat 4: upsnixan (2167 in chips)
Seat 5: Monk Gallas (1412 in chips)
asuregohon: posts the ante 6
dimetruk: posts the ante 6
AKsEffekt: posts the ante 6
upsnixan: posts the ante 6
Monk Gallas: posts the ante 6
asuregohon: posts small blind 25
dimetruk: posts big blind 50
*** HOLE CARDS ***
Dealt to dimetruk [9s Qc]
AKsEffekt: raises 62 to 112
upsnixan: folds
Monk Gallas: folds
asuregohon: folds
dimetruk: calls 62
*** FLOP *** [3s Js 6s]
dimetruk: checks
AKsEffekt: checks
*** TURN *** [3s Js 6s] [5d]
dimetruk: bets 248
AKsEffekt: folds
Uncalled bet (248) returned to dimetruk
dimetruk collected 279 from pot
dimetruk: doesn't show hand
*** SUMMARY ***
Total pot 279 | Rake 0
Board [3s Js 6s 5d]
Seat 1: asuregohon (small blind) folded before Flop
Seat 2: dimetruk (big blind) collected (279)
Seat 3: AKsEffekt folded on the Turn
Seat 4: upsnixan folded before Flop (didn't bet)
Seat 5: Monk Gallas (button) folded before Flop (didn't bet)


PokerStars Hand #227141342827: Tournament #3203198779, $27.58+$2.42 USD Hold'em No Limit - Level III (25/50) - 2021/05/28 23:20:09 MSK [2021/05/28 16:20:09 ET]
Table '3203198779 1' 6-max Seat #1 is the button
Seat 1: asuregohon (1464 in chips)
Seat 2: dimetruk (2853 in chips)
Seat 3: AKsEffekt (1116 in chips)
Seat 4: upsnixan (2161 in chips)
Seat 5: Monk Gallas (1406 in chips)
asuregohon: posts the ante 6
dimetruk: posts the ante 6
AKsEffekt: posts the ante 6
upsnixan: posts the ante 6
Monk Gallas: posts the ante 6
dimetruk: posts small blind 25
AKsEffekt: posts big blind 50
*** HOLE CARDS ***
Dealt to dimetruk [Td Tc]
upsnixan: calls 50
Monk Gallas: folds
asuregohon: folds
dimetruk: raises 125 to 175
AKsEffekt: folds
upsnixan: calls 125
*** FLOP *** [3h Jc 2s]
dimetruk: bets 151
upsnixan: calls 151
*** TURN *** [3h Jc 2s] [8h]
dimetruk: bets 366
upsnixan: folds
Uncalled bet (366) returned to dimetruk
dimetruk collected 732 from pot
dimetruk: doesn't show hand
*** SUMMARY ***
Total pot 732 | Rake 0
Board [3h Jc 2s 8h]
Seat 1: asuregohon (button) folded before Flop (didn't bet)
Seat 2: dimetruk (small blind) collected (732)
Seat 3: AKsEffekt (big blind) folded before Flop
Seat 4: upsnixan folded on the Turn
Seat 5: Monk Gallas folded before Flop (didn't bet)


PokerStars Hand #227141508953: Tournament #3203198779, $27.58+$2.42 USD Hold'em No Limit - Level IV (40/80) - 2021/05/28 23:25:07 MSK [2021/05/28 16:25:07 ET]
Table '3203198779 1' 6-max Seat #5 is the button
Seat 1: asuregohon (3205 in chips)
Seat 2: dimetruk (3237 in chips)
Seat 3: AKsEffekt (1229 in chips)
Seat 5: Monk Gallas (1329 in chips)
asuregohon: posts the ante 10
dimetruk: posts the ante 10
AKsEffekt: posts the ante 10
Monk Gallas: posts the ante 10
asuregohon: posts small blind 40
dimetruk: posts big blind 80
*** HOLE CARDS ***
Dealt to dimetruk [Ad 8s]
AKsEffekt: folds
Monk Gallas: folds
asuregohon: raises 120 to 200
dimetruk: calls 120
*** FLOP *** [6c 9d 2d]
asuregohon: bets 200
dimetruk: calls 200
*** TURN *** [6c 9d 2d] [4h]
asuregohon: bets 320
dimetruk: folds
Uncalled bet (320) returned to asuregohon
asuregohon collected 840 from pot
asuregohon: doesn't show hand
*** SUMMARY ***
Total pot 840 | Rake 0
Board [6c 9d 2d 4h]
Seat 1: asuregohon (small blind) collected (840)
Seat 2: dimetruk (big blind) folded on the Turn
Seat 3: AKsEffekt folded before Flop (didn't bet)
Seat 5: Monk Gallas (button) folded before Flop (didn't bet)


PokerStars Hand #227141623977: Tournament #3203198779, $27.58+$2.42 USD Hold'em No Limit - Level IV (40/80) - 2021/05/28 23:28:19 MSK [2021/05/28 16:28:19 ET]
Table '3203198779 1' 6-max Seat #5 is the button
Seat 1: asuregohon (3565 in chips)
Seat 2: dimetruk (2757 in chips)
Seat 3: AKsEffekt (909 in chips)
Seat 5: Monk Gallas (1769 in chips)
asuregohon: posts the ante 10
dimetruk: posts the ante 10
AKsEffekt: posts the ante 10
Monk Gallas: posts the ante 10
asuregohon: posts small blind 40
dimetruk: posts big blind 80
*** HOLE CARDS ***
Dealt to dimetruk [Qd 5d]
AKsEffekt: folds
Monk Gallas: folds
asuregohon: raises 120 to 200
dimetruk: calls 120
*** FLOP *** [4h 6s 9h]
asuregohon: bets 200
dimetruk: folds
Uncalled bet (200) returned to asuregohon
asuregohon collected 440 from pot
asuregohon: doesn't show hand
*** SUMMARY ***
Total pot 440 | Rake 0
Board [4h 6s 9h]
Seat 1: asuregohon (small blind) collected (440)
Seat 2: dimetruk (big blind) folded on the Flop
Seat 3: AKsEffekt folded before Flop (didn't bet)
Seat 5: Monk Gallas (button) folded before Flop (didn't bet)


PokerStars Hand #227141642370: Tournament #3203198779, $27.58+$2.42 USD Hold'em No Limit - Level IV (40/80) - 2021/05/28 23:28:53 MSK [2021/05/28 16:28:53 ET]
Table '3203198779 1' 6-max Seat #2 is the button
Seat 1: asuregohon (3785 in chips)
Seat 2: dimetruk (2497 in chips)
Seat 3: AKsEffekt (969 in chips)
Seat 5: Monk Gallas (1749 in chips)
asuregohon: posts the ante 10
dimetruk: posts the ante 10
AKsEffekt: posts the ante 10
Monk Gallas: posts the ante 10
AKsEffekt: posts small blind 40
Monk Gallas: posts big blind 80
*** HOLE CARDS ***
Dealt to dimetruk [Kh Qs]
asuregohon: folds
dimetruk: raises 80 to 160
AKsEffekt: raises 799 to 959 and is all-in
Monk Gallas: folds
dimetruk: calls 799
*** FLOP *** [6h Jh 9d]
*** TURN *** [6h Jh 9d] [7s]
*** RIVER *** [6h Jh 9d 7s] [Jc]
*** SHOW DOWN ***
AKsEffekt: shows [As Jd] (three of a kind, Jacks)
dimetruk: shows [Kh Qs] (a pair of Jacks)
AKsEffekt collected 2038 from pot
*** SUMMARY ***
Total pot 2038 | Rake 0
Board [6h Jh 9d 7s Jc]
Seat 1: asuregohon folded before Flop (didn't bet)
Seat 2: dimetruk (button) showed [Kh Qs] and lost with a pair of Jacks
Seat 3: AKsEffekt (small blind) showed [As Jd] and won (2038) with three of a kind, Jacks
Seat 5: Monk Gallas (big blind) folded before Flop


PokerStars Hand #227141655117: Tournament #3203198779, $27.58+$2.42 USD Hold'em No Limit - Level IV (40/80) - 2021/05/28 23:29:15 MSK [2021/05/28 16:29:15 ET]
Table '3203198779 1' 6-max Seat #3 is the button
Seat 1: asuregohon (3775 in chips)
Seat 2: dimetruk (1528 in chips)
Seat 3: AKsEffekt (2038 in chips)
Seat 5: Monk Gallas (1659 in chips)
asuregohon: posts the ante 10
dimetruk: posts the ante 10
AKsEffekt: posts the ante 10
Monk Gallas: posts the ante 10
Monk Gallas: posts small blind 40
asuregohon: posts big blind 80
*** HOLE CARDS ***
Dealt to dimetruk [Qh Kh]
dimetruk: raises 80 to 160
AKsEffekt: raises 1868 to 2028 and is all-in
Monk Gallas: folds
asuregohon: folds
dimetruk: calls 1358 and is all-in
Uncalled bet (510) returned to AKsEffekt
*** FLOP *** [Tc 5s 8h]
*** TURN *** [Tc 5s 8h] [4h]
*** RIVER *** [Tc 5s 8h 4h] [6c]
*** SHOW DOWN ***
dimetruk: shows [Qh Kh] (high card King)
AKsEffekt: shows [Ad Qc] (high card Ace)
AKsEffekt collected 3196 from pot
dimetruk finished the tournament in 4th place
*** SUMMARY ***
Total pot 3196 | Rake 0
Board [Tc 5s 8h 4h 6c]
Seat 1: asuregohon (big blind) folded before Flop
Seat 2: dimetruk showed [Qh Kh] and lost with high card King
Seat 3: AKsEffekt (button) showed [Ad Qc] and won (3196) with high card Ace
Seat 5: Monk Gallas (small blind) folded before Flop


PokerStars Hand #227140452234: Tournament #3203221938, $27.40+$2.60 USD Hold'em No Limit - Level I (10/20) - 2021/05/28 22:51:22 MSK [2021/05/28 15:51:22 ET]
Table '3203221938 1' 9-max Seat #1 is the button
Seat 1: Ukman2021 (1673 in chips)
Seat 2: AKsEffekt (1660 in chips)
Seat 3: RaulG777 (1443 in chips)
Seat 4: JourneyWell (1160 in chips)
Seat 5: dimetruk (1403 in chips)
Seat 6: berlin1888 (1133 in chips)
Seat 7: Maus219 (2045 in chips)
Seat 8: afalefex (1433 in chips)
Seat 9: Kawartha1427 (1550 in chips)
Ukman2021: posts the ante 3
AKsEffekt: posts the ante 3
RaulG777: posts the ante 3
JourneyWell: posts the ante 3
dimetruk: posts the ante 3
berlin1888: posts the ante 3
Maus219: posts the ante 3
afalefex: posts the ante 3
Kawartha1427: posts the ante 3
AKsEffekt: posts small blind 10
RaulG777: posts big blind 20
*** HOLE CARDS ***
Dealt to dimetruk [Ac Th]
JourneyWell: folds
dimetruk: raises 20 to 40
berlin1888: calls 40
Maus219: folds
afalefex: folds
Kawartha1427: folds
Ukman2021: calls 40
AKsEffekt: folds
RaulG777: calls 20
*** FLOP *** [4h Jc Qh]
RaulG777: checks
dimetruk: checks
berlin1888: bets 20
Ukman2021: calls 20
RaulG777: folds
dimetruk: calls 20
*** TURN *** [4h Jc Qh] [Ah]
dimetruk: checks
berlin1888: bets 80
Ukman2021: folds
dimetruk: calls 80
*** RIVER *** [4h Jc Qh Ah] [3s]
dimetruk: checks
berlin1888: bets 100
dimetruk: calls 100
*** SHOW DOWN ***
berlin1888: shows [As 4c] (two pair, Aces and Fours)
dimetruk: mucks hand
berlin1888 collected 617 from pot
*** SUMMARY ***
Total pot 617 | Rake 0
Board [4h Jc Qh Ah 3s]
Seat 1: Ukman2021 (button) folded on the Turn
Seat 2: AKsEffekt (small blind) folded before Flop
Seat 3: RaulG777 (big blind) folded on the Flop
Seat 4: JourneyWell folded before Flop (didn't bet)
Seat 5: dimetruk mucked [Ac Th]
Seat 6: berlin1888 showed [As 4c] and won (617) with two pair, Aces and Fours
Seat 7: Maus219 folded before Flop (didn't bet)
Seat 8: afalefex folded before Flop (didn't bet)
Seat 9: Kawartha1427 folded before Flop (didn't bet)


PokerStars Hand #227140554944: Tournament #3203221938, $27.40+$2.60 USD Hold'em No Limit - Level II (15/30) - 2021/05/28 22:54:38 MSK [2021/05/28 15:54:38 ET]
Table '3203221938 1' 9-max Seat #3 is the button
Seat 1: Ukman2021 (1507 in chips)
Seat 2: AKsEffekt (1644 in chips) is sitting out
Seat 3: RaulG777 (1544 in chips)
Seat 4: JourneyWell (1134 in chips)
Seat 5: dimetruk (1157 in chips)
Seat 6: berlin1888 (1504 in chips)
Seat 7: Maus219 (2039 in chips)
Seat 8: afalefex (1427 in chips)
Seat 9: Kawartha1427 (1544 in chips)
Ukman2021: posts the ante 4
AKsEffekt: posts the ante 4
RaulG777: posts the ante 4
JourneyWell: posts the ante 4
dimetruk: posts the ante 4
berlin1888: posts the ante 4
Maus219: posts the ante 4
afalefex: posts the ante 4
Kawartha1427: posts the ante 4
JourneyWell: posts small blind 15
dimetruk: posts big blind 30
*** HOLE CARDS ***
Dealt to dimetruk [As 8s]
berlin1888: folds
Maus219: folds
afalefex: folds
Kawartha1427: folds
Ukman2021: calls 30
AKsEffekt: folds
RaulG777: folds
JourneyWell: raises 60 to 90
dimetruk: calls 60
Ukman2021: calls 60
*** FLOP *** [Tc Ac 4s]
JourneyWell: checks
dimetruk: bets 107
Ukman2021: folds
JourneyWell: calls 107
*** TURN *** [Tc Ac 4s] [7d]
JourneyWell: checks
dimetruk: bets 182
JourneyWell: folds
Uncalled bet (182) returned to dimetruk
dimetruk collected 520 from pot
dimetruk: doesn't show hand
*** SUMMARY ***
Total pot 520 | Rake 0
Board [Tc Ac 4s 7d]
Seat 1: Ukman2021 folded on the Flop
Seat 2: AKsEffekt folded before Flop (didn't bet)
Seat 3: RaulG777 (button) folded before Flop (didn't bet)
Seat 4: JourneyWell (small blind) folded on the Turn
Seat 5: dimetruk (big blind) collected (520)
Seat 6: berlin1888 folded before Flop (didn't bet)
Seat 7: Maus219 folded before Flop (didn't bet)
Seat 8: afalefex folded before Flop (didn't bet)
Seat 9: Kawartha1427 folded before Flop (didn't bet)


PokerStars Hand #227140613359: Tournament #3203221938, $27.40+$2.60 USD Hold'em No Limit - Level II (15/30) - 2021/05/28 22:57:00 MSK [2021/05/28 15:57:00 ET]
Table '3203221938 1' 9-max Seat #6 is the button
Seat 1: Ukman2021 (1375 in chips)
Seat 2: AKsEffekt (1632 in chips)
Seat 3: RaulG777 (1532 in chips)
Seat 4: JourneyWell (925 in chips)
Seat 5: dimetruk (1453 in chips)
Seat 6: berlin1888 (1447 in chips)
Seat 7: Maus219 (2380 in chips)
Seat 8: afalefex (1415 in chips)
Seat 9: Kawartha1427 (1341 in chips)
Ukman2021: posts the ante 4
AKsEffekt: posts the ante 4
RaulG777: posts the ante 4
JourneyWell: posts the ante 4
dimetruk: posts the ante 4
berlin1888: posts the ante 4
Maus219: posts the ante 4
afalefex: posts the ante 4
Kawartha1427: posts the ante 4
Maus219: posts small blind 15
afalefex: posts big blind 30
*** HOLE CARDS ***
Dealt to dimetruk [Qc Jc]
Kawartha1427: folds
Ukman2021: calls 30
AKsEffekt: folds
RaulG777: folds
JourneyWell: folds
dimetruk: raises 75 to 105
berlin1888: calls 105
Maus219: folds
afalefex: folds
Ukman2021: calls 75
*** FLOP *** [5h Ad Tc]
Ukman2021: checks
dimetruk: bets 139
berlin1888: folds
Ukman2021: folds
Uncalled bet (139) returned to dimetruk
dimetruk collected 396 from pot
dimetruk: doesn't show hand
*** SUMMARY ***
Total pot 396 | Rake 0
Board [5h Ad Tc]
Seat 1: Ukman2021 folded on the Flop
Seat 2: AKsEffekt folded before Flop (didn't bet)
Seat 3: RaulG777 folded before Flop (didn't bet)
Seat 4: JourneyWell folded before Flop (didn't bet)
Seat 5: dimetruk collected (396)
Seat 6: berlin1888 (button) folded on the Flop
Seat 7: Maus219 (small blind) folded before Flop
Seat 8: afalefex (big blind) folded before Flop
Seat 9: Kawartha1427 folded before Flop (didn't bet)


PokerStars Hand #227140654599: Tournament #3203221938, $27.40+$2.60 USD Hold'em No Limit - Level II (15/30) - 2021/05/28 22:58:48 MSK [2021/05/28 15:58:48 ET]
Table '3203221938 1' 9-max Seat #8 is the button
Seat 1: Ukman2021 (1115 in chips)
Seat 2: AKsEffekt (1624 in chips)
Seat 3: RaulG777 (1524 in chips)
Seat 4: JourneyWell (917 in chips)
Seat 5: dimetruk (1736 in chips)
Seat 6: berlin1888 (1097 in chips)
Seat 7: Maus219 (2822 in chips)
Seat 8: afalefex (1362 in chips)
Seat 9: Kawartha1427 (1303 in chips)
Ukman2021: posts the ante 4
AKsEffekt: posts the ante 4
RaulG777: posts the ante 4
JourneyWell: posts the ante 4
dimetruk: posts the ante 4
berlin1888: posts the ante 4
Maus219: posts the ante 4
afalefex: posts the ante 4
Kawartha1427: posts the ante 4
Kawartha1427: posts small blind 15
Ukman2021: posts big blind 30
*** HOLE CARDS ***
Dealt to dimetruk [Jc Js]
AKsEffekt: folds
RaulG777: folds
JourneyWell: calls 30
dimetruk: raises 75 to 105
berlin1888: folds
Maus219: calls 105
afalefex: folds
Kawartha1427: folds
Ukman2021: folds
JourneyWell: calls 75
*** FLOP *** [7h 4c Ah]
JourneyWell: checks
dimetruk: bets 139
Maus219: folds
JourneyWell: folds
Uncalled bet (139) returned to dimetruk
dimetruk collected 396 from pot
dimetruk: doesn't show hand
*** SUMMARY ***
Total pot 396 | Rake 0
Board [7h 4c Ah]
Seat 1: Ukman2021 (big blind) folded before Flop
Seat 2: AKsEffekt folded before Flop (didn't bet)
Seat 3: RaulG777 folded before Flop (didn't bet)
Seat 4: JourneyWell folded on the Flop
Seat 5: dimetruk collected (396)
Seat 6: berlin1888 folded before Flop (didn't bet)
Seat 7: Maus219 folded on the Flop
Seat 8: afalefex (button) folded before Flop (didn't bet)
Seat 9: Kawartha1427 (small blind) folded before Flop


PokerStars Hand #227140703977: Tournament #3203221938, $27.40+$2.60 USD Hold'em No Limit - Level II (15/30) - 2021/05/28 23:00:51 MSK [2021/05/28 16:00:51 ET]
Table '3203221938 1' 9-max Seat #1 is the button
Seat 1: Ukman2021 (1047 in chips)
Seat 2: AKsEffekt (2102 in chips)
Seat 3: RaulG777 (1516 in chips)
Seat 4: JourneyWell (804 in chips)
Seat 5: dimetruk (2019 in chips)
Seat 6: berlin1888 (669 in chips)
Seat 7: Maus219 (2709 in chips)
Seat 8: afalefex (1354 in chips)
Seat 9: Kawartha1427 (1280 in chips)
Ukman2021: posts the ante 4
AKsEffekt: posts the ante 4
RaulG777: posts the ante 4
JourneyWell: posts the ante 4
dimetruk: posts the ante 4
berlin1888: posts the ante 4
Maus219: posts the ante 4
afalefex: posts the ante 4
Kawartha1427: posts the ante 4
AKsEffekt: posts small blind 15
RaulG777: posts big blind 30
*** HOLE CARDS ***
Dealt to dimetruk [Qh Jh]
JourneyWell: folds
dimetruk: raises 30 to 60
berlin1888: folds
Maus219: folds
afalefex: folds
Kawartha1427: folds
Ukman2021: calls 60
AKsEffekt: folds
RaulG777: calls 30
*** FLOP *** [Ac Td 9d]
RaulG777: checks
dimetruk: bets 116
Ukman2021: calls 116
RaulG777: calls 116
*** TURN *** [Ac Td 9d] [Kc]
RaulG777: checks
dimetruk: bets 1839 and is all-in
Ukman2021: folds
RaulG777: folds
Uncalled bet (1839) returned to dimetruk
dimetruk collected 579 from pot
dimetruk: doesn't show hand
*** SUMMARY ***
Total pot 579 | Rake 0
Board [Ac Td 9d Kc]
Seat 1: Ukman2021 (button) folded on the Turn
Seat 2: AKsEffekt (small blind) folded before Flop
Seat 3: RaulG777 (big blind) folded on the Turn
Seat 4: JourneyWell folded before Flop (didn't bet)
Seat 5: dimetruk collected (579)
Seat 6: berlin1888 folded before Flop (didn't bet)
Seat 7: Maus219 folded before Flop (didn't bet)
Seat 8: afalefex folded before Flop (didn't bet)
Seat 9: Kawartha1427 folded before Flop (didn't bet)


PokerStars Hand #227140775418: Tournament #3203221938, $27.40+$2.60 USD Hold'em No Limit - Level II (15/30) - 2021/05/28 23:03:11 MSK [2021/05/28 16:03:11 ET]
Table '3203221938 1' 9-max Seat #3 is the button
Seat 1: Ukman2021 (1424 in chips)
Seat 2: AKsEffekt (2079 in chips)
Seat 3: RaulG777 (1317 in chips)
Seat 4: JourneyWell (736 in chips)
Seat 5: dimetruk (2414 in chips)
Seat 6: berlin1888 (211 in chips)
Seat 7: Maus219 (2701 in chips)
Seat 8: afalefex (1346 in chips)
Seat 9: Kawartha1427 (1272 in chips)
Ukman2021: posts the ante 4
AKsEffekt: posts the ante 4
RaulG777: posts the ante 4
JourneyWell: posts the ante 4
dimetruk: posts the ante 4
berlin1888: posts the ante 4
Maus219: posts the ante 4
afalefex: posts the ante 4
Kawartha1427: posts the ante 4
JourneyWell: posts small blind 15
dimetruk: posts big blind 30
*** HOLE CARDS ***
Dealt to dimetruk [5c 5h]
berlin1888: folds
Maus219: folds
afalefex: folds
Kawartha1427: folds
Ukman2021: calls 30
AKsEffekt: folds
RaulG777: folds
JourneyWell: calls 15
dimetruk: checks
*** FLOP *** [2d Kh 4s]
JourneyWell: checks
dimetruk: checks
Ukman2021: checks
*** TURN *** [2d Kh 4s] [6h]
JourneyWell: bets 126
dimetruk: folds
Ukman2021: folds
Uncalled bet (126) returned to JourneyWell
JourneyWell collected 126 from pot
*** SUMMARY ***
Total pot 126 | Rake 0
Board [2d Kh 4s 6h]
Seat 1: Ukman2021 folded on the Turn
Seat 2: AKsEffekt folded before Flop (didn't bet)
Seat 3: RaulG777 (button) folded before Flop (didn't bet)
Seat 4: JourneyWell (small blind) collected (126)
Seat 5: dimetruk (big blind) folded on the Turn
Seat 6: berlin1888 folded before Flop (didn't bet)
Seat 7: Maus219 folded before Flop (didn't bet)
Seat 8: afalefex folded before Flop (didn't bet)
Seat 9: Kawartha1427 folded before Flop (didn't bet)


PokerStars Hand #227140897683: Tournament #3203221938, $27.40+$2.60 USD Hold'em No Limit - Level III (25/50) - 2021/05/28 23:06:47 MSK [2021/05/28 16:06:47 ET]
Table '3203221938 1' 9-max Seat #8 is the button
Seat 1: Ukman2021 (2349 in chips)
Seat 2: AKsEffekt (1907 in chips)
Seat 3: RaulG777 (1295 in chips)
Seat 4: JourneyWell (810 in chips)
Seat 5: dimetruk (2337 in chips)
Seat 7: Maus219 (2579 in chips)
Seat 8: afalefex (1274 in chips)
Seat 9: Kawartha1427 (949 in chips)
Ukman2021: posts the ante 6
AKsEffekt: posts the ante 6
RaulG777: posts the ante 6
JourneyWell: posts the ante 6
dimetruk: posts the ante 6
Maus219: posts the ante 6
afalefex: posts the ante 6
Kawartha1427: posts the ante 6
Kawartha1427: posts small blind 25
Ukman2021: posts big blind 50
*** HOLE CARDS ***
Dealt to dimetruk [As 4d]
AKsEffekt: folds
RaulG777: folds
JourneyWell: folds
dimetruk: raises 50 to 100
Maus219: folds
afalefex: folds
Kawartha1427: folds
Ukman2021: calls 50
*** FLOP *** [8d Kh Ac]
Ukman2021: checks
dimetruk: bets 96
Ukman2021: folds
Uncalled bet (96) returned to dimetruk
dimetruk collected 273 from pot
dimetruk: doesn't show hand
*** SUMMARY ***
Total pot 273 | Rake 0
Board [8d Kh Ac]
Seat 1: Ukman2021 (big blind) folded on the Flop
Seat 2: AKsEffekt folded before Flop (didn't bet)
Seat 3: RaulG777 folded before Flop (didn't bet)
Seat 4: JourneyWell folded before Flop (didn't bet)
Seat 5: dimetruk collected (273)
Seat 7: Maus219 folded before Flop (didn't bet)
Seat 8: afalefex (button) folded before Flop (didn't bet)
Seat 9: Kawartha1427 (small blind) folded before Flop


PokerStars Hand #227140987460: Tournament #3203221938, $27.40+$2.60 USD Hold'em No Limit - Level III (25/50) - 2021/05/28 23:09:28 MSK [2021/05/28 16:09:28 ET]
Table '3203221938 1' 9-max Seat #2 is the button
Seat 1: Ukman2021 (1931 in chips)
Seat 2: AKsEffekt (1962 in chips)
Seat 3: RaulG777 (1227 in chips)
Seat 4: JourneyWell (1165 in chips)
Seat 5: dimetruk (2492 in chips)
Seat 7: Maus219 (2561 in chips)
Seat 8: afalefex (1256 in chips)
Seat 9: Kawartha1427 (906 in chips)
Ukman2021: posts the ante 6
AKsEffekt: posts the ante 6
RaulG777: posts the ante 6
JourneyWell: posts the ante 6
dimetruk: posts the ante 6
Maus219: posts the ante 6
afalefex: posts the ante 6
Kawartha1427: posts the ante 6
RaulG777: posts small blind 25
JourneyWell: posts big blind 50
*** HOLE CARDS ***
Dealt to dimetruk [As Qc]
dimetruk: raises 50 to 100
Maus219: folds
afalefex: folds
Kawartha1427: calls 100
Ukman2021: folds
AKsEffekt: folds
RaulG777: folds
JourneyWell: folds
*** FLOP *** [Qd Jh 8c]
dimetruk: bets 287
Kawartha1427: raises 513 to 800 and is all-in
dimetruk: calls 513
*** TURN *** [Qd Jh 8c] [8s]
*** RIVER *** [Qd Jh 8c 8s] [Ad]
*** SHOW DOWN ***
dimetruk: shows [As Qc] (two pair, Aces and Queens)
Kawartha1427: shows [4s Ks] (a pair of Eights)
dimetruk collected 1923 from pot
Kawartha1427 finished the tournament in 8th place
*** SUMMARY ***
Total pot 1923 | Rake 0
Board [Qd Jh 8c 8s Ad]
Seat 1: Ukman2021 folded before Flop (didn't bet)
Seat 2: AKsEffekt (button) folded before Flop (didn't bet)
Seat 3: RaulG777 (small blind) folded before Flop
Seat 4: JourneyWell (big blind) folded before Flop
Seat 5: dimetruk showed [As Qc] and won (1923) with two pair, Aces and Queens
Seat 7: Maus219 folded before Flop (didn't bet)
Seat 8: afalefex folded before Flop (didn't bet)
Seat 9: Kawartha1427 showed [4s Ks] and lost with a pair of Eights


PokerStars Hand #227141040760: Tournament #3203221938, $27.40+$2.60 USD Hold'em No Limit - Level III (25/50) - 2021/05/28 23:11:08 MSK [2021/05/28 16:11:08 ET]
Table '3203221938 1' 9-max Seat #5 is the button
Seat 1: Ukman2021 (1863 in chips)
Seat 2: AKsEffekt (2061 in chips)
Seat 3: RaulG777 (1184 in chips)
Seat 4: JourneyWell (1239 in chips)
Seat 5: dimetruk (3422 in chips)
Seat 7: Maus219 (2493 in chips)
Seat 8: afalefex (1238 in chips)
Ukman2021: posts the ante 6
AKsEffekt: posts the ante 6
RaulG777: posts the ante 6
JourneyWell: posts the ante 6
dimetruk: posts the ante 6
Maus219: posts the ante 6
afalefex: posts the ante 6
Maus219: posts small blind 25
afalefex: posts big blind 50
*** HOLE CARDS ***
Dealt to dimetruk [8h 4h]
Ukman2021: folds
AKsEffekt: folds
RaulG777: folds
JourneyWell: folds
dimetruk: raises 50 to 100
Maus219: folds
afalefex: calls 50
*** FLOP *** [Qh Ah Jh]
afalefex: checks
dimetruk: bets 134
afalefex: folds
Uncalled bet (134) returned to dimetruk
dimetruk collected 267 from pot
dimetruk: doesn't show hand
*** SUMMARY ***
Total pot 267 | Rake 0
Board [Qh Ah Jh]
Seat 1: Ukman2021 folded before Flop (didn't bet)
Seat 2: AKsEffekt folded before Flop (didn't bet)
Seat 3: RaulG777 folded before Flop (didn't bet)
Seat 4: JourneyWell folded before Flop (didn't bet)
Seat 5: dimetruk (button) collected (267)
Seat 7: Maus219 (small blind) folded before Flop
Seat 8: afalefex (big blind) folded on the Flop


PokerStars Hand #227141057993: Tournament #3203221938, $27.40+$2.60 USD Hold'em No Limit - Level III (25/50) - 2021/05/28 23:11:41 MSK [2021/05/28 16:11:41 ET]
Table '3203221938 1' 9-max Seat #7 is the button
Seat 1: Ukman2021 (1857 in chips)
Seat 2: AKsEffekt (2055 in chips)
Seat 3: RaulG777 (1178 in chips)
Seat 4: JourneyWell (1233 in chips)
Seat 5: dimetruk (3583 in chips)
Seat 7: Maus219 (2462 in chips)
Seat 8: afalefex (1132 in chips)
Ukman2021: posts the ante 6
AKsEffekt: posts the ante 6
RaulG777: posts the ante 6
JourneyWell: posts the ante 6
dimetruk: posts the ante 6
Maus219: posts the ante 6
afalefex: posts the ante 6
afalefex: posts small blind 25
Ukman2021: posts big blind 50
*** HOLE CARDS ***
Dealt to dimetruk [Kh 9d]
AKsEffekt: folds
RaulG777: folds
JourneyWell: folds
dimetruk: raises 50 to 100
Maus219: folds
afalefex: folds
Ukman2021: calls 50
*** FLOP *** [8d Kd 2h]
Ukman2021: checks
dimetruk: bets 134
Ukman2021: folds
Uncalled bet (134) returned to dimetruk
dimetruk collected 267 from pot
dimetruk: doesn't show hand
*** SUMMARY ***
Total pot 267 | Rake 0
Board [8d Kd 2h]
Seat 1: Ukman2021 (big blind) folded on the Flop
Seat 2: AKsEffekt folded before Flop (didn't bet)
Seat 3: RaulG777 folded before Flop (didn't bet)
Seat 4: JourneyWell folded before Flop (didn't bet)
Seat 5: dimetruk collected (267)
Seat 7: Maus219 (button) folded before Flop (didn't bet)
Seat 8: afalefex (small blind) folded before Flop


PokerStars Hand #227141259305: Tournament #3203221938, $27.40+$2.60 USD Hold'em No Limit - Level IV (40/80) - 2021/05/28 23:17:51 MSK [2021/05/28 16:17:51 ET]
Table '3203221938 1' 9-max Seat #3 is the button
Seat 1: Ukman2021 (756 in chips)
Seat 2: AKsEffekt (2354 in chips)
Seat 3: RaulG777 (1480 in chips)
Seat 4: JourneyWell (1585 in chips)
Seat 5: dimetruk (3692 in chips)
Seat 7: Maus219 (2554 in chips)
Seat 8: afalefex (1079 in chips)
Ukman2021: posts the ante 10
AKsEffekt: posts the ante 10
RaulG777: posts the ante 10
JourneyWell: posts the ante 10
dimetruk: posts the ante 10
Maus219: posts the ante 10
afalefex: posts the ante 10
JourneyWell: posts small blind 40
dimetruk: posts big blind 80
*** HOLE CARDS ***
Dealt to dimetruk [Td 7s]
Maus219: folds
afalefex: folds
Ukman2021: calls 80
AKsEffekt: folds
RaulG777: folds
JourneyWell: calls 40
dimetruk: checks
*** FLOP *** [9s 7c 4s]
JourneyWell: checks
dimetruk: checks
Ukman2021: checks
*** TURN *** [9s 7c 4s] [Qs]
JourneyWell: bets 155
dimetruk: calls 155
Ukman2021: folds
*** RIVER *** [9s 7c 4s Qs] [7d]
JourneyWell: bets 310
dimetruk: calls 310
*** SHOW DOWN ***
JourneyWell: shows [Qd 4d] (two pair, Queens and Sevens)
dimetruk: shows [Td 7s] (three of a kind, Sevens)
dimetruk collected 1240 from pot
*** SUMMARY ***
Total pot 1240 | Rake 0
Board [9s 7c 4s Qs 7d]
Seat 1: Ukman2021 folded on the Turn
Seat 2: AKsEffekt folded before Flop (didn't bet)
Seat 3: RaulG777 (button) folded before Flop (didn't bet)
Seat 4: JourneyWell (small blind) showed [Qd 4d] and lost with two pair, Queens and Sevens
Seat 5: dimetruk (big blind) showed [Td 7s] and won (1240) with three of a kind, Sevens
Seat 7: Maus219 folded before Flop (didn't bet)
Seat 8: afalefex folded before Flop (didn't bet)


PokerStars Hand #227141587295: Tournament #3203221938, $27.40+$2.60 USD Hold'em No Limit - Level V (60/120) - 2021/05/28 23:27:13 MSK [2021/05/28 16:27:13 ET]
Table '3203221938 1' 9-max Seat #8 is the button
Seat 4: JourneyWell (2005 in chips)
Seat 5: dimetruk (3832 in chips)
Seat 7: Maus219 (6300 in chips)
Seat 8: afalefex (1363 in chips)
JourneyWell: posts the ante 15
dimetruk: posts the ante 15
Maus219: posts the ante 15
afalefex: posts the ante 15
JourneyWell: posts small blind 60
dimetruk: posts big blind 120
*** HOLE CARDS ***
Dealt to dimetruk [Ts 9s]
Maus219: raises 126 to 246
afalefex: folds
JourneyWell: folds
dimetruk: calls 126
*** FLOP *** [9d 6d 8c]
dimetruk: checks
Maus219: bets 404
dimetruk: calls 404
*** TURN *** [9d 6d 8c] [Ah]
dimetruk: checks
Maus219: bets 994
dimetruk: folds
Uncalled bet (994) returned to Maus219
Maus219 collected 1420 from pot
Maus219: doesn't show hand
*** SUMMARY ***
Total pot 1420 | Rake 0
Board [9d 6d 8c Ah]
Seat 4: JourneyWell (small blind) folded before Flop
Seat 5: dimetruk (big blind) folded on the Turn
Seat 7: Maus219 collected (1420)
Seat 8: afalefex (button) folded before Flop (didn't bet)


PokerStars Hand #227141658085: Tournament #3203221938, $27.40+$2.60 USD Hold'em No Limit - Level V (60/120) - 2021/05/28 23:29:21 MSK [2021/05/28 16:29:21 ET]
Table '3203221938 1' 9-max Seat #8 is the button
Seat 4: JourneyWell (2005 in chips)
Seat 5: dimetruk (2822 in chips)
Seat 7: Maus219 (7550 in chips)
Seat 8: afalefex (1123 in chips)
JourneyWell: posts the ante 15
dimetruk: posts the ante 15
Maus219: posts the ante 15
afalefex: posts the ante 15
JourneyWell: posts small blind 60
dimetruk: posts big blind 120
*** HOLE CARDS ***
Dealt to dimetruk [Kc Ah]
Maus219: raises 120 to 240
afalefex: folds
JourneyWell: folds
dimetruk: calls 120
*** FLOP *** [7s 4d 6c]
dimetruk: checks
Maus219: bets 270
dimetruk: folds
Uncalled bet (270) returned to Maus219
Maus219 collected 600 from pot
Maus219: doesn't show hand
*** SUMMARY ***
Total pot 600 | Rake 0
Board [7s 4d 6c]
Seat 4: JourneyWell (small blind) folded before Flop
Seat 5: dimetruk (big blind) folded on the Flop
Seat 7: Maus219 collected (600)
Seat 8: afalefex (button) folded before Flop (didn't bet)


PokerStars Hand #227141695313: Tournament #3203221938, $27.40+$2.60 USD Hold'em No Limit - Level V (60/120) - 2021/05/28 23:30:28 MSK [2021/05/28 16:30:28 ET]
Table '3203221938 1' 9-max Seat #8 is the button
Seat 4: JourneyWell (1765 in chips)
Seat 5: dimetruk (2462 in chips)
Seat 7: Maus219 (8270 in chips)
Seat 8: afalefex (1003 in chips)
JourneyWell: posts the ante 15
dimetruk: posts the ante 15
Maus219: posts the ante 15
afalefex: posts the ante 15
JourneyWell: posts small blind 60
dimetruk: posts big blind 120
*** HOLE CARDS ***
Dealt to dimetruk [7d 5h]
Maus219: folds
afalefex: folds
JourneyWell: calls 60
dimetruk: checks
*** FLOP *** [9d Kd Ts]
JourneyWell: bets 120
dimetruk: folds
Uncalled bet (120) returned to JourneyWell
JourneyWell collected 300 from pot
*** SUMMARY ***
Total pot 300 | Rake 0
Board [9d Kd Ts]
Seat 4: JourneyWell (small blind) collected (300)
Seat 5: dimetruk (big blind) folded on the Flop
Seat 7: Maus219 folded before Flop (didn't bet)
Seat 8: afalefex (button) folded before Flop (didn't bet)


PokerStars Hand #227141928953: Tournament #3203221938, $27.40+$2.60 USD Hold'em No Limit - Level VI (80/160) - 2021/05/28 23:37:14 MSK [2021/05/28 16:37:14 ET]
Table '3203221938 1' 9-max Seat #5 is the button
Seat 4: JourneyWell (3787 in chips)
Seat 5: dimetruk (1267 in chips)
Seat 7: Maus219 (8446 in chips)
JourneyWell: posts the ante 20
dimetruk: posts the ante 20
Maus219: posts the ante 20
Maus219: posts small blind 80
JourneyWell: posts big blind 160
*** HOLE CARDS ***
Dealt to dimetruk [Ad Tc]
dimetruk: raises 1087 to 1247 and is all-in
Maus219: folds
JourneyWell: calls 1087
*** FLOP *** [4d Kc Js]
*** TURN *** [4d Kc Js] [9s]
*** RIVER *** [4d Kc Js 9s] [Ah]
*** SHOW DOWN ***
JourneyWell: shows [Kh Qc] (a pair of Kings)
dimetruk: shows [Ad Tc] (a pair of Aces)
dimetruk collected 2634 from pot
*** SUMMARY ***
Total pot 2634 | Rake 0
Board [4d Kc Js 9s Ah]
Seat 4: JourneyWell (big blind) showed [Kh Qc] and lost with a pair of Kings
Seat 5: dimetruk (button) showed [Ad Tc] and won (2634) with a pair of Aces
Seat 7: Maus219 (small blind) folded before Flop


PokerStars Hand #227141937286: Tournament #3203221938, $27.40+$2.60 USD Hold'em No Limit - Level VI (80/160) - 2021/05/28 23:37:29 MSK [2021/05/28 16:37:29 ET]
Table '3203221938 1' 9-max Seat #7 is the button
Seat 4: JourneyWell (2520 in chips)
Seat 5: dimetruk (2634 in chips)
Seat 7: Maus219 (8346 in chips)
JourneyWell: posts the ante 20
dimetruk: posts the ante 20
Maus219: posts the ante 20
JourneyWell: posts small blind 80
dimetruk: posts big blind 160
*** HOLE CARDS ***
Dealt to dimetruk [Kd 5h]
Maus219: raises 160 to 320
JourneyWell: calls 240
dimetruk: calls 160
*** FLOP *** [3s 5d Jh]
JourneyWell: checks
dimetruk: checks
Maus219: bets 285
JourneyWell: calls 285
dimetruk: calls 285
*** TURN *** [3s 5d Jh] [Jc]
JourneyWell: checks
dimetruk: checks
Maus219: checks
*** RIVER *** [3s 5d Jh Jc] [Ks]
JourneyWell: bets 320
dimetruk: calls 320
Maus219: raises 7401 to 7721 and is all-in
JourneyWell: folds
dimetruk: folds
Uncalled bet (7401) returned to Maus219
Maus219 collected 2835 from pot
Maus219: doesn't show hand
*** SUMMARY ***
Total pot 2835 | Rake 0
Board [3s 5d Jh Jc Ks]
Seat 4: JourneyWell (small blind) folded on the River
Seat 5: dimetruk (big blind) folded on the River
Seat 7: Maus219 (button) collected (2835)


PokerStars Hand #227141980478: Tournament #3203221938, $27.40+$2.60 USD Hold'em No Limit - Level VI (80/160) - 2021/05/28 23:38:48 MSK [2021/05/28 16:38:48 ET]
Table '3203221938 1' 9-max Seat #7 is the button
Seat 4: JourneyWell (3730 in chips)
Seat 5: dimetruk (1569 in chips)
Seat 7: Maus219 (8201 in chips)
JourneyWell: posts the ante 20
dimetruk: posts the ante 20
Maus219: posts the ante 20
JourneyWell: posts small blind 80
dimetruk: posts big blind 160
*** HOLE CARDS ***
Dealt to dimetruk [Ah 2c]
Maus219: raises 160 to 320
JourneyWell: folds
dimetruk: raises 1229 to 1549 and is all-in
Maus219: calls 1229
*** FLOP *** [7d 9s Tc]
*** TURN *** [7d 9s Tc] [5s]
*** RIVER *** [7d 9s Tc 5s] [Js]
*** SHOW DOWN ***
dimetruk: shows [Ah 2c] (high card Ace)
Maus219: shows [Ac 6c] (high card Ace)
dimetruk collected 1619 from pot
Maus219 collected 1619 from pot
*** SUMMARY ***
Total pot 3238 | Rake 0
Board [7d 9s Tc 5s Js]
Seat 4: JourneyWell (small blind) folded before Flop
Seat 5: dimetruk (big blind) showed [Ah 2c] and won (1619) with high card Ace
Seat 7: Maus219 (button) showed [Ac 6c] and won (1619) with high card Ace


PokerStars Hand #227142061164: Tournament #3203221938, $27.40+$2.60 USD Hold'em No Limit - Level VI (80/160) - 2021/05/28 23:41:15 MSK [2021/05/28 16:41:15 ET]
Table '3203221938 1' 9-max Seat #7 is the button
Seat 4: JourneyWell (4012 in chips)
Seat 5: dimetruk (1799 in chips)
Seat 7: Maus219 (7689 in chips)
JourneyWell: posts the ante 20
dimetruk: posts the ante 20
Maus219: posts the ante 20
JourneyWell: posts small blind 80
dimetruk: posts big blind 160
*** HOLE CARDS ***
Dealt to dimetruk [7c 7h]
Maus219: raises 160 to 320
JourneyWell: calls 240
dimetruk: raises 1459 to 1779 and is all-in
Maus219: raises 5890 to 7669 and is all-in
JourneyWell: folds [Qc Kd]
Uncalled bet (5890) returned to Maus219
*** FLOP *** [6s 6h Qs]
*** TURN *** [6s 6h Qs] [8c]
*** RIVER *** [6s 6h Qs 8c] [9s]
*** SHOW DOWN ***
dimetruk: shows [7c 7h] (two pair, Sevens and Sixes)
Maus219: shows [Td Tc] (two pair, Tens and Sixes)
Maus219 collected 3938 from pot
dimetruk finished the tournament in 3rd place and received $49.32.
*** SUMMARY ***
Total pot 3938 | Rake 0
Board [6s 6h Qs 8c 9s]
Seat 4: JourneyWell (small blind) folded before Flop
Seat 5: dimetruk (big blind) showed [7c 7h] and lost with two pair, Sevens and Sixes
Seat 7: Maus219 (button) showed [Td Tc] and won (3938) with two pair, Tens and Sixes


PokerStars Hand #227142824936: Tournament #3203262490, $27.40+$2.60 USD Hold'em No Limit - Level I (10/20) - 2021/05/29 0:05:40 MSK [2021/05/28 17:05:40 ET]
Table '3203262490 1' 9-max Seat #2 is the button
Seat 1: jonesie202 (1497 in chips) is sitting out
Seat 2: thimmy11 (1487 in chips)
Seat 3: Apfel2905 (1669 in chips)
Seat 4: dimetruk (1497 in chips)
Seat 5: Kommersant K (1497 in chips)
Seat 6: maxats24 (1497 in chips)
Seat 7: Bandit12373 (1362 in chips)
Seat 8: CadMonkey82 (1497 in chips)
Seat 9: Tom1_AuAg_CZ (1497 in chips)
jonesie202: posts the ante 3
thimmy11: posts the ante 3
Apfel2905: posts the ante 3
dimetruk: posts the ante 3
Kommersant K: posts the ante 3
maxats24: posts the ante 3
Bandit12373: posts the ante 3
CadMonkey82: posts the ante 3
Tom1_AuAg_CZ: posts the ante 3
Apfel2905: posts small blind 10
dimetruk: posts big blind 20
*** HOLE CARDS ***
Dealt to dimetruk [Ac 9h]
Kommersant K: folds
maxats24: folds
Bandit12373: folds
CadMonkey82: raises 40 to 60
Tom1_AuAg_CZ: calls 60
jonesie202: folds
thimmy11: folds
Apfel2905: folds
dimetruk: calls 40
*** FLOP *** [3h Th 7c]
dimetruk: checks
CadMonkey82: checks
Tom1_AuAg_CZ: bets 91
dimetruk: folds
CadMonkey82: calls 91
*** TURN *** [3h Th 7c] [Jd]
CadMonkey82: checks
Tom1_AuAg_CZ: checks
*** RIVER *** [3h Th 7c Jd] [Qc]
CadMonkey82: bets 200
Tom1_AuAg_CZ: folds
Uncalled bet (200) returned to CadMonkey82
CadMonkey82 collected 399 from pot
CadMonkey82: doesn't show hand
*** SUMMARY ***
Total pot 399 | Rake 0
Board [3h Th 7c Jd Qc]
Seat 1: jonesie202 folded before Flop (didn't bet)
Seat 2: thimmy11 (button) folded before Flop (didn't bet)
Seat 3: Apfel2905 (small blind) folded before Flop
Seat 4: dimetruk (big blind) folded on the Flop
Seat 5: Kommersant K folded before Flop (didn't bet)
Seat 6: maxats24 folded before Flop (didn't bet)
Seat 7: Bandit12373 folded before Flop (didn't bet)
Seat 8: CadMonkey82 collected (399)
Seat 9: Tom1_AuAg_CZ folded on the River


PokerStars Hand #227143526705: Tournament #3203262490, $27.40+$2.60 USD Hold'em No Limit - Level III (25/50) - 2021/05/29 0:26:44 MSK [2021/05/28 17:26:44 ET]
Table '3203262490 1' 9-max Seat #6 is the button
Seat 2: thimmy11 (822 in chips)
Seat 3: Apfel2905 (2176 in chips)
Seat 4: dimetruk (1324 in chips)
Seat 5: Kommersant K (2153 in chips)
Seat 6: maxats24 (1355 in chips)
Seat 7: Bandit12373 (2572 in chips)
Seat 8: CadMonkey82 (940 in chips)
Seat 9: Tom1_AuAg_CZ (2158 in chips)
thimmy11: posts the ante 6
Apfel2905: posts the ante 6
dimetruk: posts the ante 6
Kommersant K: posts the ante 6
maxats24: posts the ante 6
Bandit12373: posts the ante 6
CadMonkey82: posts the ante 6
Tom1_AuAg_CZ: posts the ante 6
Bandit12373: posts small blind 25
CadMonkey82: posts big blind 50
*** HOLE CARDS ***
Dealt to dimetruk [8s Ah]
Tom1_AuAg_CZ: folds
thimmy11: folds
Apfel2905: folds
dimetruk: raises 50 to 100
Kommersant K: folds
maxats24: folds
Bandit12373: calls 75
CadMonkey82: calls 50
*** FLOP *** [4s Js Td]
Bandit12373: checks
CadMonkey82: bets 200
dimetruk: folds
Bandit12373: folds
Uncalled bet (200) returned to CadMonkey82
CadMonkey82 collected 348 from pot
CadMonkey82: doesn't show hand
*** SUMMARY ***
Total pot 348 | Rake 0
Board [4s Js Td]
Seat 2: thimmy11 folded before Flop (didn't bet)
Seat 3: Apfel2905 folded before Flop (didn't bet)
Seat 4: dimetruk folded on the Flop
Seat 5: Kommersant K folded before Flop (didn't bet)
Seat 6: maxats24 (button) folded before Flop (didn't bet)
Seat 7: Bandit12373 (small blind) folded on the Flop
Seat 8: CadMonkey82 (big blind) collected (348)
Seat 9: Tom1_AuAg_CZ folded before Flop (didn't bet)


PokerStars Hand #227143876872: Tournament #3203262490, $27.40+$2.60 USD Hold'em No Limit - Level IV (40/80) - 2021/05/29 0:37:38 MSK [2021/05/28 17:37:38 ET]
Table '3203262490 1' 9-max Seat #2 is the button
Seat 2: thimmy11 (1035 in chips)
Seat 3: Apfel2905 (2448 in chips)
Seat 4: dimetruk (1061 in chips)
Seat 5: Kommersant K (1990 in chips)
Seat 6: maxats24 (1192 in chips)
Seat 7: Bandit12373 (2914 in chips)
Seat 8: CadMonkey82 (862 in chips)
Seat 9: Tom1_AuAg_CZ (1998 in chips)
thimmy11: posts the ante 10
Apfel2905: posts the ante 10
dimetruk: posts the ante 10
Kommersant K: posts the ante 10
maxats24: posts the ante 10
Bandit12373: posts the ante 10
CadMonkey82: posts the ante 10
Tom1_AuAg_CZ: posts the ante 10
Apfel2905: posts small blind 40
dimetruk: posts big blind 80
*** HOLE CARDS ***
Dealt to dimetruk [5d Tc]
Kommersant K: raises 80 to 160
maxats24: folds
Bandit12373: calls 160
CadMonkey82: folds
Tom1_AuAg_CZ: folds
thimmy11: folds
Apfel2905: folds
dimetruk: calls 80
*** FLOP *** [5h 3h Kh]
dimetruk: checks
Kommersant K: checks
Bandit12373: bets 600
dimetruk: folds
Kommersant K: folds
Uncalled bet (600) returned to Bandit12373
Bandit12373 collected 600 from pot
*** SUMMARY ***
Total pot 600 | Rake 0
Board [5h 3h Kh]
Seat 2: thimmy11 (button) folded before Flop (didn't bet)
Seat 3: Apfel2905 (small blind) folded before Flop
Seat 4: dimetruk (big blind) folded on the Flop
Seat 5: Kommersant K folded on the Flop
Seat 6: maxats24 folded before Flop (didn't bet)
Seat 7: Bandit12373 collected (600)
Seat 8: CadMonkey82 folded before Flop (didn't bet)
Seat 9: Tom1_AuAg_CZ folded before Flop (didn't bet)


PokerStars Hand #227144094067: Tournament #3203262490, $27.40+$2.60 USD Hold'em No Limit - Level V (60/120) - 2021/05/29 0:44:24 MSK [2021/05/28 17:44:24 ET]
Table '3203262490 1' 9-max Seat #9 is the button
Seat 2: thimmy11 (1120 in chips)
Seat 3: Apfel2905 (2993 in chips)
Seat 4: dimetruk (746 in chips)
Seat 5: Kommersant K (1955 in chips)
Seat 6: maxats24 (997 in chips)
Seat 7: Bandit12373 (1517 in chips)
Seat 8: CadMonkey82 (2089 in chips)
Seat 9: Tom1_AuAg_CZ (2083 in chips)
thimmy11: posts the ante 15
Apfel2905: posts the ante 15
dimetruk: posts the ante 15
Kommersant K: posts the ante 15
maxats24: posts the ante 15
Bandit12373: posts the ante 15
CadMonkey82: posts the ante 15
Tom1_AuAg_CZ: posts the ante 15
thimmy11: posts small blind 60
Apfel2905: posts big blind 120
*** HOLE CARDS ***
Dealt to dimetruk [Js Ks]
dimetruk: raises 611 to 731 and is all-in
Kommersant K: folds
maxats24: raises 251 to 982 and is all-in
Bandit12373: folds
CadMonkey82: folds
Tom1_AuAg_CZ: folds
thimmy11: folds
Apfel2905: folds
Uncalled bet (251) returned to maxats24
*** FLOP *** [4s Qd Qh]
*** TURN *** [4s Qd Qh] [5s]
*** RIVER *** [4s Qd Qh 5s] [9s]
*** SHOW DOWN ***
dimetruk: shows [Js Ks] (a flush, King high)
maxats24: shows [Ah Qc] (three of a kind, Queens)
dimetruk collected 1762 from pot
*** SUMMARY ***
Total pot 1762 | Rake 0
Board [4s Qd Qh 5s 9s]
Seat 2: thimmy11 (small blind) folded before Flop
Seat 3: Apfel2905 (big blind) folded before Flop
Seat 4: dimetruk showed [Js Ks] and won (1762) with a flush, King high
Seat 5: Kommersant K folded before Flop (didn't bet)
Seat 6: maxats24 showed [Ah Qc] and lost with three of a kind, Queens
Seat 7: Bandit12373 folded before Flop (didn't bet)
Seat 8: CadMonkey82 folded before Flop (didn't bet)
Seat 9: Tom1_AuAg_CZ (button) folded before Flop (didn't bet)


PokerStars Hand #227144460623: Tournament #3203262490, $27.40+$2.60 USD Hold'em No Limit - Level VI (80/160) - 2021/05/29 0:56:53 MSK [2021/05/28 17:56:53 ET]
Table '3203262490 1' 9-max Seat #4 is the button
Seat 2: thimmy11 (3486 in chips)
Seat 3: Apfel2905 (3058 in chips)
Seat 4: dimetruk (2157 in chips)
Seat 5: Kommersant K (2300 in chips)
Seat 8: CadMonkey82 (2499 in chips)
thimmy11: posts the ante 20
Apfel2905: posts the ante 20
dimetruk: posts the ante 20
Kommersant K: posts the ante 20
CadMonkey82: posts the ante 20
Kommersant K: posts small blind 80
CadMonkey82: posts big blind 160
*** HOLE CARDS ***
Dealt to dimetruk [As Ah]
thimmy11: folds
Apfel2905: folds
dimetruk: raises 160 to 320
Kommersant K: folds
CadMonkey82: calls 160
*** FLOP *** [4c 2s 6d]
CadMonkey82: checks
dimetruk: bets 549
CadMonkey82: folds
Uncalled bet (549) returned to dimetruk
dimetruk collected 820 from pot
dimetruk: doesn't show hand
*** SUMMARY ***
Total pot 820 | Rake 0
Board [4c 2s 6d]
Seat 2: thimmy11 folded before Flop (didn't bet)
Seat 3: Apfel2905 folded before Flop (didn't bet)
Seat 4: dimetruk (button) collected (820)
Seat 5: Kommersant K (small blind) folded before Flop
Seat 8: CadMonkey82 (big blind) folded on the Flop


PokerStars Hand #227144567056: Tournament #3203262490, $27.40+$2.60 USD Hold'em No Limit - Level VI (80/160) - 2021/05/29 1:00:47 MSK [2021/05/28 18:00:47 ET]
Table '3203262490 1' 9-max Seat #2 is the button
Seat 2: thimmy11 (2476 in chips)
Seat 3: Apfel2905 (4128 in chips)
Seat 4: dimetruk (2757 in chips)
Seat 5: Kommersant K (2500 in chips)
Seat 8: CadMonkey82 (1639 in chips)
thimmy11: posts the ante 20
Apfel2905: posts the ante 20
dimetruk: posts the ante 20
Kommersant K: posts the ante 20
CadMonkey82: posts the ante 20
Apfel2905: posts small blind 80
dimetruk: posts big blind 160
*** HOLE CARDS ***
Dealt to dimetruk [4h 4s]
Kommersant K: folds
CadMonkey82: folds
thimmy11: folds
Apfel2905: calls 80
dimetruk: checks
*** FLOP *** [3s 5d 6s]
Apfel2905: bets 210
dimetruk: calls 210
*** TURN *** [3s 5d 6s] [7s]
Apfel2905: checks
dimetruk: bets 420
Apfel2905: folds
Uncalled bet (420) returned to dimetruk
dimetruk collected 840 from pot
dimetruk: doesn't show hand
*** SUMMARY ***
Total pot 840 | Rake 0
Board [3s 5d 6s 7s]
Seat 2: thimmy11 (button) folded before Flop (didn't bet)
Seat 3: Apfel2905 (small blind) folded on the Turn
Seat 4: dimetruk (big blind) collected (840)
Seat 5: Kommersant K folded before Flop (didn't bet)
Seat 8: CadMonkey82 folded before Flop (didn't bet)


PokerStars Hand #227144964022: Tournament #3203262490, $27.40+$2.60 USD Hold'em No Limit - Level VIII (150/300) - 2021/05/29 1:14:26 MSK [2021/05/28 18:14:26 ET]
Table '3203262490 1' 9-max Seat #2 is the button
Seat 2: thimmy11 (2469 in chips)
Seat 3: Apfel2905 (6349 in chips)
Seat 4: dimetruk (1967 in chips)
Seat 8: CadMonkey82 (2715 in chips)
thimmy11: posts the ante 25
Apfel2905: posts the ante 25
dimetruk: posts the ante 25
CadMonkey82: posts the ante 25
Apfel2905: posts small blind 150
dimetruk: posts big blind 300
*** HOLE CARDS ***
Dealt to dimetruk [Ad 5c]
CadMonkey82: folds
thimmy11: folds
Apfel2905: calls 150
dimetruk: raises 1642 to 1942 and is all-in
Apfel2905: calls 1642
*** FLOP *** [Qc 3d 3c]
*** TURN *** [Qc 3d 3c] [7h]
*** RIVER *** [Qc 3d 3c 7h] [Th]
*** SHOW DOWN ***
Apfel2905: shows [Ks 8s] (a pair of Threes)
dimetruk: shows [Ad 5c] (a pair of Threes - Ace kicker)
dimetruk collected 3984 from pot
*** SUMMARY ***
Total pot 3984 | Rake 0
Board [Qc 3d 3c 7h Th]
Seat 2: thimmy11 (button) folded before Flop (didn't bet)
Seat 3: Apfel2905 (small blind) showed [Ks 8s] and lost with a pair of Threes
Seat 4: dimetruk (big blind) showed [Ad 5c] and won (3984) with a pair of Threes
Seat 8: CadMonkey82 folded before Flop (didn't bet)


PokerStars Hand #227144980135: Tournament #3203262490, $27.40+$2.60 USD Hold'em No Limit - Level VIII (150/300) - 2021/05/29 1:15:00 MSK [2021/05/28 18:15:00 ET]
Table '3203262490 1' 9-max Seat #3 is the button
Seat 2: thimmy11 (2444 in chips)
Seat 3: Apfel2905 (4382 in chips)
Seat 4: dimetruk (3984 in chips)
Seat 8: CadMonkey82 (2690 in chips)
thimmy11: posts the ante 25
Apfel2905: posts the ante 25
dimetruk: posts the ante 25
CadMonkey82: posts the ante 25
dimetruk: posts small blind 150
CadMonkey82: posts big blind 300
*** HOLE CARDS ***
Dealt to dimetruk [4d 6d]
thimmy11: folds
Apfel2905: folds
dimetruk: calls 150
CadMonkey82: checks
*** FLOP *** [Qs Ks 6c]
dimetruk: bets 300
CadMonkey82: folds
Uncalled bet (300) returned to dimetruk
dimetruk collected 700 from pot
dimetruk: doesn't show hand
*** SUMMARY ***
Total pot 700 | Rake 0
Board [Qs Ks 6c]
Seat 2: thimmy11 folded before Flop (didn't bet)
Seat 3: Apfel2905 (button) folded before Flop (didn't bet)
Seat 4: dimetruk (small blind) collected (700)
Seat 8: CadMonkey82 (big blind) folded on the Flop


PokerStars Hand #227145029341: Tournament #3203262490, $27.40+$2.60 USD Hold'em No Limit - Level VIII (150/300) - 2021/05/29 1:16:45 MSK [2021/05/28 18:16:45 ET]
Table '3203262490 1' 9-max Seat #2 is the button
Seat 2: thimmy11 (2919 in chips)
Seat 3: Apfel2905 (3107 in chips)
Seat 4: dimetruk (4309 in chips)
Seat 8: CadMonkey82 (3165 in chips)
thimmy11: posts the ante 25
Apfel2905: posts the ante 25
dimetruk: posts the ante 25
CadMonkey82: posts the ante 25
Apfel2905: posts small blind 150
dimetruk: posts big blind 300
*** HOLE CARDS ***
Dealt to dimetruk [4h Td]
CadMonkey82: calls 300
thimmy11: folds
Apfel2905: calls 150
dimetruk: checks
*** FLOP *** [Tc Qs 7c]
Apfel2905: bets 300
dimetruk: folds
CadMonkey82: calls 300
*** TURN *** [Tc Qs 7c] [9d]
Apfel2905: bets 2482 and is all-in
CadMonkey82: folds
Uncalled bet (2482) returned to Apfel2905
Apfel2905 collected 1600 from pot
Apfel2905: doesn't show hand
*** SUMMARY ***
Total pot 1600 | Rake 0
Board [Tc Qs 7c 9d]
Seat 2: thimmy11 (button) folded before Flop (didn't bet)
Seat 3: Apfel2905 (small blind) collected (1600)
Seat 4: dimetruk (big blind) folded on the Flop
Seat 8: CadMonkey82 folded on the Turn


PokerStars Hand #227145134848: Tournament #3203262490, $27.40+$2.60 USD Hold'em No Limit - Level VIII (150/300) - 2021/05/29 1:20:21 MSK [2021/05/28 18:20:21 ET]
Table '3203262490 1' 9-max Seat #3 is the button
Seat 3: Apfel2905 (3707 in chips) is sitting out
Seat 4: dimetruk (4134 in chips)
Seat 8: CadMonkey82 (5659 in chips)
Apfel2905: posts the ante 25
dimetruk: posts the ante 25
CadMonkey82: posts the ante 25
dimetruk: posts small blind 150
CadMonkey82: posts big blind 300
*** HOLE CARDS ***
Dealt to dimetruk [3d Kc]
Apfel2905: folds
Apfel2905 has returned
dimetruk: calls 150
CadMonkey82: checks
*** FLOP *** [Qc 2h 5c]
dimetruk: bets 300
CadMonkey82: folds
Uncalled bet (300) returned to dimetruk
dimetruk collected 675 from pot
dimetruk: doesn't show hand
*** SUMMARY ***
Total pot 675 | Rake 0
Board [Qc 2h 5c]
Seat 3: Apfel2905 (button) folded before Flop (didn't bet)
Seat 4: dimetruk (small blind) collected (675)
Seat 8: CadMonkey82 (big blind) folded on the Flop


PokerStars Hand #227145151550: Tournament #3203262490, $27.40+$2.60 USD Hold'em No Limit - Level VIII (150/300) - 2021/05/29 1:20:57 MSK [2021/05/28 18:20:57 ET]
Table '3203262490 1' 9-max Seat #8 is the button
Seat 3: Apfel2905 (3357 in chips)
Seat 4: dimetruk (4459 in chips)
Seat 8: CadMonkey82 (5684 in chips)
Apfel2905: posts the ante 25
dimetruk: posts the ante 25
CadMonkey82: posts the ante 25
Apfel2905: posts small blind 150
dimetruk: posts big blind 300
*** HOLE CARDS ***
Dealt to dimetruk [Ac 6c]
CadMonkey82: folds
Apfel2905: raises 300 to 600
dimetruk: calls 300
*** FLOP *** [Jc 6s 2c]
Apfel2905: bets 637
dimetruk: raises 3197 to 3834 and is all-in
Apfel2905: calls 2095 and is all-in
Uncalled bet (1102) returned to dimetruk
*** TURN *** [Jc 6s 2c] [9c]
*** RIVER *** [Jc 6s 2c 9c] [4s]
*** SHOW DOWN ***
Apfel2905: shows [8h 8c] (a pair of Eights)
dimetruk: shows [Ac 6c] (a flush, Ace high)
dimetruk collected 6739 from pot
Apfel2905 finished the tournament in 3rd place and received $49.32.
*** SUMMARY ***
Total pot 6739 | Rake 0
Board [Jc 6s 2c 9c 4s]
Seat 3: Apfel2905 (small blind) showed [8h 8c] and lost with a pair of Eights
Seat 4: dimetruk (big blind) showed [Ac 6c] and won (6739) with a flush, Ace high
Seat 8: CadMonkey82 (button) folded before Flop (didn't bet)


PokerStars Hand #227145166573: Tournament #3203262490, $27.40+$2.60 USD Hold'em No Limit - Level VIII (150/300) - 2021/05/29 1:21:30 MSK [2021/05/28 18:21:30 ET]
Table '3203262490 1' 9-max Seat #4 is the button
Seat 4: dimetruk (7841 in chips)
Seat 8: CadMonkey82 (5659 in chips)
dimetruk: posts the ante 25
CadMonkey82: posts the ante 25
dimetruk: posts small blind 150
CadMonkey82: posts big blind 300
*** HOLE CARDS ***
Dealt to dimetruk [9s 7s]
dimetruk: raises 300 to 600
CadMonkey82: calls 300
*** FLOP *** [8c 7d 4c]
CadMonkey82: checks
dimetruk: bets 625
CadMonkey82: calls 625
*** TURN *** [8c 7d 4c] [Jh]
CadMonkey82: checks
dimetruk: bets 1200
CadMonkey82: folds
Uncalled bet (1200) returned to dimetruk
dimetruk collected 2500 from pot
dimetruk: doesn't show hand
*** SUMMARY ***
Total pot 2500 | Rake 0
Board [8c 7d 4c Jh]
Seat 4: dimetruk (button) (small blind) collected (2500)
Seat 8: CadMonkey82 (big blind) folded on the Turn


PokerStars Hand #227145179515: Tournament #3203262490, $27.40+$2.60 USD Hold'em No Limit - Level VIII (150/300) - 2021/05/29 1:21:59 MSK [2021/05/28 18:21:59 ET]
Table '3203262490 1' 9-max Seat #8 is the button
Seat 4: dimetruk (9091 in chips)
Seat 8: CadMonkey82 (4409 in chips)
dimetruk: posts the ante 25
CadMonkey82: posts the ante 25
CadMonkey82: posts small blind 150
dimetruk: posts big blind 300
*** HOLE CARDS ***
Dealt to dimetruk [Ks 6c]
CadMonkey82: calls 150
dimetruk: checks
*** FLOP *** [Th 2c 2h]
dimetruk: checks
CadMonkey82: bets 600
dimetruk: folds
Uncalled bet (600) returned to CadMonkey82
CadMonkey82 collected 650 from pot
CadMonkey82: doesn't show hand
*** SUMMARY ***
Total pot 650 | Rake 0
Board [Th 2c 2h]
Seat 4: dimetruk (big blind) folded on the Flop
Seat 8: CadMonkey82 (button) (small blind) collected (650)


PokerStars Hand #227145187612: Tournament #3203262490, $27.40+$2.60 USD Hold'em No Limit - Level VIII (150/300) - 2021/05/29 1:22:17 MSK [2021/05/28 18:22:17 ET]
Table '3203262490 1' 9-max Seat #8 is the button
Seat 4: dimetruk (8591 in chips)
Seat 8: CadMonkey82 (4909 in chips)
dimetruk: posts the ante 25
CadMonkey82: posts the ante 25
CadMonkey82: posts small blind 150
dimetruk: posts big blind 300
*** HOLE CARDS ***
Dealt to dimetruk [8d 2h]
CadMonkey82: calls 150
dimetruk: checks
*** FLOP *** [9s Ks Jd]
dimetruk: checks
CadMonkey82: bets 600
dimetruk: folds
Uncalled bet (600) returned to CadMonkey82
CadMonkey82 collected 650 from pot
CadMonkey82: doesn't show hand
*** SUMMARY ***
Total pot 650 | Rake 0
Board [9s Ks Jd]
Seat 4: dimetruk (big blind) folded on the Flop
Seat 8: CadMonkey82 (button) (small blind) collected (650)


PokerStars Hand #227145193568: Tournament #3203262490, $27.40+$2.60 USD Hold'em No Limit - Level VIII (150/300) - 2021/05/29 1:22:30 MSK [2021/05/28 18:22:30 ET]
Table '3203262490 1' 9-max Seat #4 is the button
Seat 4: dimetruk (8266 in chips)
Seat 8: CadMonkey82 (5234 in chips)
dimetruk: posts the ante 25
CadMonkey82: posts the ante 25
dimetruk: posts small blind 150
CadMonkey82: posts big blind 300
*** HOLE CARDS ***
Dealt to dimetruk [9c 8c]
dimetruk: raises 300 to 600
CadMonkey82: raises 600 to 1200
dimetruk: calls 600
*** FLOP *** [8h 6d 4d]
CadMonkey82: bets 4009 and is all-in
dimetruk: calls 4009
*** TURN *** [8h 6d 4d] [Ad]
*** RIVER *** [8h 6d 4d Ad] [5d]
*** SHOW DOWN ***
CadMonkey82: shows [Kd Qh] (a flush, Ace high)
dimetruk: shows [9c 8c] (a pair of Eights)
CadMonkey82 collected 10468 from pot
*** SUMMARY ***
Total pot 10468 | Rake 0
Board [8h 6d 4d Ad 5d]
Seat 4: dimetruk (button) (small blind) showed [9c 8c] and lost with a pair of Eights
Seat 8: CadMonkey82 (big blind) showed [Kd Qh] and won (10468) with a flush, Ace high


PokerStars Hand #227145210014: Tournament #3203262490, $27.40+$2.60 USD Hold'em No Limit - Level VIII (150/300) - 2021/05/29 1:23:06 MSK [2021/05/28 18:23:06 ET]
Table '3203262490 1' 9-max Seat #4 is the button
Seat 4: dimetruk (3357 in chips)
Seat 8: CadMonkey82 (10143 in chips)
dimetruk: posts the ante 25
CadMonkey82: posts the ante 25
dimetruk: posts small blind 150
CadMonkey82: posts big blind 300
*** HOLE CARDS ***
Dealt to dimetruk [2d Ks]
dimetruk: raises 3032 to 3332 and is all-in
CadMonkey82: calls 3032
*** FLOP *** [3s 5s 5h]
*** TURN *** [3s 5s 5h] [3h]
*** RIVER *** [3s 5s 5h 3h] [3c]
*** SHOW DOWN ***
CadMonkey82: shows [7h Ad] (a full house, Threes full of Fives)
dimetruk: shows [2d Ks] (a full house, Threes full of Fives)
CadMonkey82 collected 3357 from pot
dimetruk collected 3357 from pot
*** SUMMARY ***
Total pot 6714 | Rake 0
Board [3s 5s 5h 3h 3c]
Seat 4: dimetruk (button) (small blind) showed [2d Ks] and won (3357) with a full house, Threes full of Fives
Seat 8: CadMonkey82 (big blind) showed [7h Ad] and won (3357) with a full house, Threes full of Fives


PokerStars Hand #227145224378: Tournament #3203262490, $27.40+$2.60 USD Hold'em No Limit - Level IX (200/400) - 2021/05/29 1:23:37 MSK [2021/05/28 18:23:37 ET]
Table '3203262490 1' 9-max Seat #8 is the button
Seat 4: dimetruk (3557 in chips)
Seat 8: CadMonkey82 (9943 in chips)
dimetruk: posts the ante 25
CadMonkey82: posts the ante 25
CadMonkey82: posts small blind 200
dimetruk: posts big blind 400
*** HOLE CARDS ***
Dealt to dimetruk [6s 7h]
CadMonkey82: calls 200
dimetruk: checks
*** FLOP *** [Kc 3s Jh]
dimetruk: checks
CadMonkey82: bets 800
dimetruk: folds
Uncalled bet (800) returned to CadMonkey82
CadMonkey82 collected 850 from pot
CadMonkey82: doesn't show hand
*** SUMMARY ***
Total pot 850 | Rake 0
Board [Kc 3s Jh]
Seat 4: dimetruk (big blind) folded on the Flop
Seat 8: CadMonkey82 (button) (small blind) collected (850)


PokerStars Hand #227145252617: Tournament #3203262490, $27.40+$2.60 USD Hold'em No Limit - Level IX (200/400) - 2021/05/29 1:24:39 MSK [2021/05/28 18:24:39 ET]
Table '3203262490 1' 9-max Seat #8 is the button
Seat 4: dimetruk (3557 in chips)
Seat 8: CadMonkey82 (9943 in chips)
dimetruk: posts the ante 25
CadMonkey82: posts the ante 25
CadMonkey82: posts small blind 200
dimetruk: posts big blind 400
*** HOLE CARDS ***
Dealt to dimetruk [9h 6d]
CadMonkey82: calls 200
dimetruk: checks
*** FLOP *** [Ks 3c 8h]
dimetruk: bets 400
CadMonkey82: calls 400
*** TURN *** [Ks 3c 8h] [4c]
dimetruk: checks
CadMonkey82: bets 825
dimetruk: folds
Uncalled bet (825) returned to CadMonkey82
CadMonkey82 collected 1650 from pot
CadMonkey82: doesn't show hand
*** SUMMARY ***
Total pot 1650 | Rake 0
Board [Ks 3c 8h 4c]
Seat 4: dimetruk (big blind) folded on the Turn
Seat 8: CadMonkey82 (button) (small blind) collected (1650)


PokerStars Hand #227145262504: Tournament #3203262490, $27.40+$2.60 USD Hold'em No Limit - Level IX (200/400) - 2021/05/29 1:25:01 MSK [2021/05/28 18:25:01 ET]
Table '3203262490 1' 9-max Seat #4 is the button
Seat 4: dimetruk (2732 in chips)
Seat 8: CadMonkey82 (10768 in chips)
dimetruk: posts the ante 25
CadMonkey82: posts the ante 25
dimetruk: posts small blind 200
CadMonkey82: posts big blind 400
*** HOLE CARDS ***
Dealt to dimetruk [9d Js]
dimetruk: raises 2307 to 2707 and is all-in
CadMonkey82: calls 2307
*** FLOP *** [Jd As 8s]
*** TURN *** [Jd As 8s] [Th]
*** RIVER *** [Jd As 8s Th] [Qc]
*** SHOW DOWN ***
CadMonkey82: shows [Ah 8d] (two pair, Aces and Eights)
dimetruk: shows [9d Js] (a straight, Eight to Queen)
dimetruk collected 5464 from pot
*** SUMMARY ***
Total pot 5464 | Rake 0
Board [Jd As 8s Th Qc]
Seat 4: dimetruk (button) (small blind) showed [9d Js] and won (5464) with a straight, Eight to Queen
Seat 8: CadMonkey82 (big blind) showed [Ah 8d] and lost with two pair, Aces and Eights


PokerStars Hand #227145267763: Tournament #3203262490, $27.40+$2.60 USD Hold'em No Limit - Level IX (200/400) - 2021/05/29 1:25:13 MSK [2021/05/28 18:25:13 ET]
Table '3203262490 1' 9-max Seat #8 is the button
Seat 4: dimetruk (5464 in chips)
Seat 8: CadMonkey82 (8036 in chips)
dimetruk: posts the ante 25
CadMonkey82: posts the ante 25
CadMonkey82: posts small blind 200
dimetruk: posts big blind 400
*** HOLE CARDS ***
Dealt to dimetruk [9h Qd]
CadMonkey82: calls 200
dimetruk: checks
*** FLOP *** [2c 8s Ac]
dimetruk: checks
CadMonkey82: checks
*** TURN *** [2c 8s Ac] [Qc]
dimetruk: bets 400
CadMonkey82: calls 400
*** RIVER *** [2c 8s Ac Qc] [8h]
dimetruk: bets 825
CadMonkey82: folds
Uncalled bet (825) returned to dimetruk
dimetruk collected 1650 from pot
dimetruk: doesn't show hand
*** SUMMARY ***
Total pot 1650 | Rake 0
Board [2c 8s Ac Qc 8h]
Seat 4: dimetruk (big blind) collected (1650)
Seat 8: CadMonkey82 (button) (small blind) folded on the River


PokerStars Hand #227145276695: Tournament #3203262490, $27.40+$2.60 USD Hold'em No Limit - Level IX (200/400) - 2021/05/29 1:25:32 MSK [2021/05/28 18:25:32 ET]
Table '3203262490 1' 9-max Seat #4 is the button
Seat 4: dimetruk (6289 in chips)
Seat 8: CadMonkey82 (7211 in chips)
dimetruk: posts the ante 25
CadMonkey82: posts the ante 25
dimetruk: posts small blind 200
CadMonkey82: posts big blind 400
*** HOLE CARDS ***
Dealt to dimetruk [4d 7h]
dimetruk: calls 200
CadMonkey82: checks
*** FLOP *** [2h 5h Qd]
CadMonkey82: bets 425
dimetruk: folds
Uncalled bet (425) returned to CadMonkey82
CadMonkey82 collected 850 from pot
CadMonkey82: doesn't show hand
*** SUMMARY ***
Total pot 850 | Rake 0
Board [2h 5h Qd]
Seat 4: dimetruk (button) (small blind) folded on the Flop
Seat 8: CadMonkey82 (big blind) collected (850)


PokerStars Hand #227145288058: Tournament #3203262490, $27.40+$2.60 USD Hold'em No Limit - Level IX (200/400) - 2021/05/29 1:25:58 MSK [2021/05/28 18:25:58 ET]
Table '3203262490 1' 9-max Seat #4 is the button
Seat 4: dimetruk (5439 in chips)
Seat 8: CadMonkey82 (8061 in chips)
dimetruk: posts the ante 25
CadMonkey82: posts the ante 25
dimetruk: posts small blind 200
CadMonkey82: posts big blind 400
*** HOLE CARDS ***
Dealt to dimetruk [6h 9d]
dimetruk: calls 200
CadMonkey82: checks
*** FLOP *** [Ks Th 7c]
CadMonkey82: checks
dimetruk: bets 400
CadMonkey82: folds
Uncalled bet (400) returned to dimetruk
dimetruk collected 850 from pot
dimetruk: doesn't show hand
*** SUMMARY ***
Total pot 850 | Rake 0
Board [Ks Th 7c]
Seat 4: dimetruk (button) (small blind) collected (850)
Seat 8: CadMonkey82 (big blind) folded on the Flop


PokerStars Hand #227145299960: Tournament #3203262490, $27.40+$2.60 USD Hold'em No Limit - Level IX (200/400) - 2021/05/29 1:26:24 MSK [2021/05/28 18:26:24 ET]
Table '3203262490 1' 9-max Seat #8 is the button
Seat 4: dimetruk (6714 in chips)
Seat 8: CadMonkey82 (6786 in chips)
dimetruk: posts the ante 25
CadMonkey82: posts the ante 25
CadMonkey82: posts small blind 200
dimetruk: posts big blind 400
*** HOLE CARDS ***
Dealt to dimetruk [4h 9d]
CadMonkey82: calls 200
dimetruk: checks
*** FLOP *** [6h Ts 3h]
dimetruk: checks
CadMonkey82: bets 800
dimetruk: folds
Uncalled bet (800) returned to CadMonkey82
CadMonkey82 collected 850 from pot
CadMonkey82: doesn't show hand
*** SUMMARY ***
Total pot 850 | Rake 0
Board [6h Ts 3h]
Seat 4: dimetruk (big blind) folded on the Flop
Seat 8: CadMonkey82 (button) (small blind) collected (850)


PokerStars Hand #227145318661: Tournament #3203262490, $27.40+$2.60 USD Hold'em No Limit - Level IX (200/400) - 2021/05/29 1:27:06 MSK [2021/05/28 18:27:06 ET]
Table '3203262490 1' 9-max Seat #4 is the button
Seat 4: dimetruk (6089 in chips)
Seat 8: CadMonkey82 (7411 in chips)
dimetruk: posts the ante 25
CadMonkey82: posts the ante 25
dimetruk: posts small blind 200
CadMonkey82: posts big blind 400
*** HOLE CARDS ***
Dealt to dimetruk [5s Kc]
dimetruk: raises 400 to 800
CadMonkey82: calls 400
*** FLOP *** [Qh 5h 7d]
CadMonkey82: checks
dimetruk: bets 825
CadMonkey82: folds
Uncalled bet (825) returned to dimetruk
dimetruk collected 1650 from pot
dimetruk: doesn't show hand
*** SUMMARY ***
Total pot 1650 | Rake 0
Board [Qh 5h 7d]
Seat 4: dimetruk (button) (small blind) collected (1650)
Seat 8: CadMonkey82 (big blind) folded on the Flop


PokerStars Hand #227145325602: Tournament #3203262490, $27.40+$2.60 USD Hold'em No Limit - Level IX (200/400) - 2021/05/29 1:27:21 MSK [2021/05/28 18:27:21 ET]
Table '3203262490 1' 9-max Seat #8 is the button
Seat 4: dimetruk (6914 in chips)
Seat 8: CadMonkey82 (6586 in chips)
dimetruk: posts the ante 25
CadMonkey82: posts the ante 25
CadMonkey82: posts small blind 200
dimetruk: posts big blind 400
*** HOLE CARDS ***
Dealt to dimetruk [8d Kh]
CadMonkey82: calls 200
dimetruk: checks
*** FLOP *** [4c 5h 2h]
dimetruk: checks
CadMonkey82: bets 850
dimetruk: folds
Uncalled bet (850) returned to CadMonkey82
CadMonkey82 collected 850 from pot
CadMonkey82: doesn't show hand
*** SUMMARY ***
Total pot 850 | Rake 0
Board [4c 5h 2h]
Seat 4: dimetruk (big blind) folded on the Flop
Seat 8: CadMonkey82 (button) (small blind) collected (850)


PokerStars Hand #227145332585: Tournament #3203262490, $27.40+$2.60 USD Hold'em No Limit - Level IX (200/400) - 2021/05/29 1:27:37 MSK [2021/05/28 18:27:37 ET]
Table '3203262490 1' 9-max Seat #4 is the button
Seat 4: dimetruk (6489 in chips)
Seat 8: CadMonkey82 (7011 in chips)
dimetruk: posts the ante 25
CadMonkey82: posts the ante 25
dimetruk: posts small blind 200
CadMonkey82: posts big blind 400
*** HOLE CARDS ***
Dealt to dimetruk [2h 2d]
dimetruk: raises 6064 to 6464 and is all-in
CadMonkey82: calls 6064
*** FLOP *** [As Jh Jc]
*** TURN *** [As Jh Jc] [3c]
*** RIVER *** [As Jh Jc 3c] [7h]
*** SHOW DOWN ***
CadMonkey82: shows [Tc Ts] (two pair, Jacks and Tens)
dimetruk: shows [2h 2d] (two pair, Jacks and Deuces)
CadMonkey82 collected 12978 from pot
dimetruk finished the tournament in 2nd place and received $73.98.
CadMonkey82 wins the tournament and receives $123.30 - congratulations!
*** SUMMARY ***
Total pot 12978 | Rake 0
Board [As Jh Jc 3c 7h]
Seat 4: dimetruk (button) (small blind) showed [2h 2d] and lost with two pair, Jacks and Deuces
Seat 8: CadMonkey82 (big blind) showed [Tc Ts] and won (12978) with two pair, Jacks and Tens


PokerStars Hand #227142992215: Tournament #3203287977, $27.58+$2.42 USD Hold'em No Limit - Level I (10/20) - 2021/05/29 0:10:35 MSK [2021/05/28 17:10:35 ET]
Table '3203287977 1' 6-max Seat #2 is the button
Seat 1: Xram_NL (1915 in chips)
Seat 2: dimetruk (1397 in chips)
Seat 3: Kommersant K (1197 in chips)
Seat 4: judge_dreggel (1497 in chips)
Seat 5: asuregohon (1497 in chips)
Seat 6: tratorpoker (1497 in chips)
Xram_NL: posts the ante 3
dimetruk: posts the ante 3
Kommersant K: posts the ante 3
judge_dreggel: posts the ante 3
asuregohon: posts the ante 3
tratorpoker: posts the ante 3
Kommersant K: posts small blind 10
judge_dreggel: posts big blind 20
*** HOLE CARDS ***
Dealt to dimetruk [Kd 7d]
asuregohon: folds
tratorpoker: folds
Xram_NL: folds
dimetruk: raises 20 to 40
Kommersant K: folds
judge_dreggel: calls 20
*** FLOP *** [8d Tc Ad]
judge_dreggel: checks
dimetruk: bets 38
judge_dreggel: calls 38
*** TURN *** [8d Tc Ad] [As]
judge_dreggel: bets 92
dimetruk: calls 92
*** RIVER *** [8d Tc Ad As] [Qh]
judge_dreggel: checks
dimetruk: checks
*** SHOW DOWN ***
judge_dreggel: shows [Jd 8c] (two pair, Aces and Eights)
dimetruk: mucks hand
judge_dreggel collected 368 from pot
*** SUMMARY ***
Total pot 368 | Rake 0
Board [8d Tc Ad As Qh]
Seat 1: Xram_NL folded before Flop (didn't bet)
Seat 2: dimetruk (button) mucked [Kd 7d]
Seat 3: Kommersant K (small blind) folded before Flop
Seat 4: judge_dreggel (big blind) showed [Jd 8c] and won (368) with two pair, Aces and Eights
Seat 5: asuregohon folded before Flop (didn't bet)
Seat 6: tratorpoker folded before Flop (didn't bet)


PokerStars Hand #227143067588: Tournament #3203287977, $27.58+$2.42 USD Hold'em No Limit - Level I (10/20) - 2021/05/29 0:12:52 MSK [2021/05/28 17:12:52 ET]
Table '3203287977 1' 6-max Seat #4 is the button
Seat 1: Xram_NL (1909 in chips)
Seat 2: dimetruk (1221 in chips)
Seat 3: Kommersant K (1181 in chips)
Seat 4: judge_dreggel (1679 in chips)
Seat 5: asuregohon (1171 in chips)
Seat 6: tratorpoker (1839 in chips)
Xram_NL: posts the ante 3
dimetruk: posts the ante 3
Kommersant K: posts the ante 3
judge_dreggel: posts the ante 3
asuregohon: posts the ante 3
tratorpoker: posts the ante 3
asuregohon: posts small blind 10
tratorpoker: posts big blind 20
*** HOLE CARDS ***
Dealt to dimetruk [Js Jc]
Xram_NL: folds
dimetruk: raises 20 to 40
Kommersant K: folds
judge_dreggel: folds
asuregohon: folds
tratorpoker: calls 20
*** FLOP *** [8s Th 5s]
tratorpoker: checks
dimetruk: bets 72
tratorpoker: folds
Uncalled bet (72) returned to dimetruk
dimetruk collected 108 from pot
dimetruk: doesn't show hand
*** SUMMARY ***
Total pot 108 | Rake 0
Board [8s Th 5s]
Seat 1: Xram_NL folded before Flop (didn't bet)
Seat 2: dimetruk collected (108)
Seat 3: Kommersant K folded before Flop (didn't bet)
Seat 4: judge_dreggel (button) folded before Flop (didn't bet)
Seat 5: asuregohon (small blind) folded before Flop
Seat 6: tratorpoker (big blind) folded on the Flop


PokerStars Hand #227143124903: Tournament #3203287977, $27.58+$2.42 USD Hold'em No Limit - Level I (10/20) - 2021/05/29 0:14:26 MSK [2021/05/28 17:14:26 ET]
Table '3203287977 1' 6-max Seat #6 is the button
Seat 1: Xram_NL (1971 in chips)
Seat 2: dimetruk (1283 in chips)
Seat 3: Kommersant K (1175 in chips)
Seat 4: judge_dreggel (1633 in chips)
Seat 5: asuregohon (1155 in chips)
Seat 6: tratorpoker (1783 in chips)
Xram_NL: posts the ante 3
dimetruk: posts the ante 3
Kommersant K: posts the ante 3
judge_dreggel: posts the ante 3
asuregohon: posts the ante 3
tratorpoker: posts the ante 3
Xram_NL: posts small blind 10
dimetruk: posts big blind 20
*** HOLE CARDS ***
Dealt to dimetruk [Ks Ah]
Kommersant K: folds
judge_dreggel: folds
asuregohon: folds
tratorpoker: raises 24 to 44
Xram_NL: folds
dimetruk: calls 24
*** FLOP *** [7c Jc Ad]
dimetruk: checks
tratorpoker: checks
*** TURN *** [7c Jc Ad] [Kd]
dimetruk: bets 78
tratorpoker: calls 78
*** RIVER *** [7c Jc Ad Kd] [3c]
dimetruk: bets 182
tratorpoker: folds
Uncalled bet (182) returned to dimetruk
dimetruk collected 272 from pot
dimetruk: doesn't show hand
*** SUMMARY ***
Total pot 272 | Rake 0
Board [7c Jc Ad Kd 3c]
Seat 1: Xram_NL (small blind) folded before Flop
Seat 2: dimetruk (big blind) collected (272)
Seat 3: Kommersant K folded before Flop (didn't bet)
Seat 4: judge_dreggel folded before Flop (didn't bet)
Seat 5: asuregohon folded before Flop (didn't bet)
Seat 6: tratorpoker (button) folded on the River


PokerStars Hand #227143202001: Tournament #3203287977, $27.58+$2.42 USD Hold'em No Limit - Level I (10/20) - 2021/05/29 0:16:49 MSK [2021/05/28 17:16:49 ET]
Table '3203287977 1' 6-max Seat #5 is the button
Seat 1: Xram_NL (2014 in chips)
Seat 2: dimetruk (1408 in chips)
Seat 3: Kommersant K (1256 in chips)
Seat 4: judge_dreggel (1588 in chips)
Seat 5: asuregohon (1138 in chips)
Seat 6: tratorpoker (1596 in chips)
Xram_NL: posts the ante 3
dimetruk: posts the ante 3
Kommersant K: posts the ante 3
judge_dreggel: posts the ante 3
asuregohon: posts the ante 3
tratorpoker: posts the ante 3
tratorpoker: posts small blind 10
Xram_NL: posts big blind 20
*** HOLE CARDS ***
Dealt to dimetruk [4c 4d]
dimetruk: raises 20 to 40
Kommersant K: folds
judge_dreggel: raises 70 to 110
asuregohon: folds
tratorpoker: folds
Xram_NL: folds
dimetruk: calls 70
*** FLOP *** [Qh 7d Tc]
dimetruk: checks
judge_dreggel: bets 134
dimetruk: folds
Uncalled bet (134) returned to judge_dreggel
judge_dreggel collected 268 from pot
judge_dreggel: doesn't show hand
*** SUMMARY ***
Total pot 268 | Rake 0
Board [Qh 7d Tc]
Seat 1: Xram_NL (big blind) folded before Flop
Seat 2: dimetruk folded on the Flop
Seat 3: Kommersant K folded before Flop (didn't bet)
Seat 4: judge_dreggel collected (268)
Seat 5: asuregohon (button) folded before Flop (didn't bet)
Seat 6: tratorpoker (small blind) folded before Flop


PokerStars Hand #227143225680: Tournament #3203287977, $27.58+$2.42 USD Hold'em No Limit - Level I (10/20) - 2021/05/29 0:17:33 MSK [2021/05/28 17:17:33 ET]
Table '3203287977 1' 6-max Seat #6 is the button
Seat 1: Xram_NL (1991 in chips)
Seat 2: dimetruk (1295 in chips)
Seat 3: Kommersant K (1253 in chips)
Seat 4: judge_dreggel (1743 in chips)
Seat 5: asuregohon (1135 in chips)
Seat 6: tratorpoker (1583 in chips)
Xram_NL: posts the ante 3
dimetruk: posts the ante 3
Kommersant K: posts the ante 3
judge_dreggel: posts the ante 3
asuregohon: posts the ante 3
tratorpoker: posts the ante 3
Xram_NL: posts small blind 10
dimetruk: posts big blind 20
*** HOLE CARDS ***
Dealt to dimetruk [Kc 5d]
Kommersant K: folds
judge_dreggel: raises 40 to 60
asuregohon: folds
tratorpoker: folds
Xram_NL: folds
dimetruk: calls 40
*** FLOP *** [7c 9c 6c]
dimetruk: checks
judge_dreggel: checks
*** TURN *** [7c 9c 6c] [4s]
dimetruk: bets 74
judge_dreggel: calls 74
*** RIVER *** [7c 9c 6c 4s] [Jd]
dimetruk: bets 198
judge_dreggel: raises 346 to 544
dimetruk: folds
Uncalled bet (346) returned to judge_dreggel
judge_dreggel collected 692 from pot
judge_dreggel: doesn't show hand
*** SUMMARY ***
Total pot 692 | Rake 0
Board [7c 9c 6c 4s Jd]
Seat 1: Xram_NL (small blind) folded before Flop
Seat 2: dimetruk (big blind) folded on the River
Seat 3: Kommersant K folded before Flop (didn't bet)
Seat 4: judge_dreggel collected (692)
Seat 5: asuregohon folded before Flop (didn't bet)
Seat 6: tratorpoker (button) folded before Flop (didn't bet)


PokerStars Hand #227143388840: Tournament #3203287977, $27.58+$2.42 USD Hold'em No Limit - Level II (15/30) - 2021/05/29 0:22:36 MSK [2021/05/28 17:22:36 ET]
Table '3203287977 1' 6-max Seat #6 is the button
Seat 1: Xram_NL (1885 in chips)
Seat 2: dimetruk (932 in chips)
Seat 3: Kommersant K (1256 in chips)
Seat 4: judge_dreggel (1681 in chips)
Seat 5: asuregohon (1198 in chips)
Seat 6: tratorpoker (2048 in chips)
Xram_NL: posts the ante 4
dimetruk: posts the ante 4
Kommersant K: posts the ante 4
judge_dreggel: posts the ante 4
asuregohon: posts the ante 4
tratorpoker: posts the ante 4
Xram_NL: posts small blind 15
dimetruk: posts big blind 30
*** HOLE CARDS ***
Dealt to dimetruk [4d 6c]
Kommersant K: folds
judge_dreggel: raises 30 to 60
asuregohon: folds
tratorpoker: folds
Xram_NL: folds
dimetruk: calls 30
*** FLOP *** [Ac 3d 5h]
dimetruk: checks
judge_dreggel: bets 79
dimetruk: calls 79
*** TURN *** [Ac 3d 5h] [6d]
dimetruk: checks
judge_dreggel: checks
*** RIVER *** [Ac 3d 5h 6d] [Jc]
dimetruk: bets 159
judge_dreggel: folds
Uncalled bet (159) returned to dimetruk
dimetruk collected 317 from pot
dimetruk: doesn't show hand
*** SUMMARY ***
Total pot 317 | Rake 0
Board [Ac 3d 5h 6d Jc]
Seat 1: Xram_NL (small blind) folded before Flop
Seat 2: dimetruk (big blind) collected (317)
Seat 3: Kommersant K folded before Flop (didn't bet)
Seat 4: judge_dreggel folded on the River
Seat 5: asuregohon folded before Flop (didn't bet)
Seat 6: tratorpoker (button) folded before Flop (didn't bet)


PokerStars Hand #227143567043: Tournament #3203287977, $27.58+$2.42 USD Hold'em No Limit - Level II (15/30) - 2021/05/29 0:27:47 MSK [2021/05/28 17:27:47 ET]
Table '3203287977 1' 6-max Seat #6 is the button
Seat 1: Xram_NL (1756 in chips)
Seat 2: dimetruk (1071 in chips)
Seat 3: Kommersant K (941 in chips)
Seat 4: judge_dreggel (1062 in chips)
Seat 5: asuregohon (1852 in chips)
Seat 6: tratorpoker (2318 in chips)
Xram_NL: posts the ante 4
dimetruk: posts the ante 4
Kommersant K: posts the ante 4
judge_dreggel: posts the ante 4
asuregohon: posts the ante 4
tratorpoker: posts the ante 4
Xram_NL: posts small blind 15
dimetruk: posts big blind 30
*** HOLE CARDS ***
Dealt to dimetruk [Kc 6s]
Kommersant K: raises 30 to 60
judge_dreggel: folds
asuregohon: folds
tratorpoker: folds
Xram_NL: folds
dimetruk: calls 30
*** FLOP *** [4c Th Qs]
dimetruk: checks
Kommersant K: bets 40
dimetruk: folds
Uncalled bet (40) returned to Kommersant K
Kommersant K collected 159 from pot
Kommersant K: doesn't show hand
*** SUMMARY ***
Total pot 159 | Rake 0
Board [4c Th Qs]
Seat 1: Xram_NL (small blind) folded before Flop
Seat 2: dimetruk (big blind) folded on the Flop
Seat 3: Kommersant K collected (159)
Seat 4: judge_dreggel folded before Flop (didn't bet)
Seat 5: asuregohon folded before Flop (didn't bet)
Seat 6: tratorpoker (button) folded before Flop (didn't bet)


PokerStars Hand #227143696082: Tournament #3203287977, $27.58+$2.42 USD Hold'em No Limit - Level III (25/50) - 2021/05/29 0:31:51 MSK [2021/05/28 17:31:51 ET]
Table '3203287977 1' 6-max Seat #6 is the button
Seat 1: Xram_NL (1661 in chips)
Seat 2: dimetruk (966 in chips)
Seat 4: judge_dreggel (1166 in chips)
Seat 5: asuregohon (2994 in chips)
Seat 6: tratorpoker (2213 in chips)
Xram_NL: posts the ante 6
dimetruk: posts the ante 6
judge_dreggel: posts the ante 6
asuregohon: posts the ante 6
tratorpoker: posts the ante 6
Xram_NL: posts small blind 25
dimetruk: posts big blind 50
*** HOLE CARDS ***
Dealt to dimetruk [9h Td]
judge_dreggel: raises 100 to 150
asuregohon: folds
tratorpoker: folds
Xram_NL: folds
dimetruk: calls 100
*** FLOP *** [Qd Js 6c]
dimetruk: checks
judge_dreggel: bets 177
dimetruk: raises 633 to 810 and is all-in
judge_dreggel: calls 633
*** TURN *** [Qd Js 6c] [4s]
*** RIVER *** [Qd Js 6c 4s] [8s]
*** SHOW DOWN ***
dimetruk: shows [9h Td] (a straight, Eight to Queen)
judge_dreggel: shows [Kc 9c] (high card King)
dimetruk collected 1975 from pot
*** SUMMARY ***
Total pot 1975 | Rake 0
Board [Qd Js 6c 4s 8s]
Seat 1: Xram_NL (small blind) folded before Flop
Seat 2: dimetruk (big blind) showed [9h Td] and won (1975) with a straight, Eight to Queen
Seat 4: judge_dreggel showed [Kc 9c] and lost with high card King
Seat 5: asuregohon folded before Flop (didn't bet)
Seat 6: tratorpoker (button) folded before Flop (didn't bet)


PokerStars Hand #227143765252: Tournament #3203287977, $27.58+$2.42 USD Hold'em No Limit - Level III (25/50) - 2021/05/29 0:34:03 MSK [2021/05/28 17:34:03 ET]
Table '3203287977 1' 6-max Seat #5 is the button
Seat 1: Xram_NL (1612 in chips)
Seat 2: dimetruk (2242 in chips)
Seat 4: judge_dreggel (107 in chips)
Seat 5: asuregohon (3000 in chips)
Seat 6: tratorpoker (2039 in chips)
Xram_NL: posts the ante 6
dimetruk: posts the ante 6
judge_dreggel: posts the ante 6
asuregohon: posts the ante 6
tratorpoker: posts the ante 6
tratorpoker: posts small blind 25
Xram_NL: posts big blind 50
*** HOLE CARDS ***
Dealt to dimetruk [3h 3s]
dimetruk: raises 50 to 100
judge_dreggel: raises 1 to 101 and is all-in
asuregohon: calls 101
tratorpoker: folds
Xram_NL: calls 51
dimetruk: calls 1
*** FLOP *** [8s Jh Ks]
Xram_NL: checks
dimetruk: checks
asuregohon: bets 250
Xram_NL: folds
dimetruk: folds
Uncalled bet (250) returned to asuregohon
*** TURN *** [8s Jh Ks] [Qd]
*** RIVER *** [8s Jh Ks Qd] [Th]
*** SHOW DOWN ***
judge_dreggel: shows [9s Qs] (a straight, Nine to King)
asuregohon: shows [Kd 7d] (a pair of Kings)
judge_dreggel collected 459 from pot
*** SUMMARY ***
Total pot 459 | Rake 0
Board [8s Jh Ks Qd Th]
Seat 1: Xram_NL (big blind) folded on the Flop
Seat 2: dimetruk folded on the Flop
Seat 4: judge_dreggel showed [9s Qs] and won (459) with a straight, Nine to King
Seat 5: asuregohon (button) showed [Kd 7d] and lost with a pair of Kings
Seat 6: tratorpoker (small blind) folded before Flop


PokerStars Hand #227143824671: Tournament #3203287977, $27.58+$2.42 USD Hold'em No Limit - Level III (25/50) - 2021/05/29 0:35:58 MSK [2021/05/28 17:35:58 ET]
Table '3203287977 1' 6-max Seat #2 is the button
Seat 1: Xram_NL (1673 in chips)
Seat 2: dimetruk (2048 in chips)
Seat 4: judge_dreggel (949 in chips)
Seat 5: asuregohon (2434 in chips)
Seat 6: tratorpoker (1896 in chips)
Xram_NL: posts the ante 6
dimetruk: posts the ante 6
judge_dreggel: posts the ante 6
asuregohon: posts the ante 6
tratorpoker: posts the ante 6
judge_dreggel: posts small blind 25
asuregohon: posts big blind 50
*** HOLE CARDS ***
Dealt to dimetruk [Th Ac]
tratorpoker: folds
Xram_NL: raises 50 to 100
dimetruk: raises 200 to 300
judge_dreggel: folds
asuregohon: calls 250
Xram_NL: folds
*** FLOP *** [8d Ts 7d]
asuregohon: bets 400
dimetruk: raises 1342 to 1742 and is all-in
asuregohon: calls 1342
*** TURN *** [8d Ts 7d] [4s]
*** RIVER *** [8d Ts 7d 4s] [4d]
*** SHOW DOWN ***
asuregohon: shows [8c 8s] (a full house, Eights full of Fours)
dimetruk: shows [Th Ac] (two pair, Tens and Fours)
asuregohon collected 4239 from pot
dimetruk finished the tournament in 5th place
*** SUMMARY ***
Total pot 4239 | Rake 0
Board [8d Ts 7d 4s 4d]
Seat 1: Xram_NL folded before Flop
Seat 2: dimetruk (button) showed [Th Ac] and lost with two pair, Tens and Fours
Seat 4: judge_dreggel (small blind) folded before Flop
Seat 5: asuregohon (big blind) showed [8c 8s] and won (4239) with a full house, Eights full of Fours
Seat 6: tratorpoker folded before Flop (didn't bet)


PokerStars Hand #227190773868: Tournament #3203890226, $13.70+$1.30 USD Hold'em No Limit - Level I (10/20) - 2021/05/30 19:40:20 MSK [2021/05/30 12:40:20 ET]
Table '3203890226 2' 9-max Seat #3 is the button
Seat 1: hmw_01 (1494 in chips)
Seat 2: scottsedi (2498 in chips)
Seat 3: TheHulk7 (1464 in chips)
Seat 4: Slav1n82 (1394 in chips)
Seat 5: dimetruk (1494 in chips)
Seat 6: RedRafflesia (1494 in chips)
Seat 7: Choof7777 (1494 in chips)
Seat 8: 777forty777 (794 in chips)
Seat 9: hansbolle (1374 in chips)
hmw_01: posts the ante 3
scottsedi: posts the ante 3
TheHulk7: posts the ante 3
Slav1n82: posts the ante 3
dimetruk: posts the ante 3
RedRafflesia: posts the ante 3
Choof7777: posts the ante 3
777forty777: posts the ante 3
hansbolle: posts the ante 3
Slav1n82: posts small blind 10
dimetruk: posts big blind 20
*** HOLE CARDS ***
Dealt to dimetruk [8h Qh]
RedRafflesia: folds
Choof7777: raises 20 to 40
777forty777: folds
hansbolle: folds
hmw_01: folds
scottsedi: calls 40
TheHulk7: folds
Slav1n82: calls 30
dimetruk: calls 20
*** FLOP *** [9s As 9d]
Slav1n82: checks
dimetruk: checks
Choof7777: bets 94
scottsedi: folds
Slav1n82: calls 94
dimetruk: folds
*** TURN *** [9s As 9d] [Ts]
Slav1n82: checks
Choof7777: checks
*** RIVER *** [9s As 9d Ts] [5d]
Slav1n82: bets 480
Choof7777: calls 480
*** SHOW DOWN ***
Slav1n82: shows [9c 7c] (three of a kind, Nines)
Choof7777: shows [9h Jc] (three of a kind, Nines - Ace+Jack kicker)
Choof7777 collected 1335 from pot
*** SUMMARY ***
Total pot 1335 | Rake 0
Board [9s As 9d Ts 5d]
Seat 1: hmw_01 folded before Flop (didn't bet)
Seat 2: scottsedi folded on the Flop
Seat 3: TheHulk7 (button) folded before Flop (didn't bet)
Seat 4: Slav1n82 (small blind) showed [9c 7c] and lost with three of a kind, Nines
Seat 5: dimetruk (big blind) folded on the Flop
Seat 6: RedRafflesia folded before Flop (didn't bet)
Seat 7: Choof7777 showed [9h Jc] and won (1335) with three of a kind, Nines
Seat 8: 777forty777 folded before Flop (didn't bet)
Seat 9: hansbolle folded before Flop (didn't bet)


PokerStars Hand #227190808432: Tournament #3203890226, $13.70+$1.30 USD Hold'em No Limit - Level I (10/20) - 2021/05/30 19:41:31 MSK [2021/05/30 12:41:31 ET]
Table '3203890226 2' 9-max Seat #4 is the button
Seat 1: hmw_01 (1491 in chips)
Seat 2: scottsedi (2455 in chips)
Seat 3: TheHulk7 (1461 in chips)
Seat 4: Slav1n82 (777 in chips)
Seat 5: dimetruk (1451 in chips)
Seat 6: RedRafflesia (1491 in chips)
Seat 7: Choof7777 (2212 in chips)
Seat 8: 777forty777 (791 in chips)
Seat 9: hansbolle (1371 in chips)
hmw_01: posts the ante 3
scottsedi: posts the ante 3
TheHulk7: posts the ante 3
Slav1n82: posts the ante 3
dimetruk: posts the ante 3
RedRafflesia: posts the ante 3
Choof7777: posts the ante 3
777forty777: posts the ante 3
hansbolle: posts the ante 3
dimetruk: posts small blind 10
RedRafflesia: posts big blind 20
*** HOLE CARDS ***
Dealt to dimetruk [4h 4s]
Choof7777: folds
777forty777: calls 20
hansbolle: folds
hmw_01: folds
scottsedi: calls 20
TheHulk7: folds
Slav1n82: folds
dimetruk: calls 10
RedRafflesia: checks
*** FLOP *** [5s 9c 5h]
dimetruk: checks
RedRafflesia: checks
777forty777: checks
scottsedi: bets 100
dimetruk: folds
RedRafflesia: folds
777forty777: folds
Uncalled bet (100) returned to scottsedi
scottsedi collected 107 from pot
scottsedi: doesn't show hand
*** SUMMARY ***
Total pot 107 | Rake 0
Board [5s 9c 5h]
Seat 1: hmw_01 folded before Flop (didn't bet)
Seat 2: scottsedi collected (107)
Seat 3: TheHulk7 folded before Flop (didn't bet)
Seat 4: Slav1n82 (button) folded before Flop (didn't bet)
Seat 5: dimetruk (small blind) folded on the Flop
Seat 6: RedRafflesia (big blind) folded on the Flop
Seat 7: Choof7777 folded before Flop (didn't bet)
Seat 8: 777forty777 folded on the Flop
Seat 9: hansbolle folded before Flop (didn't bet)


PokerStars Hand #227190923550: Tournament #3203890226, $13.70+$1.30 USD Hold'em No Limit - Level I (10/20) - 2021/05/30 19:45:26 MSK [2021/05/30 12:45:26 ET]
Table '3203890226 2' 9-max Seat #7 is the button
Seat 1: hmw_01 (1482 in chips)
Seat 2: scottsedi (2561 in chips)
Seat 3: TheHulk7 (1452 in chips)
Seat 4: Slav1n82 (768 in chips)
Seat 5: dimetruk (1422 in chips)
Seat 6: RedRafflesia (1452 in chips)
Seat 7: Choof7777 (2538 in chips)
Seat 8: 777forty777 (463 in chips)
Seat 9: hansbolle (1362 in chips)
hmw_01: posts the ante 3
scottsedi: posts the ante 3
TheHulk7: posts the ante 3
Slav1n82: posts the ante 3
dimetruk: posts the ante 3
RedRafflesia: posts the ante 3
Choof7777: posts the ante 3
777forty777: posts the ante 3
hansbolle: posts the ante 3
777forty777: posts small blind 10
hansbolle: posts big blind 20
*** HOLE CARDS ***
Dealt to dimetruk [Qs Qd]
hmw_01: folds
scottsedi: calls 20
TheHulk7: folds
Slav1n82: folds
dimetruk: raises 40 to 60
RedRafflesia: folds
Choof7777: folds
777forty777: calls 50
hansbolle: folds
scottsedi: calls 40
*** FLOP *** [Jh 3c Kh]
777forty777: bets 60
scottsedi: folds
dimetruk: calls 60
*** TURN *** [Jh 3c Kh] [Ah]
777forty777: checks
dimetruk: checks
*** RIVER *** [Jh 3c Kh Ah] [8s]
777forty777: checks
dimetruk: checks
*** SHOW DOWN ***
777forty777: shows [Ks 4s] (a pair of Kings)
dimetruk: mucks hand
777forty777 collected 347 from pot
*** SUMMARY ***
Total pot 347 | Rake 0
Board [Jh 3c Kh Ah 8s]
Seat 1: hmw_01 folded before Flop (didn't bet)
Seat 2: scottsedi folded on the Flop
Seat 3: TheHulk7 folded before Flop (didn't bet)
Seat 4: Slav1n82 folded before Flop (didn't bet)
Seat 5: dimetruk mucked [Qs Qd]
Seat 6: RedRafflesia folded before Flop (didn't bet)
Seat 7: Choof7777 (button) folded before Flop (didn't bet)
Seat 8: 777forty777 (small blind) showed [Ks 4s] and won (347) with a pair of Kings
Seat 9: hansbolle (big blind) folded before Flop


PokerStars Hand #227191041854: Tournament #3203890226, $13.70+$1.30 USD Hold'em No Limit - Level II (15/30) - 2021/05/30 19:49:14 MSK [2021/05/30 12:49:14 ET]
Table '3203890226 2' 9-max Seat #2 is the button
Seat 1: hmw_01 (1544 in chips)
Seat 2: scottsedi (2823 in chips)
Seat 3: TheHulk7 (1348 in chips)
Seat 4: Slav1n82 (754 in chips)
Seat 5: dimetruk (1288 in chips)
Seat 6: RedRafflesia (1674 in chips)
Seat 7: Choof7777 (2225 in chips)
Seat 8: 777forty777 (526 in chips)
Seat 9: hansbolle (1318 in chips)
hmw_01: posts the ante 4
scottsedi: posts the ante 4
TheHulk7: posts the ante 4
Slav1n82: posts the ante 4
dimetruk: posts the ante 4
RedRafflesia: posts the ante 4
Choof7777: posts the ante 4
777forty777: posts the ante 4
hansbolle: posts the ante 4
TheHulk7: posts small blind 15
Slav1n82: posts big blind 30
*** HOLE CARDS ***
Dealt to dimetruk [Ah As]
dimetruk: raises 30 to 60
RedRafflesia: folds
Choof7777: calls 60
777forty777: folds
hansbolle: folds
hmw_01: folds
scottsedi: folds
TheHulk7: calls 45
Slav1n82: calls 30
*** FLOP *** [3c Qd 8s]
TheHulk7: checks
Slav1n82: checks
dimetruk: bets 185
Choof7777: folds
TheHulk7: folds
Slav1n82: folds
Uncalled bet (185) returned to dimetruk
dimetruk collected 276 from pot
dimetruk: doesn't show hand
*** SUMMARY ***
Total pot 276 | Rake 0
Board [3c Qd 8s]
Seat 1: hmw_01 folded before Flop (didn't bet)
Seat 2: scottsedi (button) folded before Flop (didn't bet)
Seat 3: TheHulk7 (small blind) folded on the Flop
Seat 4: Slav1n82 (big blind) folded on the Flop
Seat 5: dimetruk collected (276)
Seat 6: RedRafflesia folded before Flop (didn't bet)
Seat 7: Choof7777 folded on the Flop
Seat 8: 777forty777 folded before Flop (didn't bet)
Seat 9: hansbolle folded before Flop (didn't bet)


PokerStars Hand #227191063626: Tournament #3203890226, $13.70+$1.30 USD Hold'em No Limit - Level II (15/30) - 2021/05/30 19:49:59 MSK [2021/05/30 12:49:59 ET]
Table '3203890226 2' 9-max Seat #3 is the button
Seat 1: hmw_01 (1540 in chips)
Seat 2: scottsedi (2819 in chips)
Seat 3: TheHulk7 (1284 in chips)
Seat 4: Slav1n82 (690 in chips)
Seat 5: dimetruk (1500 in chips)
Seat 6: RedRafflesia (1670 in chips)
Seat 7: Choof7777 (2161 in chips)
Seat 8: 777forty777 (522 in chips)
Seat 9: hansbolle (1314 in chips)
hmw_01: posts the ante 4
scottsedi: posts the ante 4
TheHulk7: posts the ante 4
Slav1n82: posts the ante 4
dimetruk: posts the ante 4
RedRafflesia: posts the ante 4
Choof7777: posts the ante 4
777forty777: posts the ante 4
hansbolle: posts the ante 4
Slav1n82: posts small blind 15
dimetruk: posts big blind 30
*** HOLE CARDS ***
Dealt to dimetruk [Th 2s]
RedRafflesia: folds
Choof7777: folds
777forty777: folds
hansbolle: folds
hmw_01: folds
scottsedi: folds
TheHulk7: folds
Slav1n82: calls 15
dimetruk: checks
*** FLOP *** [5h 3c Ad]
Slav1n82: checks
dimetruk: checks
*** TURN *** [5h 3c Ad] [4s]
Slav1n82: checks
dimetruk: bets 64
Slav1n82: folds
Uncalled bet (64) returned to dimetruk
dimetruk collected 96 from pot
dimetruk: doesn't show hand
*** SUMMARY ***
Total pot 96 | Rake 0
Board [5h 3c Ad 4s]
Seat 1: hmw_01 folded before Flop (didn't bet)
Seat 2: scottsedi folded before Flop (didn't bet)
Seat 3: TheHulk7 (button) folded before Flop (didn't bet)
Seat 4: Slav1n82 (small blind) folded on the Turn
Seat 5: dimetruk (big blind) collected (96)
Seat 6: RedRafflesia folded before Flop (didn't bet)
Seat 7: Choof7777 folded before Flop (didn't bet)
Seat 8: 777forty777 folded before Flop (didn't bet)
Seat 9: hansbolle folded before Flop (didn't bet)


PokerStars Hand #227191146015: Tournament #3203890226, $13.70+$1.30 USD Hold'em No Limit - Level II (15/30) - 2021/05/30 19:52:49 MSK [2021/05/30 12:52:49 ET]
Table '3203890226 2' 9-max Seat #6 is the button
Seat 1: hmw_01 (1528 in chips)
Seat 2: scottsedi (3471 in chips)
Seat 3: TheHulk7 (1272 in chips)
Seat 4: Slav1n82 (588 in chips)
Seat 5: dimetruk (1539 in chips)
Seat 6: RedRafflesia (1613 in chips)
Seat 7: Choof7777 (1898 in chips)
Seat 8: 777forty777 (289 in chips)
Seat 9: hansbolle (1302 in chips)
hmw_01: posts the ante 4
scottsedi: posts the ante 4
TheHulk7: posts the ante 4
Slav1n82: posts the ante 4
dimetruk: posts the ante 4
RedRafflesia: posts the ante 4
Choof7777: posts the ante 4
777forty777: posts the ante 4
hansbolle: posts the ante 4
Choof7777: posts small blind 15
777forty777: posts big blind 30
*** HOLE CARDS ***
Dealt to dimetruk [9s 9h]
hansbolle: folds
hmw_01: folds
scottsedi: calls 30
TheHulk7: raises 75 to 105
Slav1n82: folds
dimetruk: calls 105
RedRafflesia: folds
Choof7777: folds
777forty777: raises 180 to 285 and is all-in
scottsedi: folds
TheHulk7: calls 180
dimetruk: calls 180
*** FLOP *** [Kc 5h 6s]
TheHulk7: bets 328
dimetruk: folds
Uncalled bet (328) returned to TheHulk7
*** TURN *** [Kc 5h 6s] [3c]
*** RIVER *** [Kc 5h 6s 3c] [Tc]
*** SHOW DOWN ***
777forty777: shows [Ac Ks] (a pair of Kings)
TheHulk7: shows [Ad As] (a pair of Aces)
TheHulk7 collected 936 from pot
777forty777 finished the tournament in 18th place
*** SUMMARY ***
Total pot 936 | Rake 0
Board [Kc 5h 6s 3c Tc]
Seat 1: hmw_01 folded before Flop (didn't bet)
Seat 2: scottsedi folded before Flop
Seat 3: TheHulk7 showed [Ad As] and won (936) with a pair of Aces
Seat 4: Slav1n82 folded before Flop (didn't bet)
Seat 5: dimetruk folded on the Flop
Seat 6: RedRafflesia (button) folded before Flop (didn't bet)
Seat 7: Choof7777 (small blind) folded before Flop
Seat 8: 777forty777 (big blind) showed [Ac Ks] and lost with a pair of Kings
Seat 9: hansbolle folded before Flop (didn't bet)


PokerStars Hand #227191206742: Tournament #3203890226, $13.70+$1.30 USD Hold'em No Limit - Level II (15/30) - 2021/05/30 19:54:54 MSK [2021/05/30 12:54:54 ET]
Table '3203890226 2' 9-max Seat #9 is the button
Seat 1: hmw_01 (1822 in chips)
Seat 2: scottsedi (3433 in chips)
Seat 3: TheHulk7 (1726 in chips)
Seat 4: Slav1n82 (580 in chips)
Seat 5: dimetruk (1246 in chips)
Seat 6: RedRafflesia (1605 in chips)
Seat 7: Choof7777 (1809 in chips)
Seat 9: hansbolle (1279 in chips)
hmw_01: posts the ante 4
scottsedi: posts the ante 4
TheHulk7: posts the ante 4
Slav1n82: posts the ante 4
dimetruk: posts the ante 4
RedRafflesia: posts the ante 4
Choof7777: posts the ante 4
hansbolle: posts the ante 4
hmw_01: posts small blind 15
scottsedi: posts big blind 30
*** HOLE CARDS ***
Dealt to dimetruk [Ks Qd]
TheHulk7: folds
Slav1n82: folds
dimetruk: raises 30 to 60
RedRafflesia: folds
Choof7777: calls 60
hansbolle: folds
hmw_01: folds
scottsedi: raises 60 to 120
dimetruk: calls 60
Choof7777: calls 60
*** FLOP *** [Qh Jc 6c]
scottsedi: checks
dimetruk: bets 142
Choof7777: calls 142
scottsedi: raises 608 to 750
dimetruk: folds
Choof7777: calls 608
*** TURN *** [Qh Jc 6c] [2h]
scottsedi: bets 2559 and is all-in
Choof7777: calls 935 and is all-in
Uncalled bet (1624) returned to scottsedi
*** RIVER *** [Qh Jc 6c 2h] [4s]
*** SHOW DOWN ***
scottsedi: shows [Ah Ac] (a pair of Aces)
Choof7777: shows [Tc Qc] (a pair of Queens)
scottsedi collected 3919 from pot
Choof7777 finished the tournament in 17th place
*** SUMMARY ***
Total pot 3919 | Rake 0
Board [Qh Jc 6c 2h 4s]
Seat 1: hmw_01 (small blind) folded before Flop
Seat 2: scottsedi (big blind) showed [Ah Ac] and won (3919) with a pair of Aces
Seat 3: TheHulk7 folded before Flop (didn't bet)
Seat 4: Slav1n82 folded before Flop (didn't bet)
Seat 5: dimetruk folded on the Flop
Seat 6: RedRafflesia folded before Flop (didn't bet)
Seat 7: Choof7777 showed [Tc Qc] and lost with a pair of Queens
Seat 9: hansbolle (button) folded before Flop (didn't bet)


PokerStars Hand #227191460125: Tournament #3203890226, $13.70+$1.30 USD Hold'em No Limit - Level III (25/50) - 2021/05/30 20:05:19 MSK [2021/05/30 13:05:19 ET]
Table '3203890226 2' 9-max Seat #4 is the button
Seat 1: hmw_01 (1470 in chips)
Seat 2: scottsedi (6877 in chips)
Seat 3: TheHulk7 (2382 in chips)
Seat 4: tuborg123456 (1698 in chips)
Seat 5: dimetruk (1183 in chips)
Seat 7: JayManthers (3220 in chips)
hmw_01: posts the ante 6
scottsedi: posts the ante 6
TheHulk7: posts the ante 6
tuborg123456: posts the ante 6
dimetruk: posts the ante 6
JayManthers: posts the ante 6
dimetruk: posts small blind 25
JayManthers: posts big blind 50
*** HOLE CARDS ***
Dealt to dimetruk [7h 8c]
hmw_01: folds
scottsedi: folds
TheHulk7: folds
tuborg123456: folds
dimetruk: raises 50 to 100
JayManthers: calls 50
*** FLOP *** [6c Jc 5c]
dimetruk: bets 118
JayManthers: calls 118
*** TURN *** [6c Jc 5c] [Kh]
dimetruk: checks
JayManthers: checks
*** RIVER *** [6c Jc 5c Kh] [Ad]
dimetruk: bets 300
JayManthers: folds
Uncalled bet (300) returned to dimetruk
dimetruk collected 472 from pot
dimetruk: doesn't show hand
*** SUMMARY ***
Total pot 472 | Rake 0
Board [6c Jc 5c Kh Ad]
Seat 1: hmw_01 folded before Flop (didn't bet)
Seat 2: scottsedi folded before Flop (didn't bet)
Seat 3: TheHulk7 folded before Flop (didn't bet)
Seat 4: tuborg123456 (button) folded before Flop (didn't bet)
Seat 5: dimetruk (small blind) collected (472)
Seat 7: JayManthers (big blind) folded on the River


PokerStars Hand #227191492330: Tournament #3203890226, $13.70+$1.30 USD Hold'em No Limit - Level III (25/50) - 2021/05/30 20:06:20 MSK [2021/05/30 13:06:20 ET]
Table '3203890226 2' 9-max Seat #5 is the button
Seat 1: hmw_01 (1464 in chips)
Seat 2: scottsedi (6871 in chips)
Seat 3: TheHulk7 (2376 in chips)
Seat 4: tuborg123456 (1692 in chips)
Seat 5: dimetruk (1431 in chips)
Seat 7: JayManthers (2996 in chips)
hmw_01: posts the ante 6
scottsedi: posts the ante 6
TheHulk7: posts the ante 6
tuborg123456: posts the ante 6
dimetruk: posts the ante 6
JayManthers: posts the ante 6
JayManthers: posts small blind 25
hmw_01: posts big blind 50
*** HOLE CARDS ***
Dealt to dimetruk [Ah 2h]
scottsedi: calls 50
TheHulk7: folds
tuborg123456: folds
dimetruk: raises 100 to 150
JayManthers: folds
hmw_01: folds
scottsedi: calls 100
*** FLOP *** [Kc Jc 6h]
scottsedi: checks
dimetruk: bets 200
scottsedi: calls 200
*** TURN *** [Kc Jc 6h] [5s]
scottsedi: checks
dimetruk: checks
*** RIVER *** [Kc Jc 6h 5s] [Jh]
scottsedi: bets 450
dimetruk: folds
Uncalled bet (450) returned to scottsedi
scottsedi collected 811 from pot
scottsedi: doesn't show hand
*** SUMMARY ***
Total pot 811 | Rake 0
Board [Kc Jc 6h 5s Jh]
Seat 1: hmw_01 (big blind) folded before Flop
Seat 2: scottsedi collected (811)
Seat 3: TheHulk7 folded before Flop (didn't bet)
Seat 4: tuborg123456 folded before Flop (didn't bet)
Seat 5: dimetruk (button) folded on the River
Seat 7: JayManthers (small blind) folded before Flop


PokerStars Hand #227191568974: Tournament #3203890226, $13.70+$1.30 USD Hold'em No Limit - Level IV (40/80) - 2021/05/30 20:08:45 MSK [2021/05/30 13:08:45 ET]
Table '3203890226 2' 9-max Seat #3 is the button
Seat 1: hmw_01 (1357 in chips)
Seat 2: scottsedi (7501 in chips)
Seat 3: TheHulk7 (2224 in chips)
Seat 4: tuborg123456 (1580 in chips)
Seat 5: dimetruk (1229 in chips)
Seat 7: JayManthers (2939 in chips)
hmw_01: posts the ante 10
scottsedi: posts the ante 10
TheHulk7: posts the ante 10
tuborg123456: posts the ante 10
dimetruk: posts the ante 10
JayManthers: posts the ante 10
tuborg123456: posts small blind 40
dimetruk: posts big blind 80
*** HOLE CARDS ***
Dealt to dimetruk [7h 3h]
JayManthers: raises 80 to 160
hmw_01: folds
scottsedi: calls 160
TheHulk7: folds
tuborg123456: folds
dimetruk: calls 80
*** FLOP *** [Jh 5s Ks]
dimetruk: checks
JayManthers: checks
scottsedi: bets 240
dimetruk: folds
JayManthers: folds
Uncalled bet (240) returned to scottsedi
scottsedi collected 580 from pot
scottsedi: doesn't show hand
*** SUMMARY ***
Total pot 580 | Rake 0
Board [Jh 5s Ks]
Seat 1: hmw_01 folded before Flop (didn't bet)
Seat 2: scottsedi collected (580)
Seat 3: TheHulk7 (button) folded before Flop (didn't bet)
Seat 4: tuborg123456 (small blind) folded before Flop
Seat 5: dimetruk (big blind) folded on the Flop
Seat 7: JayManthers folded on the Flop


PokerStars Hand #227191780252: Tournament #3203890226, $13.70+$1.30 USD Hold'em No Limit - Level IV (40/80) - 2021/05/30 20:14:55 MSK [2021/05/30 13:14:55 ET]
Table '3203890226 1' 9-max Seat #3 is the button
Seat 2: vacwiz (4491 in chips)
Seat 3: kenazx18 (2177 in chips)
Seat 4: jasonoleary2 (2663 in chips)
Seat 5: dimetruk (1139 in chips)
Seat 8: jeka080685 (669 in chips)
vacwiz: posts the ante 10
kenazx18: posts the ante 10
jasonoleary2: posts the ante 10
dimetruk: posts the ante 10
jeka080685: posts the ante 10
jasonoleary2: posts small blind 40
dimetruk: posts big blind 80
*** HOLE CARDS ***
Dealt to dimetruk [8d 8c]
jeka080685: raises 579 to 659 and is all-in
vacwiz: folds
kenazx18: calls 659
jasonoleary2: folds
dimetruk: raises 470 to 1129 and is all-in
kenazx18: calls 470
*** FLOP *** [Kc Qh Qc]
*** TURN *** [Kc Qh Qc] [Th]
*** RIVER *** [Kc Qh Qc Th] [7d]
*** SHOW DOWN ***
dimetruk: shows [8d 8c] (two pair, Queens and Eights)
kenazx18: shows [Td As] (two pair, Queens and Tens)
kenazx18 collected 940 from side pot
jeka080685: shows [Qd Ks] (a full house, Queens full of Kings)
jeka080685 collected 2067 from main pot
dimetruk finished the tournament in 10th place
*** SUMMARY ***
Total pot 3007 Main pot 2067. Side pot 940. | Rake 0
Board [Kc Qh Qc Th 7d]
Seat 2: vacwiz folded before Flop (didn't bet)
Seat 3: kenazx18 (button) showed [Td As] and won (940) with two pair, Queens and Tens
Seat 4: jasonoleary2 (small blind) folded before Flop
Seat 5: dimetruk (big blind) showed [8d 8c] and lost with two pair, Queens and Eights
Seat 8: jeka080685 showed [Qd Ks] and won (2067) with a full house, Queens full of Kings


PokerStars Hand #227179707140: Tournament #3204122579, $13.79+$1.21 USD Hold'em No Limit - Level I (10/20) - 2021/05/30 8:17:55 MSK [2021/05/30 1:17:55 ET]
Table '3204122579 1' 6-max Seat #6 is the button
Seat 1: mishanya_pim (1428 in chips)
Seat 2: wellwell27 (1608 in chips)
Seat 3: mt99808 (3003 in chips)
Seat 4: dimetruk (1503 in chips)
Seat 6: thedisik (1458 in chips)
mishanya_pim: posts the ante 3
wellwell27: posts the ante 3
mt99808: posts the ante 3
dimetruk: posts the ante 3
thedisik: posts the ante 3
mishanya_pim: posts small blind 10
wellwell27: posts big blind 20
*** HOLE CARDS ***
Dealt to dimetruk [Qc Jc]
mt99808: folds
dimetruk: raises 20 to 40
thedisik: folds
mishanya_pim: folds
wellwell27: raises 105 to 145
dimetruk: calls 105
*** FLOP *** [Ac As 5h]
wellwell27: bets 315
dimetruk: folds
Uncalled bet (315) returned to wellwell27
wellwell27 collected 315 from pot
wellwell27: doesn't show hand
*** SUMMARY ***
Total pot 315 | Rake 0
Board [Ac As 5h]
Seat 1: mishanya_pim (small blind) folded before Flop
Seat 2: wellwell27 (big blind) collected (315)
Seat 3: mt99808 folded before Flop (didn't bet)
Seat 4: dimetruk folded on the Flop
Seat 6: thedisik (button) folded before Flop (didn't bet)


PokerStars Hand #227179721145: Tournament #3204122579, $13.79+$1.21 USD Hold'em No Limit - Level I (10/20) - 2021/05/30 8:19:18 MSK [2021/05/30 1:19:18 ET]
Table '3204122579 1' 6-max Seat #2 is the button
Seat 1: mishanya_pim (1368 in chips)
Seat 2: wellwell27 (1875 in chips)
Seat 3: mt99808 (2953 in chips)
Seat 4: dimetruk (1352 in chips)
Seat 6: thedisik (1452 in chips)
mishanya_pim: posts the ante 3
wellwell27: posts the ante 3
mt99808: posts the ante 3
dimetruk: posts the ante 3
thedisik: posts the ante 3
mt99808: posts small blind 10
dimetruk: posts big blind 20
*** HOLE CARDS ***
Dealt to dimetruk [4s 7h]
thedisik: raises 22 to 42
mishanya_pim: folds
wellwell27: calls 42
mt99808: folds
dimetruk: calls 22
*** FLOP *** [8d Js Kd]
dimetruk: checks
thedisik: checks
wellwell27: bets 151
dimetruk: folds
thedisik: folds
Uncalled bet (151) returned to wellwell27
wellwell27 collected 151 from pot
wellwell27: doesn't show hand
*** SUMMARY ***
Total pot 151 | Rake 0
Board [8d Js Kd]
Seat 1: mishanya_pim folded before Flop (didn't bet)
Seat 2: wellwell27 (button) collected (151)
Seat 3: mt99808 (small blind) folded before Flop
Seat 4: dimetruk (big blind) folded on the Flop
Seat 6: thedisik folded on the Flop


PokerStars Hand #227179745346: Tournament #3204122579, $13.79+$1.21 USD Hold'em No Limit - Level I (10/20) - 2021/05/30 8:21:42 MSK [2021/05/30 1:21:42 ET]
Table '3204122579 1' 6-max Seat #2 is the button
Seat 1: mishanya_pim (1368 in chips)
Seat 2: wellwell27 (2201 in chips)
Seat 3: mt99808 (2823 in chips)
Seat 4: dimetruk (1285 in chips)
Seat 6: thedisik (1323 in chips)
mishanya_pim: posts the ante 3
wellwell27: posts the ante 3
mt99808: posts the ante 3
dimetruk: posts the ante 3
thedisik: posts the ante 3
mt99808: posts small blind 10
dimetruk: posts big blind 20
*** HOLE CARDS ***
Dealt to dimetruk [8c 2d]
thedisik: folds
mishanya_pim: raises 40 to 60
wellwell27: calls 60
mt99808: folds
dimetruk: calls 40
*** FLOP *** [Ac 8d 3h]
dimetruk: checks
mishanya_pim: bets 135
wellwell27: calls 135
dimetruk: folds
*** TURN *** [Ac 8d 3h] [4s]
mishanya_pim: bets 285
wellwell27: raises 523 to 808
mishanya_pim: raises 362 to 1170 and is all-in
wellwell27: calls 362
*** RIVER *** [Ac 8d 3h 4s] [8h]
*** SHOW DOWN ***
mishanya_pim: shows [Ks Ah] (two pair, Aces and Eights)
wellwell27: shows [4h 3c] (two pair, Eights and Fours)
mishanya_pim collected 2815 from pot
*** SUMMARY ***
Total pot 2815 | Rake 0
Board [Ac 8d 3h 4s 8h]
Seat 1: mishanya_pim showed [Ks Ah] and won (2815) with two pair, Aces and Eights
Seat 2: wellwell27 (button) showed [4h 3c] and lost with two pair, Eights and Fours
Seat 3: mt99808 (small blind) folded before Flop
Seat 4: dimetruk (big blind) folded on the Flop
Seat 6: thedisik folded before Flop (didn't bet)


PokerStars Hand #227179793846: Tournament #3204122579, $13.79+$1.21 USD Hold'em No Limit - Level II (15/30) - 2021/05/30 8:26:20 MSK [2021/05/30 1:26:20 ET]
Table '3204122579 1' 6-max Seat #6 is the button
Seat 1: mishanya_pim (3629 in chips)
Seat 3: mt99808 (2902 in chips)
Seat 4: dimetruk (1244 in chips)
Seat 6: thedisik (1225 in chips)
mishanya_pim: posts the ante 4
mt99808: posts the ante 4
dimetruk: posts the ante 4
thedisik: posts the ante 4
mishanya_pim: posts small blind 15
mt99808: posts big blind 30
*** HOLE CARDS ***
Dealt to dimetruk [4d 4c]
dimetruk: raises 30 to 60
thedisik: folds
mishanya_pim: folds
mt99808: calls 30
*** FLOP *** [8c 9d 3d]
mt99808: checks
dimetruk: bets 76
mt99808: raises 164 to 240
dimetruk: folds
Uncalled bet (164) returned to mt99808
mt99808 collected 303 from pot
mt99808: doesn't show hand
*** SUMMARY ***
Total pot 303 | Rake 0
Board [8c 9d 3d]
Seat 1: mishanya_pim (small blind) folded before Flop
Seat 3: mt99808 (big blind) collected (303)
Seat 4: dimetruk folded on the Flop
Seat 6: thedisik (button) folded before Flop (didn't bet)


PokerStars Hand #227179863258: Tournament #3204122579, $13.79+$1.21 USD Hold'em No Limit - Level II (15/30) - 2021/05/30 8:32:15 MSK [2021/05/30 1:32:15 ET]
Table '3204122579 1' 6-max Seat #1 is the button
Seat 1: mishanya_pim (3671 in chips)
Seat 3: mt99808 (2944 in chips) is sitting out
Seat 4: dimetruk (1043 in chips)
Seat 6: thedisik (1342 in chips)
mishanya_pim: posts the ante 4
mt99808: posts the ante 4
dimetruk: posts the ante 4
thedisik: posts the ante 4
mt99808: posts small blind 15
dimetruk: posts big blind 30
*** HOLE CARDS ***
Dealt to dimetruk [Ad 9s]
thedisik: folds
mishanya_pim: raises 36 to 66
mt99808: folds
dimetruk: calls 36
*** FLOP *** [5d 6d Jh]
dimetruk: checks
mishanya_pim: bets 51
mt99808 has returned
dimetruk: raises 129 to 180
mishanya_pim: calls 129
*** TURN *** [5d 6d Jh] [6s]
dimetruk: bets 793 and is all-in
mishanya_pim: calls 793
*** RIVER *** [5d 6d Jh 6s] [As]
*** SHOW DOWN ***
dimetruk: shows [Ad 9s] (two pair, Aces and Sixes)
mishanya_pim: shows [6h 7s] (three of a kind, Sixes)
mishanya_pim collected 2109 from pot
dimetruk finished the tournament in 4th place
*** SUMMARY ***
Total pot 2109 | Rake 0
Board [5d 6d Jh 6s As]
Seat 1: mishanya_pim (button) showed [6h 7s] and won (2109) with three of a kind, Sixes
Seat 3: mt99808 (small blind) folded before Flop
Seat 4: dimetruk (big blind) showed [Ad 9s] and lost with two pair, Aces and Sixes
Seat 6: thedisik folded before Flop (didn't bet)


PokerStars Hand #227188977190: Tournament #3204283203, $27.40+$2.60 USD Hold'em No Limit - Level I (10/20) - 2021/05/30 18:33:30 MSK [2021/05/30 11:33:30 ET]
Table '3204283203 1' 9-max Seat #8 is the button
Seat 1: dimetruk (1439 in chips)
Seat 2: Coolman20000 (1456 in chips)
Seat 4: LfcTrev (1449 in chips) is sitting out
Seat 5: maxats24 (1449 in chips)
Seat 6: 1jims2 (3419 in chips)
Seat 7: terem22 (1253 in chips)
Seat 8: RedRafflesia (1281 in chips)
Seat 9: Kommersant K (1754 in chips)
dimetruk: posts the ante 3
Coolman20000: posts the ante 3
LfcTrev: posts the ante 3
maxats24: posts the ante 3
1jims2: posts the ante 3
terem22: posts the ante 3
RedRafflesia: posts the ante 3
Kommersant K: posts the ante 3
Kommersant K: posts small blind 10
dimetruk: posts big blind 20
*** HOLE CARDS ***
Dealt to dimetruk [Th Td]
Coolman20000: folds
LfcTrev: folds
maxats24: raises 29 to 49
1jims2: calls 49
terem22: calls 49
RedRafflesia: folds
Kommersant K: folds
dimetruk: calls 29
*** FLOP *** [4d 4h 6h]
dimetruk: checks
maxats24: checks
1jims2: checks
LfcTrev is disconnected
terem22: checks
*** TURN *** [4d 4h 6h] [9d]
dimetruk: bets 140
maxats24: folds
1jims2: calls 140
terem22: calls 140
*** RIVER *** [4d 4h 6h 9d] [Kd]
LfcTrev has returned
dimetruk: checks
1jims2: checks
terem22: checks
*** SHOW DOWN ***
dimetruk: shows [Th Td] (two pair, Tens and Fours)
1jims2: mucks hand
terem22: mucks hand
dimetruk collected 650 from pot
*** SUMMARY ***
Total pot 650 | Rake 0
Board [4d 4h 6h 9d Kd]
Seat 1: dimetruk (big blind) showed [Th Td] and won (650) with two pair, Tens and Fours
Seat 2: Coolman20000 folded before Flop (didn't bet)
Seat 4: LfcTrev folded before Flop (didn't bet)
Seat 5: maxats24 folded on the Turn
Seat 6: 1jims2 mucked [Qh 9c]
Seat 7: terem22 mucked [2h 5h]
Seat 8: RedRafflesia (button) folded before Flop (didn't bet)
Seat 9: Kommersant K (small blind) folded before Flop


PokerStars Hand #227189001477: Tournament #3204283203, $27.40+$2.60 USD Hold'em No Limit - Level I (10/20) - 2021/05/30 18:34:27 MSK [2021/05/30 11:34:27 ET]
Table '3204283203 1' 9-max Seat #9 is the button
Seat 1: dimetruk (1897 in chips)
Seat 2: Coolman20000 (1453 in chips)
Seat 4: LfcTrev (1446 in chips)
Seat 5: maxats24 (1397 in chips)
Seat 6: 1jims2 (3227 in chips)
Seat 7: terem22 (1061 in chips)
Seat 8: RedRafflesia (1278 in chips)
Seat 9: Kommersant K (1741 in chips)
dimetruk: posts the ante 3
Coolman20000: posts the ante 3
LfcTrev: posts the ante 3
maxats24: posts the ante 3
1jims2: posts the ante 3
terem22: posts the ante 3
RedRafflesia: posts the ante 3
Kommersant K: posts the ante 3
dimetruk: posts small blind 10
Coolman20000: posts big blind 20
*** HOLE CARDS ***
Dealt to dimetruk [As 7s]
LfcTrev: folds
maxats24: folds
1jims2: raises 40 to 60
terem22: folds
RedRafflesia: folds
Kommersant K: folds
dimetruk: calls 50
Coolman20000: folds
*** FLOP *** [5d 5s 8d]
dimetruk: checks
1jims2: checks
*** TURN *** [5d 5s 8d] [4s]
dimetruk: bets 90
1jims2: calls 90
*** RIVER *** [5d 5s 8d 4s] [2c]
dimetruk: bets 220
1jims2: folds
Uncalled bet (220) returned to dimetruk
dimetruk collected 344 from pot
dimetruk: doesn't show hand
*** SUMMARY ***
Total pot 344 | Rake 0
Board [5d 5s 8d 4s 2c]
Seat 1: dimetruk (small blind) collected (344)
Seat 2: Coolman20000 (big blind) folded before Flop
Seat 4: LfcTrev folded before Flop (didn't bet)
Seat 5: maxats24 folded before Flop (didn't bet)
Seat 6: 1jims2 folded on the River
Seat 7: terem22 folded before Flop (didn't bet)
Seat 8: RedRafflesia folded before Flop (didn't bet)
Seat 9: Kommersant K (button) folded before Flop (didn't bet)


PokerStars Hand #227189064419: Tournament #3204283203, $27.40+$2.60 USD Hold'em No Limit - Level II (15/30) - 2021/05/30 18:36:55 MSK [2021/05/30 11:36:55 ET]
Table '3204283203 1' 9-max Seat #6 is the button
Seat 1: dimetruk (2034 in chips)
Seat 2: Coolman20000 (1577 in chips)
Seat 4: LfcTrev (1399 in chips)
Seat 5: maxats24 (1345 in chips)
Seat 6: 1jims2 (2955 in chips)
Seat 7: terem22 (1151 in chips)
Seat 8: RedRafflesia (1261 in chips)
Seat 9: Kommersant K (1778 in chips)
dimetruk: posts the ante 4
Coolman20000: posts the ante 4
LfcTrev: posts the ante 4
maxats24: posts the ante 4
1jims2: posts the ante 4
terem22: posts the ante 4
RedRafflesia: posts the ante 4
Kommersant K: posts the ante 4
terem22: posts small blind 15
RedRafflesia: posts big blind 30
*** HOLE CARDS ***
Dealt to dimetruk [7d 7h]
Kommersant K: raises 45 to 75
dimetruk: calls 75
Coolman20000: folds
LfcTrev: calls 75
maxats24: folds
1jims2: folds
terem22: folds
RedRafflesia: calls 45
*** FLOP *** [8c 3s 4c]
RedRafflesia: checks
Kommersant K: checks
dimetruk: bets 174
LfcTrev: folds
RedRafflesia: folds
Kommersant K: folds
Uncalled bet (174) returned to dimetruk
dimetruk collected 347 from pot
dimetruk: doesn't show hand
*** SUMMARY ***
Total pot 347 | Rake 0
Board [8c 3s 4c]
Seat 1: dimetruk collected (347)
Seat 2: Coolman20000 folded before Flop (didn't bet)
Seat 4: LfcTrev folded on the Flop
Seat 5: maxats24 folded before Flop (didn't bet)
Seat 6: 1jims2 (button) folded before Flop (didn't bet)
Seat 7: terem22 (small blind) folded before Flop
Seat 8: RedRafflesia (big blind) folded on the Flop
Seat 9: Kommersant K folded on the Flop


PokerStars Hand #227189089318: Tournament #3204283203, $27.40+$2.60 USD Hold'em No Limit - Level II (15/30) - 2021/05/30 18:37:53 MSK [2021/05/30 11:37:53 ET]
Table '3204283203 1' 9-max Seat #8 is the button
Seat 1: dimetruk (2298 in chips)
Seat 2: Coolman20000 (1646 in chips)
Seat 4: LfcTrev (1316 in chips)
Seat 5: maxats24 (1337 in chips)
Seat 6: 1jims2 (2947 in chips)
Seat 7: terem22 (1128 in chips)
Seat 8: RedRafflesia (1163 in chips)
Seat 9: Kommersant K (1665 in chips)
dimetruk: posts the ante 4
Coolman20000: posts the ante 4
LfcTrev: posts the ante 4
maxats24: posts the ante 4
1jims2: posts the ante 4
terem22: posts the ante 4
RedRafflesia: posts the ante 4
Kommersant K: posts the ante 4
Kommersant K: posts small blind 15
dimetruk: posts big blind 30
*** HOLE CARDS ***
Dealt to dimetruk [3h Ks]
Coolman20000: folds
LfcTrev: folds
maxats24: raises 43 to 73
1jims2: folds
terem22: folds
RedRafflesia: folds
Kommersant K: calls 58
dimetruk: calls 43
*** FLOP *** [7h 4d 2d]
Kommersant K: checks
dimetruk: checks
maxats24: bets 62
Kommersant K: folds
dimetruk: folds
Uncalled bet (62) returned to maxats24
maxats24 collected 251 from pot
maxats24: doesn't show hand
*** SUMMARY ***
Total pot 251 | Rake 0
Board [7h 4d 2d]
Seat 1: dimetruk (big blind) folded on the Flop
Seat 2: Coolman20000 folded before Flop (didn't bet)
Seat 4: LfcTrev folded before Flop (didn't bet)
Seat 5: maxats24 collected (251)
Seat 6: 1jims2 folded before Flop (didn't bet)
Seat 7: terem22 folded before Flop (didn't bet)
Seat 8: RedRafflesia (button) folded before Flop (didn't bet)
Seat 9: Kommersant K (small blind) folded on the Flop


PokerStars Hand #227189113273: Tournament #3204283203, $27.40+$2.60 USD Hold'em No Limit - Level II (15/30) - 2021/05/30 18:38:49 MSK [2021/05/30 11:38:49 ET]
Table '3204283203 1' 9-max Seat #9 is the button
Seat 1: dimetruk (2221 in chips)
Seat 2: Coolman20000 (1642 in chips)
Seat 4: LfcTrev (1312 in chips)
Seat 5: maxats24 (1511 in chips)
Seat 6: 1jims2 (2943 in chips)
Seat 7: terem22 (1124 in chips)
Seat 8: RedRafflesia (1159 in chips)
Seat 9: Kommersant K (1588 in chips)
dimetruk: posts the ante 4
Coolman20000: posts the ante 4
LfcTrev: posts the ante 4
maxats24: posts the ante 4
1jims2: posts the ante 4
terem22: posts the ante 4
RedRafflesia: posts the ante 4
Kommersant K: posts the ante 4
dimetruk: posts small blind 15
Coolman20000: posts big blind 30
*** HOLE CARDS ***
Dealt to dimetruk [As Ts]
LfcTrev: folds
maxats24: folds
1jims2: folds
terem22: calls 30
RedRafflesia: folds
Kommersant K: folds
dimetruk: raises 60 to 90
Coolman20000: folds
terem22: calls 60
*** FLOP *** [3h 8d 6c]
dimetruk: bets 121
terem22: calls 121
*** TURN *** [3h 8d 6c] [6s]
dimetruk: checks
terem22: bets 242
dimetruk: folds
Uncalled bet (242) returned to terem22
terem22 collected 484 from pot
terem22: doesn't show hand
*** SUMMARY ***
Total pot 484 | Rake 0
Board [3h 8d 6c 6s]
Seat 1: dimetruk (small blind) folded on the Turn
Seat 2: Coolman20000 (big blind) folded before Flop
Seat 4: LfcTrev folded before Flop (didn't bet)
Seat 5: maxats24 folded before Flop (didn't bet)
Seat 6: 1jims2 folded before Flop (didn't bet)
Seat 7: terem22 collected (484)
Seat 8: RedRafflesia folded before Flop (didn't bet)
Seat 9: Kommersant K (button) folded before Flop (didn't bet)


PokerStars Hand #227189186840: Tournament #3204283203, $27.40+$2.60 USD Hold'em No Limit - Level II (15/30) - 2021/05/30 18:41:35 MSK [2021/05/30 11:41:35 ET]
Table '3204283203 1' 9-max Seat #5 is the button
Seat 1: dimetruk (1994 in chips)
Seat 2: Coolman20000 (1658 in chips)
Seat 4: LfcTrev (1478 in chips)
Seat 5: maxats24 (1450 in chips)
Seat 6: 1jims2 (2897 in chips)
Seat 7: terem22 (914 in chips)
Seat 8: RedRafflesia (1143 in chips)
Seat 9: Kommersant K (1966 in chips)
dimetruk: posts the ante 4
Coolman20000: posts the ante 4
LfcTrev: posts the ante 4
maxats24: posts the ante 4
1jims2: posts the ante 4
terem22: posts the ante 4
RedRafflesia: posts the ante 4
Kommersant K: posts the ante 4
1jims2: posts small blind 15
terem22: posts big blind 30
*** HOLE CARDS ***
Dealt to dimetruk [Ad Kc]
RedRafflesia: folds
Kommersant K: folds
dimetruk: raises 30 to 60
Coolman20000: calls 60
LfcTrev: folds
maxats24: folds
1jims2: folds
terem22: calls 30
*** FLOP *** [Tc 4c 8c]
terem22: checks
dimetruk: checks
Coolman20000: bets 75
terem22: folds
dimetruk: calls 75
*** TURN *** [Tc 4c 8c] [9d]
dimetruk: checks
Coolman20000: bets 297
dimetruk: folds
Uncalled bet (297) returned to Coolman20000
Coolman20000 collected 377 from pot
*** SUMMARY ***
Total pot 377 | Rake 0
Board [Tc 4c 8c 9d]
Seat 1: dimetruk folded on the Turn
Seat 2: Coolman20000 collected (377)
Seat 4: LfcTrev folded before Flop (didn't bet)
Seat 5: maxats24 (button) folded before Flop (didn't bet)
Seat 6: 1jims2 (small blind) folded before Flop
Seat 7: terem22 (big blind) folded on the Flop
Seat 8: RedRafflesia folded before Flop (didn't bet)
Seat 9: Kommersant K folded before Flop (didn't bet)


PokerStars Hand #227189261251: Tournament #3204283203, $27.40+$2.60 USD Hold'em No Limit - Level II (15/30) - 2021/05/30 18:44:12 MSK [2021/05/30 11:44:12 ET]
Table '3204283203 1' 9-max Seat #8 is the button
Seat 1: dimetruk (1847 in chips)
Seat 2: Coolman20000 (1813 in chips)
Seat 4: LfcTrev (1376 in chips)
Seat 5: maxats24 (1438 in chips)
Seat 6: 1jims2 (2870 in chips)
Seat 7: terem22 (994 in chips)
Seat 8: RedRafflesia (1086 in chips)
Seat 9: Kommersant K (2076 in chips)
dimetruk: posts the ante 4
Coolman20000: posts the ante 4
LfcTrev: posts the ante 4
maxats24: posts the ante 4
1jims2: posts the ante 4
terem22: posts the ante 4
RedRafflesia: posts the ante 4
Kommersant K: posts the ante 4
Kommersant K: posts small blind 15
dimetruk: posts big blind 30
*** HOLE CARDS ***
Dealt to dimetruk [7s 5s]
Coolman20000: folds
LfcTrev: folds
maxats24: folds
1jims2: folds
terem22: folds
RedRafflesia: folds
Kommersant K: raises 72 to 102
dimetruk: calls 72
*** FLOP *** [Ad 3d 8h]
Kommersant K: bets 59
dimetruk: folds
Uncalled bet (59) returned to Kommersant K
Kommersant K collected 236 from pot
Kommersant K: doesn't show hand
*** SUMMARY ***
Total pot 236 | Rake 0
Board [Ad 3d 8h]
Seat 1: dimetruk (big blind) folded on the Flop
Seat 2: Coolman20000 folded before Flop (didn't bet)
Seat 4: LfcTrev folded before Flop (didn't bet)
Seat 5: maxats24 folded before Flop (didn't bet)
Seat 6: 1jims2 folded before Flop (didn't bet)
Seat 7: terem22 folded before Flop (didn't bet)
Seat 8: RedRafflesia (button) folded before Flop (didn't bet)
Seat 9: Kommersant K (small blind) collected (236)


PokerStars Hand #227189396084: Tournament #3204283203, $27.40+$2.60 USD Hold'em No Limit - Level III (25/50) - 2021/05/30 18:49:03 MSK [2021/05/30 11:49:03 ET]
Table '3204283203 1' 9-max Seat #4 is the button
Seat 1: dimetruk (1710 in chips)
Seat 2: Coolman20000 (1502 in chips)
Seat 4: LfcTrev (1801 in chips)
Seat 5: maxats24 (1259 in chips)
Seat 6: 1jims2 (2998 in chips)
Seat 7: terem22 (974 in chips)
Seat 8: RedRafflesia (1066 in chips)
Seat 9: Kommersant K (2190 in chips)
dimetruk: posts the ante 6
Coolman20000: posts the ante 6
LfcTrev: posts the ante 6
maxats24: posts the ante 6
1jims2: posts the ante 6
terem22: posts the ante 6
RedRafflesia: posts the ante 6
Kommersant K: posts the ante 6
maxats24: posts small blind 25
1jims2: posts big blind 50
*** HOLE CARDS ***
Dealt to dimetruk [Kc 7c]
terem22: folds
RedRafflesia: folds
Kommersant K: folds
dimetruk: raises 50 to 100
Coolman20000: folds
LfcTrev: calls 100
maxats24: folds
1jims2: calls 50
*** FLOP *** [Qd 7d Qs]
1jims2: checks
dimetruk: bets 187
LfcTrev: folds
1jims2: folds
Uncalled bet (187) returned to dimetruk
dimetruk collected 373 from pot
dimetruk: doesn't show hand
*** SUMMARY ***
Total pot 373 | Rake 0
Board [Qd 7d Qs]
Seat 1: dimetruk collected (373)
Seat 2: Coolman20000 folded before Flop (didn't bet)
Seat 4: LfcTrev (button) folded on the Flop
Seat 5: maxats24 (small blind) folded before Flop
Seat 6: 1jims2 (big blind) folded on the Flop
Seat 7: terem22 folded before Flop (didn't bet)
Seat 8: RedRafflesia folded before Flop (didn't bet)
Seat 9: Kommersant K folded before Flop (didn't bet)


PokerStars Hand #227189454700: Tournament #3204283203, $27.40+$2.60 USD Hold'em No Limit - Level III (25/50) - 2021/05/30 18:51:20 MSK [2021/05/30 11:51:20 ET]
Table '3204283203 1' 9-max Seat #8 is the button
Seat 1: dimetruk (1959 in chips)
Seat 2: Coolman20000 (1478 in chips)
Seat 4: LfcTrev (2100 in chips)
Seat 5: maxats24 (1210 in chips)
Seat 6: 1jims2 (2898 in chips)
Seat 7: terem22 (949 in chips)
Seat 8: RedRafflesia (884 in chips)
Seat 9: Kommersant K (2022 in chips)
dimetruk: posts the ante 6
Coolman20000: posts the ante 6
LfcTrev: posts the ante 6
maxats24: posts the ante 6
1jims2: posts the ante 6
terem22: posts the ante 6
RedRafflesia: posts the ante 6
Kommersant K: posts the ante 6
Kommersant K: posts small blind 25
dimetruk: posts big blind 50
*** HOLE CARDS ***
Dealt to dimetruk [8c 8h]
Coolman20000: folds
LfcTrev: folds
maxats24: raises 50 to 100
1jims2: folds
terem22: folds
RedRafflesia: folds
Kommersant K: calls 75
dimetruk: calls 50
*** FLOP *** [3d 3h 6s]
Kommersant K: checks
dimetruk: checks
maxats24: checks
*** TURN *** [3d 3h 6s] [7h]
Kommersant K: checks
dimetruk: bets 225
maxats24: folds
Kommersant K: calls 225
*** RIVER *** [3d 3h 6s 7h] [Ts]
Kommersant K: checks
dimetruk: checks
*** SHOW DOWN ***
Kommersant K: shows [6h 6d] (a full house, Sixes full of Threes)
dimetruk: mucks hand
Kommersant K collected 798 from pot
*** SUMMARY ***
Total pot 798 | Rake 0
Board [3d 3h 6s 7h Ts]
Seat 1: dimetruk (big blind) mucked [8c 8h]
Seat 2: Coolman20000 folded before Flop (didn't bet)
Seat 4: LfcTrev folded before Flop (didn't bet)
Seat 5: maxats24 folded on the Turn
Seat 6: 1jims2 folded before Flop (didn't bet)
Seat 7: terem22 folded before Flop (didn't bet)
Seat 8: RedRafflesia (button) folded before Flop (didn't bet)
Seat 9: Kommersant K (small blind) showed [6h 6d] and won (798) with a full house, Sixes full of Threes


PokerStars Hand #227189611687: Tournament #3204283203, $27.40+$2.60 USD Hold'em No Limit - Level IV (40/80) - 2021/05/30 18:58:22 MSK [2021/05/30 11:58:22 ET]
Table '3204283203 1' 9-max Seat #8 is the button
Seat 1: dimetruk (1553 in chips)
Seat 2: Coolman20000 (1822 in chips)
Seat 4: LfcTrev (1574 in chips)
Seat 5: maxats24 (1202 in chips)
Seat 6: 1jims2 (2373 in chips)
Seat 7: terem22 (1868 in chips)
Seat 8: RedRafflesia (2132 in chips)
Seat 9: Kommersant K (976 in chips)
dimetruk: posts the ante 10
Coolman20000: posts the ante 10
LfcTrev: posts the ante 10
maxats24: posts the ante 10
1jims2: posts the ante 10
terem22: posts the ante 10
RedRafflesia: posts the ante 10
Kommersant K: posts the ante 10
Kommersant K: posts small blind 40
dimetruk: posts big blind 80
*** HOLE CARDS ***
Dealt to dimetruk [2d 5d]
Coolman20000: folds
LfcTrev: folds
maxats24: folds
1jims2: folds
terem22: folds
RedRafflesia: raises 80 to 160
Kommersant K: folds
dimetruk: calls 80
*** FLOP *** [Jh 4c 6s]
dimetruk: checks
RedRafflesia: bets 174
dimetruk: calls 174
*** TURN *** [Jh 4c 6s] [Th]
dimetruk: checks
RedRafflesia: bets 402
dimetruk: folds
Uncalled bet (402) returned to RedRafflesia
RedRafflesia collected 788 from pot
RedRafflesia: doesn't show hand
*** SUMMARY ***
Total pot 788 | Rake 0
Board [Jh 4c 6s Th]
Seat 1: dimetruk (big blind) folded on the Turn
Seat 2: Coolman20000 folded before Flop (didn't bet)
Seat 4: LfcTrev folded before Flop (didn't bet)
Seat 5: maxats24 folded before Flop (didn't bet)
Seat 6: 1jims2 folded before Flop (didn't bet)
Seat 7: terem22 folded before Flop (didn't bet)
Seat 8: RedRafflesia (button) collected (788)
Seat 9: Kommersant K (small blind) folded before Flop


PokerStars Hand #227189737316: Tournament #3204283203, $27.40+$2.60 USD Hold'em No Limit - Level IV (40/80) - 2021/05/30 19:04:03 MSK [2021/05/30 12:04:03 ET]
Table '3204283203 1' 9-max Seat #8 is the button
Seat 1: dimetruk (1109 in chips)
Seat 2: Coolman20000 (2152 in chips)
Seat 4: LfcTrev (1504 in chips)
Seat 5: maxats24 (1012 in chips)
Seat 6: 1jims2 (4541 in chips)
Seat 8: RedRafflesia (2116 in chips)
Seat 9: Kommersant K (1066 in chips)
dimetruk: posts the ante 10
Coolman20000: posts the ante 10
LfcTrev: posts the ante 10
maxats24: posts the ante 10
1jims2: posts the ante 10
RedRafflesia: posts the ante 10
Kommersant K: posts the ante 10
Kommersant K: posts small blind 40
dimetruk: posts big blind 80
*** HOLE CARDS ***
Dealt to dimetruk [2d 8c]
Coolman20000: folds
LfcTrev has timed out
LfcTrev: folds
LfcTrev is sitting out
maxats24: folds
1jims2: calls 80
RedRafflesia: folds
Kommersant K: calls 40
dimetruk: checks
*** FLOP *** [6h Js 8s]
Kommersant K: bets 140
LfcTrev has returned
dimetruk: folds
1jims2: folds
Uncalled bet (140) returned to Kommersant K
Kommersant K collected 310 from pot
Kommersant K: doesn't show hand
*** SUMMARY ***
Total pot 310 | Rake 0
Board [6h Js 8s]
Seat 1: dimetruk (big blind) folded on the Flop
Seat 2: Coolman20000 folded before Flop (didn't bet)
Seat 4: LfcTrev folded before Flop (didn't bet)
Seat 5: maxats24 folded before Flop (didn't bet)
Seat 6: 1jims2 folded on the Flop
Seat 8: RedRafflesia (button) folded before Flop (didn't bet)
Seat 9: Kommersant K (small blind) collected (310)


PokerStars Hand #227189831699: Tournament #3204283203, $27.40+$2.60 USD Hold'em No Limit - Level V (60/120) - 2021/05/30 19:07:37 MSK [2021/05/30 12:07:37 ET]
Table '3204283203 1' 9-max Seat #8 is the button
Seat 1: dimetruk (784 in chips)
Seat 2: Coolman20000 (3823 in chips)
Seat 4: LfcTrev (1489 in chips)
Seat 6: 1jims2 (4451 in chips)
Seat 8: RedRafflesia (2953 in chips)
dimetruk: posts the ante 15
Coolman20000: posts the ante 15
LfcTrev: posts the ante 15
1jims2: posts the ante 15
RedRafflesia: posts the ante 15
dimetruk: posts small blind 60
Coolman20000: posts big blind 120
*** HOLE CARDS ***
Dealt to dimetruk [Jd Jc]
LfcTrev: raises 120 to 240
1jims2: folds
RedRafflesia: folds
dimetruk: raises 529 to 769 and is all-in
Coolman20000: folds
LfcTrev: calls 529
*** FLOP *** [3c Js 9h]
*** TURN *** [3c Js 9h] [Qd]
*** RIVER *** [3c Js 9h Qd] [5d]
*** SHOW DOWN ***
dimetruk: shows [Jd Jc] (three of a kind, Jacks)
LfcTrev: shows [Ad 6h] (high card Ace)
dimetruk collected 1733 from pot
*** SUMMARY ***
Total pot 1733 | Rake 0
Board [3c Js 9h Qd 5d]
Seat 1: dimetruk (small blind) showed [Jd Jc] and won (1733) with three of a kind, Jacks
Seat 2: Coolman20000 (big blind) folded before Flop
Seat 4: LfcTrev showed [Ad 6h] and lost with high card Ace
Seat 6: 1jims2 folded before Flop (didn't bet)
Seat 8: RedRafflesia (button) folded before Flop (didn't bet)


PokerStars Hand #227189873791: Tournament #3204283203, $27.40+$2.60 USD Hold'em No Limit - Level V (60/120) - 2021/05/30 19:09:11 MSK [2021/05/30 12:09:11 ET]
Table '3204283203 1' 9-max Seat #6 is the button
Seat 1: dimetruk (1688 in chips)
Seat 2: Coolman20000 (4093 in chips)
Seat 4: LfcTrev (1170 in chips)
Seat 6: 1jims2 (3776 in chips)
Seat 8: RedRafflesia (2773 in chips)
dimetruk: posts the ante 15
Coolman20000: posts the ante 15
LfcTrev: posts the ante 15
1jims2: posts the ante 15
RedRafflesia: posts the ante 15
RedRafflesia: posts small blind 60
dimetruk: posts big blind 120
*** HOLE CARDS ***
Dealt to dimetruk [2h Jd]
Coolman20000: folds
LfcTrev: folds
1jims2: calls 120
RedRafflesia: calls 60
dimetruk: checks
*** FLOP *** [4d 5c Ts]
RedRafflesia: checks
dimetruk: checks
1jims2: checks
*** TURN *** [4d 5c Ts] [Ac]
RedRafflesia: checks
dimetruk: checks
1jims2: checks
*** RIVER *** [4d 5c Ts Ac] [9d]
RedRafflesia: checks
dimetruk: checks
1jims2: checks
*** SHOW DOWN ***
RedRafflesia: shows [8d Js] (high card Ace)
dimetruk: mucks hand
1jims2: mucks hand
RedRafflesia collected 435 from pot
*** SUMMARY ***
Total pot 435 | Rake 0
Board [4d 5c Ts Ac 9d]
Seat 1: dimetruk (big blind) mucked [2h Jd]
Seat 2: Coolman20000 folded before Flop (didn't bet)
Seat 4: LfcTrev folded before Flop (didn't bet)
Seat 6: 1jims2 (button) mucked [8s 7s]
Seat 8: RedRafflesia (small blind) showed [8d Js] and won (435) with high card Ace


PokerStars Hand #227189977720: Tournament #3204283203, $27.40+$2.60 USD Hold'em No Limit - Level V (60/120) - 2021/05/30 19:13:00 MSK [2021/05/30 12:13:00 ET]
Table '3204283203 1' 9-max Seat #6 is the button
Seat 1: dimetruk (1433 in chips)
Seat 2: Coolman20000 (2396 in chips)
Seat 4: LfcTrev (2190 in chips)
Seat 6: 1jims2 (2839 in chips)
Seat 8: RedRafflesia (4642 in chips)
dimetruk: posts the ante 15
Coolman20000: posts the ante 15
LfcTrev: posts the ante 15
1jims2: posts the ante 15
RedRafflesia: posts the ante 15
RedRafflesia: posts small blind 60
dimetruk: posts big blind 120
*** HOLE CARDS ***
Dealt to dimetruk [Ah 4d]
Coolman20000: folds
LfcTrev: raises 165 to 285
1jims2: folds
RedRafflesia: folds
dimetruk: calls 165
*** FLOP *** [Ad Jc 3s]
dimetruk: bets 1133 and is all-in
LfcTrev: folds
Uncalled bet (1133) returned to dimetruk
dimetruk collected 705 from pot
dimetruk: doesn't show hand
*** SUMMARY ***
Total pot 705 | Rake 0
Board [Ad Jc 3s]
Seat 1: dimetruk (big blind) collected (705)
Seat 2: Coolman20000 folded before Flop (didn't bet)
Seat 4: LfcTrev folded on the Flop
Seat 6: 1jims2 (button) folded before Flop (didn't bet)
Seat 8: RedRafflesia (small blind) folded before Flop


PokerStars Hand #227190088193: Tournament #3204283203, $27.40+$2.60 USD Hold'em No Limit - Level VI (80/160) - 2021/05/30 19:16:50 MSK [2021/05/30 12:16:50 ET]
Table '3204283203 1' 9-max Seat #4 is the button
Seat 1: dimetruk (1373 in chips)
Seat 4: LfcTrev (1985 in chips)
Seat 6: 1jims2 (3643 in chips)
Seat 8: RedRafflesia (6499 in chips)
dimetruk: posts the ante 20
LfcTrev: posts the ante 20
1jims2: posts the ante 20
RedRafflesia: posts the ante 20
1jims2: posts small blind 80
RedRafflesia: posts big blind 160
*** HOLE CARDS ***
Dealt to dimetruk [Qs Jc]
dimetruk: raises 1193 to 1353 and is all-in
LfcTrev: folds
1jims2: folds
RedRafflesia: calls 1193
*** FLOP *** [Ts 6h 3s]
*** TURN *** [Ts 6h 3s] [5s]
*** RIVER *** [Ts 6h 3s 5s] [6d]
*** SHOW DOWN ***
RedRafflesia: shows [8d Ad] (a pair of Sixes)
dimetruk: shows [Qs Jc] (a pair of Sixes - lower kicker)
RedRafflesia collected 2866 from pot
dimetruk finished the tournament in 4th place
*** SUMMARY ***
Total pot 2866 | Rake 0
Board [Ts 6h 3s 5s 6d]
Seat 1: dimetruk showed [Qs Jc] and lost with a pair of Sixes
Seat 4: LfcTrev (button) folded before Flop (didn't bet)
Seat 6: 1jims2 (small blind) folded before Flop
Seat 8: RedRafflesia (big blind) showed [8d Ad] and won (2866) with a pair of Sixes


PokerStars Hand #227271305553: Tournament #3206184643, $13.70+$1.30 USD Hold'em No Limit - Level I (10/20) - 2021/06/02 20:53:36 MSK [2021/06/02 13:53:36 ET]
Table '3206184643 1' 9-max Seat #7 is the button
Seat 1: ScousePro (3238 in chips)
Seat 2: dimetruk (1475 in chips)
Seat 3: dclucasPS (1455 in chips)
Seat 4: den220577 (1602 in chips)
Seat 6: JayManthers (1509 in chips)
Seat 7: mr. Snigirev (1095 in chips)
Seat 8: ViniD. maria (1372 in chips)
Seat 9: Manusian (1754 in chips)
ScousePro: posts the ante 3
dimetruk: posts the ante 3
dclucasPS: posts the ante 3
den220577: posts the ante 3
JayManthers: posts the ante 3
mr. Snigirev: posts the ante 3
ViniD. maria: posts the ante 3
Manusian: posts the ante 3
ViniD. maria: posts small blind 10
Manusian: posts big blind 20
*** HOLE CARDS ***
Dealt to dimetruk [8d Ad]
ScousePro: folds
dimetruk: raises 20 to 40
dclucasPS: folds
den220577: folds
JayManthers: folds
mr. Snigirev: folds
ViniD. maria: folds
Manusian: calls 20
*** FLOP *** [3c Jh 2c]
Manusian: checks
dimetruk: checks
*** TURN *** [3c Jh 2c] [4s]
Manusian: bets 62
dimetruk: calls 62
*** RIVER *** [3c Jh 2c 4s] [7d]
Manusian: bets 129
dimetruk: folds
Uncalled bet (129) returned to Manusian
Manusian collected 238 from pot
*** SUMMARY ***
Total pot 238 | Rake 0
Board [3c Jh 2c 4s 7d]
Seat 1: ScousePro folded before Flop (didn't bet)
Seat 2: dimetruk folded on the River
Seat 3: dclucasPS folded before Flop (didn't bet)
Seat 4: den220577 folded before Flop (didn't bet)
Seat 6: JayManthers folded before Flop (didn't bet)
Seat 7: mr. Snigirev (button) folded before Flop (didn't bet)
Seat 8: ViniD. maria (small blind) folded before Flop
Seat 9: Manusian (big blind) collected (238)


PokerStars Hand #227271334968: Tournament #3206184643, $13.70+$1.30 USD Hold'em No Limit - Level I (10/20) - 2021/06/02 20:54:42 MSK [2021/06/02 13:54:42 ET]
Table '3206184643 1' 9-max Seat #9 is the button
Seat 1: ScousePro (3212 in chips)
Seat 2: dimetruk (1367 in chips)
Seat 3: dclucasPS (1449 in chips)
Seat 4: den220577 (1596 in chips)
Seat 6: JayManthers (1503 in chips)
Seat 7: mr. Snigirev (1089 in chips)
Seat 8: ViniD. maria (1410 in chips)
Seat 9: Manusian (1874 in chips)
ScousePro: posts the ante 3
dimetruk: posts the ante 3
dclucasPS: posts the ante 3
den220577: posts the ante 3
JayManthers: posts the ante 3
mr. Snigirev: posts the ante 3
ViniD. maria: posts the ante 3
Manusian: posts the ante 3
ScousePro: posts small blind 10
dimetruk: posts big blind 20
*** HOLE CARDS ***
Dealt to dimetruk [6d 3h]
dclucasPS: folds
den220577: folds
JayManthers: folds
mr. Snigirev: raises 20 to 40
ViniD. maria: folds
Manusian: folds
ScousePro: folds
dimetruk: calls 20
*** FLOP *** [Kh Qd 4c]
dimetruk: checks
mr. Snigirev: checks
*** TURN *** [Kh Qd 4c] [2c]
dimetruk: bets 40
mr. Snigirev: calls 40
*** RIVER *** [Kh Qd 4c 2c] [4d]
dimetruk: bets 240
mr. Snigirev: calls 240
*** SHOW DOWN ***
dimetruk: shows [6d 3h] (a pair of Fours)
mr. Snigirev: shows [9c 9s] (two pair, Nines and Fours)
mr. Snigirev collected 674 from pot
*** SUMMARY ***
Total pot 674 | Rake 0
Board [Kh Qd 4c 2c 4d]
Seat 1: ScousePro (small blind) folded before Flop
Seat 2: dimetruk (big blind) showed [6d 3h] and lost with a pair of Fours
Seat 3: dclucasPS folded before Flop (didn't bet)
Seat 4: den220577 folded before Flop (didn't bet)
Seat 6: JayManthers folded before Flop (didn't bet)
Seat 7: mr. Snigirev showed [9c 9s] and won (674) with two pair, Nines and Fours
Seat 8: ViniD. maria folded before Flop (didn't bet)
Seat 9: Manusian (button) folded before Flop (didn't bet)


PokerStars Hand #227271430508: Tournament #3206184643, $13.70+$1.30 USD Hold'em No Limit - Level II (15/30) - 2021/06/02 20:59:29 MSK [2021/06/02 13:59:29 ET]
Table '3206184643 1' 9-max Seat #4 is the button
Seat 1: ScousePro (3189 in chips)
Seat 2: dimetruk (1024 in chips)
Seat 3: dclucasPS (1509 in chips)
Seat 4: den220577 (1656 in chips)
Seat 6: JayManthers (1296 in chips)
Seat 7: mr. Snigirev (1430 in chips)
Seat 9: Manusian (3396 in chips)
ScousePro: posts the ante 4
dimetruk: posts the ante 4
dclucasPS: posts the ante 4
den220577: posts the ante 4
JayManthers: posts the ante 4
mr. Snigirev: posts the ante 4
Manusian: posts the ante 4
JayManthers: posts small blind 15
mr. Snigirev: posts big blind 30
*** HOLE CARDS ***
Dealt to dimetruk [6d Ad]
Manusian: folds
ScousePro: folds
dimetruk: raises 30 to 60
dclucasPS: folds
den220577: folds
JayManthers: folds
mr. Snigirev: calls 30
*** FLOP *** [2d 8h Ts]
mr. Snigirev: checks
dimetruk: checks
*** TURN *** [2d 8h Ts] [Qs]
mr. Snigirev: checks
dimetruk: bets 57
mr. Snigirev: folds
Uncalled bet (57) returned to dimetruk
dimetruk collected 163 from pot
dimetruk: doesn't show hand
*** SUMMARY ***
Total pot 163 | Rake 0
Board [2d 8h Ts Qs]
Seat 1: ScousePro folded before Flop (didn't bet)
Seat 2: dimetruk collected (163)
Seat 3: dclucasPS folded before Flop (didn't bet)
Seat 4: den220577 (button) folded before Flop (didn't bet)
Seat 6: JayManthers (small blind) folded before Flop
Seat 7: mr. Snigirev (big blind) folded on the Turn
Seat 9: Manusian folded before Flop (didn't bet)


PokerStars Hand #227271455303: Tournament #3206184643, $13.70+$1.30 USD Hold'em No Limit - Level II (15/30) - 2021/06/02 21:00:41 MSK [2021/06/02 14:00:41 ET]
Table '3206184643 1' 9-max Seat #9 is the button
Seat 1: ScousePro (3147 in chips)
Seat 2: dimetruk (1115 in chips)
Seat 3: dclucasPS (1497 in chips)
Seat 4: den220577 (1644 in chips)
Seat 6: JayManthers (1267 in chips)
Seat 7: mr. Snigirev (1283 in chips)
Seat 9: Manusian (3547 in chips)
ScousePro: posts the ante 4
dimetruk: posts the ante 4
dclucasPS: posts the ante 4
den220577: posts the ante 4
JayManthers: posts the ante 4
mr. Snigirev: posts the ante 4
Manusian: posts the ante 4
ScousePro: posts small blind 15
dimetruk: posts big blind 30
*** HOLE CARDS ***
Dealt to dimetruk [Tc 8d]
dclucasPS: folds
den220577: folds
JayManthers: folds
mr. Snigirev: folds
Manusian: folds
ScousePro: raises 60 to 90
dimetruk: calls 60
*** FLOP *** [8c 9c Qh]
ScousePro: bets 101
dimetruk: calls 101
*** TURN *** [8c 9c Qh] [4c]
ScousePro: bets 176
dimetruk: calls 176
*** RIVER *** [8c 9c Qh 4c] [2c]
ScousePro: checks
dimetruk: checks
*** SHOW DOWN ***
ScousePro: shows [Kd Kc] (a flush, King high)
dimetruk: mucks hand
ScousePro collected 762 from pot
*** SUMMARY ***
Total pot 762 | Rake 0
Board [8c 9c Qh 4c 2c]
Seat 1: ScousePro (small blind) showed [Kd Kc] and won (762) with a flush, King high
Seat 2: dimetruk (big blind) mucked [Tc 8d]
Seat 3: dclucasPS folded before Flop (didn't bet)
Seat 4: den220577 folded before Flop (didn't bet)
Seat 6: JayManthers folded before Flop (didn't bet)
Seat 7: mr. Snigirev folded before Flop (didn't bet)
Seat 9: Manusian (button) folded before Flop (didn't bet)


PokerStars Hand #227271560470: Tournament #3206184643, $13.70+$1.30 USD Hold'em No Limit - Level II (15/30) - 2021/06/02 21:04:42 MSK [2021/06/02 14:04:42 ET]
Table '3206184643 1' 9-max Seat #9 is the button
Seat 1: ScousePro (3484 in chips)
Seat 2: dimetruk (838 in chips)
Seat 3: dclucasPS (1343 in chips)
Seat 4: den220577 (1753 in chips)
Seat 6: JayManthers (1312 in chips)
Seat 7: mr. Snigirev (1443 in chips)
Seat 9: Manusian (3327 in chips)
ScousePro: posts the ante 4
dimetruk: posts the ante 4
dclucasPS: posts the ante 4
den220577: posts the ante 4
JayManthers: posts the ante 4
mr. Snigirev: posts the ante 4
Manusian: posts the ante 4
ScousePro: posts small blind 15
dimetruk: posts big blind 30
*** HOLE CARDS ***
Dealt to dimetruk [Ks Kd]
dclucasPS: folds
den220577: folds
JayManthers: folds
mr. Snigirev: raises 30 to 60
Manusian: folds
ScousePro: folds
dimetruk: calls 30
*** FLOP *** [Jd 3c 4h]
dimetruk: checks
mr. Snigirev: checks
*** TURN *** [Jd 3c 4h] [Ah]
dimetruk: checks
mr. Snigirev: bets 54
dimetruk: calls 54
*** RIVER *** [Jd 3c 4h Ah] [6c]
dimetruk: checks
mr. Snigirev: checks
*** SHOW DOWN ***
dimetruk: shows [Ks Kd] (a pair of Kings)
mr. Snigirev: mucks hand
dimetruk collected 271 from pot
*** SUMMARY ***
Total pot 271 | Rake 0
Board [Jd 3c 4h Ah 6c]
Seat 1: ScousePro (small blind) folded before Flop
Seat 2: dimetruk (big blind) showed [Ks Kd] and won (271) with a pair of Kings
Seat 3: dclucasPS folded before Flop (didn't bet)
Seat 4: den220577 folded before Flop (didn't bet)
Seat 6: JayManthers folded before Flop (didn't bet)
Seat 7: mr. Snigirev mucked [Qh 8h]
Seat 9: Manusian (button) folded before Flop (didn't bet)


PokerStars Hand #227271844479: Tournament #3206184643, $13.70+$1.30 USD Hold'em No Limit - Level III (25/50) - 2021/06/02 21:14:54 MSK [2021/06/02 14:14:54 ET]
Table '3206184643 1' 9-max Seat #3 is the button
Seat 1: ScousePro (3682 in chips)
Seat 2: dimetruk (1330 in chips)
Seat 3: dclucasPS (2483 in chips)
Seat 4: den220577 (2025 in chips)
Seat 7: mr. Snigirev (859 in chips)
Seat 9: Manusian (3121 in chips)
ScousePro: posts the ante 6
dimetruk: posts the ante 6
dclucasPS: posts the ante 6
den220577: posts the ante 6
mr. Snigirev: posts the ante 6
Manusian: posts the ante 6
den220577: posts small blind 25
mr. Snigirev: posts big blind 50
*** HOLE CARDS ***
Dealt to dimetruk [5s Ac]
Manusian: folds
ScousePro: folds
dimetruk: raises 50 to 100
dclucasPS: folds
den220577: calls 75
mr. Snigirev: calls 50
*** FLOP *** [As 8c Jd]
den220577: checks
mr. Snigirev: checks
dimetruk: bets 118
den220577: folds
mr. Snigirev: folds
Uncalled bet (118) returned to dimetruk
dimetruk collected 336 from pot
dimetruk: doesn't show hand
*** SUMMARY ***
Total pot 336 | Rake 0
Board [As 8c Jd]
Seat 1: ScousePro folded before Flop (didn't bet)
Seat 2: dimetruk collected (336)
Seat 3: dclucasPS (button) folded before Flop (didn't bet)
Seat 4: den220577 (small blind) folded on the Flop
Seat 7: mr. Snigirev (big blind) folded on the Flop
Seat 9: Manusian folded before Flop (didn't bet)


PokerStars Hand #227271864552: Tournament #3206184643, $13.70+$1.30 USD Hold'em No Limit - Level III (25/50) - 2021/06/02 21:15:37 MSK [2021/06/02 14:15:37 ET]
Table '3206184643 1' 9-max Seat #4 is the button
Seat 1: ScousePro (3676 in chips)
Seat 2: dimetruk (1560 in chips)
Seat 3: dclucasPS (2477 in chips)
Seat 4: den220577 (1919 in chips)
Seat 7: mr. Snigirev (753 in chips)
Seat 9: Manusian (3115 in chips)
ScousePro: posts the ante 6
dimetruk: posts the ante 6
dclucasPS: posts the ante 6
den220577: posts the ante 6
mr. Snigirev: posts the ante 6
Manusian: posts the ante 6
mr. Snigirev: posts small blind 25
Manusian: posts big blind 50
*** HOLE CARDS ***
Dealt to dimetruk [Qs Qc]
ScousePro: folds
dimetruk: raises 50 to 100
dclucasPS: folds
den220577: folds
mr. Snigirev: folds
Manusian: calls 50
*** FLOP *** [2c 5s Jc]
Manusian: checks
dimetruk: bets 131
Manusian: calls 131
*** TURN *** [2c 5s Jc] [9d]
Manusian: checks
dimetruk: bets 262
Manusian: folds
Uncalled bet (262) returned to dimetruk
dimetruk collected 523 from pot
dimetruk: doesn't show hand
*** SUMMARY ***
Total pot 523 | Rake 0
Board [2c 5s Jc 9d]
Seat 1: ScousePro folded before Flop (didn't bet)
Seat 2: dimetruk collected (523)
Seat 3: dclucasPS folded before Flop (didn't bet)
Seat 4: den220577 (button) folded before Flop (didn't bet)
Seat 7: mr. Snigirev (small blind) folded before Flop
Seat 9: Manusian (big blind) folded on the Turn


PokerStars Hand #227271983929: Tournament #3206184643, $13.70+$1.30 USD Hold'em No Limit - Level IV (40/80) - 2021/06/02 21:19:42 MSK [2021/06/02 14:19:42 ET]
Table '3206184643 1' 9-max Seat #9 is the button
Seat 1: ScousePro (3743 in chips)
Seat 2: dimetruk (1717 in chips)
Seat 3: dclucasPS (2782 in chips)
Seat 4: den220577 (1299 in chips)
Seat 7: mr. Snigirev (659 in chips)
Seat 9: Manusian (3300 in chips)
ScousePro: posts the ante 10
dimetruk: posts the ante 10
dclucasPS: posts the ante 10
den220577: posts the ante 10
mr. Snigirev: posts the ante 10
Manusian: posts the ante 10
ScousePro: posts small blind 40
dimetruk: posts big blind 80
*** HOLE CARDS ***
Dealt to dimetruk [7c 8h]
dclucasPS: folds
den220577: raises 80 to 160
mr. Snigirev: folds
Manusian: folds
ScousePro: folds
dimetruk: calls 80
*** FLOP *** [6s Kh 4d]
dimetruk: checks
den220577: bets 139
dimetruk: calls 139
*** TURN *** [6s Kh 4d] [Td]
dimetruk: checks
den220577: bets 990 and is all-in
dimetruk: folds
Uncalled bet (990) returned to den220577
den220577 collected 698 from pot
*** SUMMARY ***
Total pot 698 | Rake 0
Board [6s Kh 4d Td]
Seat 1: ScousePro (small blind) folded before Flop
Seat 2: dimetruk (big blind) folded on the Turn
Seat 3: dclucasPS folded before Flop (didn't bet)
Seat 4: den220577 collected (698)
Seat 7: mr. Snigirev folded before Flop (didn't bet)
Seat 9: Manusian (button) folded before Flop (didn't bet)


PokerStars Hand #227272208121: Tournament #3206184643, $13.70+$1.30 USD Hold'em No Limit - Level IV (40/80) - 2021/06/02 21:27:31 MSK [2021/06/02 14:27:31 ET]
Table '3206184643 1' 9-max Seat #3 is the button
Seat 1: ScousePro (3743 in chips)
Seat 2: dimetruk (848 in chips)
Seat 3: dclucasPS (2023 in chips)
Seat 4: den220577 (3072 in chips)
Seat 9: Manusian (3814 in chips)
ScousePro: posts the ante 10
dimetruk: posts the ante 10
dclucasPS: posts the ante 10
den220577: posts the ante 10
Manusian: posts the ante 10
den220577: posts small blind 40
Manusian: posts big blind 80
*** HOLE CARDS ***
Dealt to dimetruk [Kc Kd]
ScousePro: folds
dimetruk: raises 758 to 838 and is all-in
dclucasPS: folds
den220577: raises 2224 to 3062 and is all-in
Manusian: folds
Uncalled bet (2224) returned to den220577
*** FLOP *** [5d Ts Ad]
*** TURN *** [5d Ts Ad] [9c]
*** RIVER *** [5d Ts Ad 9c] [Jd]
*** SHOW DOWN ***
den220577: shows [Ah Jh] (two pair, Aces and Jacks)
dimetruk: shows [Kc Kd] (a pair of Kings)
den220577 collected 1806 from pot
dimetruk finished the tournament in 5th place
*** SUMMARY ***
Total pot 1806 | Rake 0
Board [5d Ts Ad 9c Jd]
Seat 1: ScousePro folded before Flop (didn't bet)
Seat 2: dimetruk showed [Kc Kd] and lost with a pair of Kings
Seat 3: dclucasPS (button) folded before Flop (didn't bet)
Seat 4: den220577 (small blind) showed [Ah Jh] and won (1806) with two pair, Aces and Jacks
Seat 9: Manusian (big blind) folded before Flop


PokerStars Hand #228170078529: Tournament #3227151913, $13.70+$1.30 USD Hold'em No Limit - Level I (10/20) - 2021/07/09 21:41:29 MSK [2021/07/09 14:41:29 ET]
Table '3227151913 1' 9-max Seat #8 is the button
Seat 1: dimetruk (1442 in chips)
Seat 2: norge0405 (1030 in chips)
Seat 3: fonshemis (1549 in chips)
Seat 4: alijster (1372 in chips)
Seat 5: afalefex (1570 in chips)
Seat 6: So_Nice LC (1452 in chips)
Seat 8: invisible271 (3258 in chips)
Seat 9: Hung69Solo (1827 in chips)
dimetruk: posts the ante 3
norge0405: posts the ante 3
fonshemis: posts the ante 3
alijster: posts the ante 3
afalefex: posts the ante 3
So_Nice LC: posts the ante 3
invisible271: posts the ante 3
Hung69Solo: posts the ante 3
Hung69Solo: posts small blind 10
dimetruk: posts big blind 20
*** HOLE CARDS ***
Dealt to dimetruk [Ad Qs]
norge0405: folds
fonshemis: folds
alijster: folds
afalefex: folds
So_Nice LC: folds
invisible271: folds
Hung69Solo: raises 40 to 60
dimetruk: calls 40
*** FLOP *** [8d Ac 5d]
Hung69Solo: checks
dimetruk: bets 50
Hung69Solo: calls 50
*** TURN *** [8d Ac 5d] [4d]
Hung69Solo: checks
dimetruk: checks
*** RIVER *** [8d Ac 5d 4d] [Kc]
Hung69Solo: checks
dimetruk: bets 166
Hung69Solo: folds
Uncalled bet (166) returned to dimetruk
dimetruk collected 244 from pot
dimetruk: doesn't show hand
*** SUMMARY ***
Total pot 244 | Rake 0
Board [8d Ac 5d 4d Kc]
Seat 1: dimetruk (big blind) collected (244)
Seat 2: norge0405 folded before Flop (didn't bet)
Seat 3: fonshemis folded before Flop (didn't bet)
Seat 4: alijster folded before Flop (didn't bet)
Seat 5: afalefex folded before Flop (didn't bet)
Seat 6: So_Nice LC folded before Flop (didn't bet)
Seat 8: invisible271 (button) folded before Flop (didn't bet)
Seat 9: Hung69Solo (small blind) folded on the River


PokerStars Hand #228170172587: Tournament #3227151913, $13.70+$1.30 USD Hold'em No Limit - Level I (10/20) - 2021/07/09 21:45:17 MSK [2021/07/09 14:45:17 ET]
Table '3227151913 1' 9-max Seat #2 is the button
Seat 1: dimetruk (1557 in chips)
Seat 2: norge0405 (991 in chips)
Seat 3: fonshemis (1574 in chips)
Seat 4: alijster (1417 in chips)
Seat 5: afalefex (1561 in chips)
Seat 6: So_Nice LC (1443 in chips)
Seat 8: invisible271 (3249 in chips)
Seat 9: Hung69Solo (1708 in chips) is sitting out
dimetruk: posts the ante 3
norge0405: posts the ante 3
fonshemis: posts the ante 3
alijster: posts the ante 3
afalefex: posts the ante 3
So_Nice LC: posts the ante 3
invisible271: posts the ante 3
Hung69Solo: posts the ante 3
fonshemis: posts small blind 10
alijster: posts big blind 20
*** HOLE CARDS ***
Dealt to dimetruk [2s As]
afalefex: folds
So_Nice LC: folds
invisible271: folds
Hung69Solo: folds
dimetruk: raises 20 to 40
norge0405: folds
fonshemis: folds
alijster: calls 20
*** FLOP *** [6c 2h Ts]
alijster: checks
dimetruk: bets 57
alijster: folds
Uncalled bet (57) returned to dimetruk
dimetruk collected 114 from pot
dimetruk: doesn't show hand
*** SUMMARY ***
Total pot 114 | Rake 0
Board [6c 2h Ts]
Seat 1: dimetruk collected (114)
Seat 2: norge0405 (button) folded before Flop (didn't bet)
Seat 3: fonshemis (small blind) folded before Flop
Seat 4: alijster (big blind) folded on the Flop
Seat 5: afalefex folded before Flop (didn't bet)
Seat 6: So_Nice LC folded before Flop (didn't bet)
Seat 8: invisible271 folded before Flop (didn't bet)
Seat 9: Hung69Solo folded before Flop (didn't bet)


PokerStars Hand #228170186865: Tournament #3227151913, $13.70+$1.30 USD Hold'em No Limit - Level I (10/20) - 2021/07/09 21:45:52 MSK [2021/07/09 14:45:52 ET]
Table '3227151913 1' 9-max Seat #3 is the button
Seat 1: dimetruk (1628 in chips)
Seat 2: norge0405 (988 in chips)
Seat 3: fonshemis (1561 in chips)
Seat 4: alijster (1374 in chips)
Seat 5: afalefex (1558 in chips)
Seat 6: So_Nice LC (1440 in chips)
Seat 8: invisible271 (3246 in chips)
Seat 9: Hung69Solo (1705 in chips) is sitting out
dimetruk: posts the ante 3
norge0405: posts the ante 3
fonshemis: posts the ante 3
alijster: posts the ante 3
afalefex: posts the ante 3
So_Nice LC: posts the ante 3
invisible271: posts the ante 3
Hung69Solo: posts the ante 3
alijster: posts small blind 10
afalefex: posts big blind 20
*** HOLE CARDS ***
Dealt to dimetruk [Ks 7s]
So_Nice LC: folds
invisible271: folds
Hung69Solo: folds
dimetruk: raises 20 to 40
norge0405: folds
fonshemis: folds
alijster: folds
afalefex: calls 20
*** FLOP *** [9c 7c Jc]
afalefex: checks
dimetruk: bets 57
afalefex: folds
Uncalled bet (57) returned to dimetruk
dimetruk collected 114 from pot
dimetruk: doesn't show hand
*** SUMMARY ***
Total pot 114 | Rake 0
Board [9c 7c Jc]
Seat 1: dimetruk collected (114)
Seat 2: norge0405 folded before Flop (didn't bet)
Seat 3: fonshemis (button) folded before Flop (didn't bet)
Seat 4: alijster (small blind) folded before Flop
Seat 5: afalefex (big blind) folded on the Flop
Seat 6: So_Nice LC folded before Flop (didn't bet)
Seat 8: invisible271 folded before Flop (didn't bet)
Seat 9: Hung69Solo folded before Flop (didn't bet)


PokerStars Hand #228170299048: Tournament #3227151913, $13.70+$1.30 USD Hold'em No Limit - Level II (15/30) - 2021/07/09 21:49:44 MSK [2021/07/09 14:49:44 ET]
Table '3227151913 1' 9-max Seat #8 is the button
Seat 1: dimetruk (1687 in chips)
Seat 2: norge0405 (973 in chips)
Seat 3: fonshemis (1653 in chips)
Seat 4: alijster (1501 in chips)
Seat 5: afalefex (1488 in chips)
Seat 6: So_Nice LC (1275 in chips)
Seat 8: invisible271 (3263 in chips)
Seat 9: Hung69Solo (1660 in chips) is sitting out
dimetruk: posts the ante 4
norge0405: posts the ante 4
fonshemis: posts the ante 4
alijster: posts the ante 4
afalefex: posts the ante 4
So_Nice LC: posts the ante 4
invisible271: posts the ante 4
Hung69Solo: posts the ante 4
Hung69Solo: posts small blind 15
dimetruk: posts big blind 30
*** HOLE CARDS ***
Dealt to dimetruk [3h 4d]
norge0405: raises 60 to 90
fonshemis: folds
alijster: calls 90
afalefex: folds
So_Nice LC: folds
invisible271: folds
Hung69Solo: folds
dimetruk: calls 60
*** FLOP *** [9h 2c Th]
dimetruk: checks
norge0405: bets 317
alijster: folds
dimetruk: folds
Uncalled bet (317) returned to norge0405
norge0405 collected 317 from pot
norge0405: doesn't show hand
*** SUMMARY ***
Total pot 317 | Rake 0
Board [9h 2c Th]
Seat 1: dimetruk (big blind) folded on the Flop
Seat 2: norge0405 collected (317)
Seat 3: fonshemis folded before Flop (didn't bet)
Seat 4: alijster folded on the Flop
Seat 5: afalefex folded before Flop (didn't bet)
Seat 6: So_Nice LC folded before Flop (didn't bet)
Seat 8: invisible271 (button) folded before Flop (didn't bet)
Seat 9: Hung69Solo (small blind) folded before Flop


PokerStars Hand #228170450541: Tournament #3227151913, $13.70+$1.30 USD Hold'em No Limit - Level II (15/30) - 2021/07/09 21:55:34 MSK [2021/07/09 14:55:34 ET]
Table '3227151913 1' 9-max Seat #6 is the button
Seat 1: dimetruk (1539 in chips)
Seat 2: norge0405 (1470 in chips)
Seat 3: fonshemis (1869 in chips)
Seat 5: afalefex (1385 in chips)
Seat 6: So_Nice LC (2338 in chips)
Seat 8: invisible271 (3205 in chips)
Seat 9: Hung69Solo (1694 in chips)
dimetruk: posts the ante 4
norge0405: posts the ante 4
fonshemis: posts the ante 4
afalefex: posts the ante 4
So_Nice LC: posts the ante 4
invisible271: posts the ante 4
Hung69Solo: posts the ante 4
invisible271: posts small blind 15
Hung69Solo: posts big blind 30
*** HOLE CARDS ***
Dealt to dimetruk [9d Jd]
dimetruk: raises 30 to 60
norge0405: calls 60
fonshemis: folds
afalefex: folds
So_Nice LC: folds
invisible271: folds
Hung69Solo: folds
*** FLOP *** [Ks 3c 4d]
dimetruk: checks
norge0405: bets 97
dimetruk: folds
Uncalled bet (97) returned to norge0405
norge0405 collected 193 from pot
norge0405: doesn't show hand
*** SUMMARY ***
Total pot 193 | Rake 0
Board [Ks 3c 4d]
Seat 1: dimetruk folded on the Flop
Seat 2: norge0405 collected (193)
Seat 3: fonshemis folded before Flop (didn't bet)
Seat 5: afalefex folded before Flop (didn't bet)
Seat 6: So_Nice LC (button) folded before Flop (didn't bet)
Seat 8: invisible271 (small blind) folded before Flop
Seat 9: Hung69Solo (big blind) folded before Flop


PokerStars Hand #228170483730: Tournament #3227151913, $13.70+$1.30 USD Hold'em No Limit - Level III (25/50) - 2021/07/09 21:57:21 MSK [2021/07/09 14:57:21 ET]
Table '3227151913 1' 9-max Seat #9 is the button
Seat 1: dimetruk (1636 in chips)
Seat 2: norge0405 (1493 in chips)
Seat 3: fonshemis (1859 in chips)
Seat 5: afalefex (1375 in chips)
Seat 6: So_Nice LC (2328 in chips)
Seat 8: invisible271 (3180 in chips)
Seat 9: Hung69Solo (1629 in chips)
dimetruk: posts the ante 6
norge0405: posts the ante 6
fonshemis: posts the ante 6
afalefex: posts the ante 6
So_Nice LC: posts the ante 6
invisible271: posts the ante 6
Hung69Solo: posts the ante 6
dimetruk: posts small blind 25
norge0405: posts big blind 50
*** HOLE CARDS ***
Dealt to dimetruk [5c 2c]
fonshemis: folds
afalefex: calls 50
So_Nice LC: folds
invisible271: folds
Hung69Solo: folds
dimetruk: calls 25
norge0405 said, "@ so nice lc if i loose against you i have no problem, you are only one who say hello ;-)"
norge0405: checks
*** FLOP *** [2d 2h Ks]
dimetruk: checks
norge0405: bets 96
afalefex: folds
dimetruk: raises 1484 to 1580 and is all-in
norge0405: folds
Uncalled bet (1484) returned to dimetruk
dimetruk collected 384 from pot
dimetruk: doesn't show hand
*** SUMMARY ***
Total pot 384 | Rake 0
Board [2d 2h Ks]
Seat 1: dimetruk (small blind) collected (384)
Seat 2: norge0405 (big blind) folded on the Flop
Seat 3: fonshemis folded before Flop (didn't bet)
Seat 5: afalefex folded on the Flop
Seat 6: So_Nice LC folded before Flop (didn't bet)
Seat 8: invisible271 folded before Flop (didn't bet)
Seat 9: Hung69Solo (button) folded before Flop (didn't bet)


PokerStars Hand #228170506073: Tournament #3227151913, $13.70+$1.30 USD Hold'em No Limit - Level III (25/50) - 2021/07/09 21:58:33 MSK [2021/07/09 14:58:33 ET]
Table '3227151913 1' 9-max Seat #2 is the button
Seat 1: dimetruk (1862 in chips)
Seat 2: norge0405 (1310 in chips)
Seat 3: fonshemis (1914 in chips)
Seat 5: afalefex (1313 in chips)
Seat 6: So_Nice LC (2316 in chips)
Seat 8: invisible271 (3168 in chips)
Seat 9: Hung69Solo (1617 in chips) is sitting out
dimetruk: posts the ante 6
norge0405: posts the ante 6
fonshemis: posts the ante 6
afalefex: posts the ante 6
So_Nice LC: posts the ante 6
invisible271: posts the ante 6
Hung69Solo: posts the ante 6
fonshemis: posts small blind 25
afalefex: posts big blind 50
*** HOLE CARDS ***
Dealt to dimetruk [Qs Ah]
So_Nice LC: raises 50 to 100
invisible271: folds
Hung69Solo: folds
dimetruk: raises 150 to 250
norge0405: folds
fonshemis: folds
afalefex: folds
So_Nice LC: calls 150
*** FLOP *** [Ks 7d 9c]
So_Nice LC: bets 250
dimetruk: folds
Uncalled bet (250) returned to So_Nice LC
So_Nice LC collected 617 from pot
So_Nice LC: doesn't show hand
*** SUMMARY ***
Total pot 617 | Rake 0
Board [Ks 7d 9c]
Seat 1: dimetruk folded on the Flop
Seat 2: norge0405 (button) folded before Flop (didn't bet)
Seat 3: fonshemis (small blind) folded before Flop
Seat 5: afalefex (big blind) folded before Flop
Seat 6: So_Nice LC collected (617)
Seat 8: invisible271 folded before Flop (didn't bet)
Seat 9: Hung69Solo folded before Flop (didn't bet)


PokerStars Hand #228170530910: Tournament #3227151913, $13.70+$1.30 USD Hold'em No Limit - Level III (25/50) - 2021/07/09 21:59:54 MSK [2021/07/09 14:59:54 ET]
Table '3227151913 1' 9-max Seat #5 is the button
Seat 1: dimetruk (1600 in chips)
Seat 2: norge0405 (1298 in chips)
Seat 3: fonshemis (1877 in chips)
Seat 5: afalefex (1151 in chips)
Seat 6: So_Nice LC (2621 in chips)
Seat 8: invisible271 (3348 in chips)
Seat 9: Hung69Solo (1605 in chips) is sitting out
dimetruk: posts the ante 6
norge0405: posts the ante 6
fonshemis: posts the ante 6
afalefex: posts the ante 6
So_Nice LC: posts the ante 6
invisible271: posts the ante 6
Hung69Solo: posts the ante 6
So_Nice LC: posts small blind 25
invisible271: posts big blind 50
*** HOLE CARDS ***
Dealt to dimetruk [5d 6d]
Hung69Solo: folds
dimetruk: raises 50 to 100
norge0405: folds
fonshemis: folds
afalefex: calls 100
So_Nice LC: folds
invisible271: calls 50
*** FLOP *** [4s 8c Kd]
invisible271: checks
dimetruk: bets 128
afalefex: folds
invisible271: calls 128
*** TURN *** [4s 8c Kd] [As]
invisible271: checks
dimetruk: bets 350
invisible271: folds
Uncalled bet (350) returned to dimetruk
dimetruk collected 623 from pot
dimetruk: doesn't show hand
*** SUMMARY ***
Total pot 623 | Rake 0
Board [4s 8c Kd As]
Seat 1: dimetruk collected (623)
Seat 2: norge0405 folded before Flop (didn't bet)
Seat 3: fonshemis folded before Flop (didn't bet)
Seat 5: afalefex (button) folded on the Flop
Seat 6: So_Nice LC (small blind) folded before Flop
Seat 8: invisible271 (big blind) folded on the Turn
Seat 9: Hung69Solo folded before Flop (didn't bet)


PokerStars Hand #228170546180: Tournament #3227151913, $13.70+$1.30 USD Hold'em No Limit - Level III (25/50) - 2021/07/09 22:00:40 MSK [2021/07/09 15:00:40 ET]
Table '3227151913 1' 9-max Seat #8 is the button
Seat 1: dimetruk (1983 in chips)
Seat 2: norge0405 (1286 in chips)
Seat 3: fonshemis (1865 in chips)
Seat 5: afalefex (1039 in chips)
Seat 6: So_Nice LC (2584 in chips)
Seat 8: invisible271 (3200 in chips)
Seat 9: Hung69Solo (1543 in chips) is sitting out
dimetruk: posts the ante 6
norge0405: posts the ante 6
fonshemis: posts the ante 6
afalefex: posts the ante 6
So_Nice LC: posts the ante 6
invisible271: posts the ante 6
Hung69Solo: posts the ante 6
Hung69Solo: posts small blind 25
dimetruk: posts big blind 50
*** HOLE CARDS ***
Dealt to dimetruk [2d 6c]
norge0405: calls 50
fonshemis: folds
afalefex: folds
So_Nice LC: folds
invisible271: folds
Hung69Solo: folds
dimetruk: checks
*** FLOP *** [7d 4c 9c]
dimetruk: checks
norge0405: bets 84
dimetruk: folds
Uncalled bet (84) returned to norge0405
norge0405 collected 167 from pot
norge0405: doesn't show hand
*** SUMMARY ***
Total pot 167 | Rake 0
Board [7d 4c 9c]
Seat 1: dimetruk (big blind) folded on the Flop
Seat 2: norge0405 collected (167)
Seat 3: fonshemis folded before Flop (didn't bet)
Seat 5: afalefex folded before Flop (didn't bet)
Seat 6: So_Nice LC folded before Flop (didn't bet)
Seat 8: invisible271 (button) folded before Flop (didn't bet)
Seat 9: Hung69Solo (small blind) folded before Flop


PokerStars Hand #228170563157: Tournament #3227151913, $13.70+$1.30 USD Hold'em No Limit - Level III (25/50) - 2021/07/09 22:01:27 MSK [2021/07/09 15:01:27 ET]
Table '3227151913 1' 9-max Seat #1 is the button
Seat 1: dimetruk (1871 in chips)
Seat 2: norge0405 (1483 in chips)
Seat 3: fonshemis (1853 in chips)
Seat 5: afalefex (1027 in chips)
Seat 6: So_Nice LC (2572 in chips)
Seat 8: invisible271 (3188 in chips)
Seat 9: Hung69Solo (1506 in chips) is sitting out
dimetruk: posts the ante 6
norge0405: posts the ante 6
fonshemis: posts the ante 6
afalefex: posts the ante 6
So_Nice LC: posts the ante 6
invisible271: posts the ante 6
Hung69Solo: posts the ante 6
norge0405: posts small blind 25
fonshemis: posts big blind 50
*** HOLE CARDS ***
Dealt to dimetruk [3d Kd]
afalefex: folds
So_Nice LC: folds
invisible271: folds
Hung69Solo: folds
dimetruk: raises 50 to 100
norge0405: folds
fonshemis: calls 50
*** FLOP *** [8d Ah 4s]
fonshemis: checks
dimetruk: bets 93
fonshemis: calls 93
*** TURN *** [8d Ah 4s] [Kc]
fonshemis: checks
dimetruk: checks
*** RIVER *** [8d Ah 4s Kc] [2s]
fonshemis: bets 149
dimetruk: calls 149
*** SHOW DOWN ***
fonshemis: shows [8c 4d] (two pair, Eights and Fours)
dimetruk: mucks hand
fonshemis collected 751 from pot
*** SUMMARY ***
Total pot 751 | Rake 0
Board [8d Ah 4s Kc 2s]
Seat 1: dimetruk (button) mucked [3d Kd]
Seat 2: norge0405 (small blind) folded before Flop
Seat 3: fonshemis (big blind) showed [8c 4d] and won (751) with two pair, Eights and Fours
Seat 5: afalefex folded before Flop (didn't bet)
Seat 6: So_Nice LC folded before Flop (didn't bet)
Seat 8: invisible271 folded before Flop (didn't bet)
Seat 9: Hung69Solo folded before Flop (didn't bet)


PokerStars Hand #228170749629: Tournament #3227151913, $13.70+$1.30 USD Hold'em No Limit - Level IV (40/80) - 2021/07/09 22:08:37 MSK [2021/07/09 15:08:37 ET]
Table '3227151913 1' 9-max Seat #8 is the button
Seat 1: dimetruk (1552 in chips)
Seat 3: fonshemis (1835 in chips)
Seat 5: afalefex (1604 in chips)
Seat 6: So_Nice LC (2554 in chips)
Seat 8: invisible271 (4669 in chips)
Seat 9: Hung69Solo (1286 in chips) is sitting out
dimetruk: posts the ante 10
fonshemis: posts the ante 10
afalefex: posts the ante 10
So_Nice LC: posts the ante 10
invisible271: posts the ante 10
Hung69Solo: posts the ante 10
Hung69Solo: posts small blind 40
dimetruk: posts big blind 80
*** HOLE CARDS ***
Dealt to dimetruk [5h Qd]
Hung69Solo has returned
fonshemis: folds
afalefex: folds
So_Nice LC: folds
invisible271: folds
Hung69Solo: calls 40
dimetruk: raises 80 to 160
Hung69Solo: calls 80
*** FLOP *** [8h Ad 9d]
Hung69Solo: checks
dimetruk: bets 133
Hung69Solo: calls 133
*** TURN *** [8h Ad 9d] [9h]
Hung69Solo: checks
dimetruk: checks
*** RIVER *** [8h Ad 9d 9h] [3h]
Hung69Solo: bets 323
dimetruk: folds
Uncalled bet (323) returned to Hung69Solo
Hung69Solo collected 646 from pot
*** SUMMARY ***
Total pot 646 | Rake 0
Board [8h Ad 9d 9h 3h]
Seat 1: dimetruk (big blind) folded on the River
Seat 3: fonshemis folded before Flop (didn't bet)
Seat 5: afalefex folded before Flop (didn't bet)
Seat 6: So_Nice LC folded before Flop (didn't bet)
Seat 8: invisible271 (button) folded before Flop (didn't bet)
Seat 9: Hung69Solo (small blind) collected (646)


PokerStars Hand #228170849134: Tournament #3227151913, $13.70+$1.30 USD Hold'em No Limit - Level IV (40/80) - 2021/07/09 22:12:18 MSK [2021/07/09 15:12:18 ET]
Table '3227151913 1' 9-max Seat #8 is the button
Seat 1: dimetruk (1519 in chips)
Seat 3: fonshemis (1655 in chips)
Seat 5: afalefex (1764 in chips)
Seat 6: So_Nice LC (2214 in chips)
Seat 8: invisible271 (4669 in chips)
Seat 9: Hung69Solo (1679 in chips)
dimetruk: posts the ante 10
fonshemis: posts the ante 10
afalefex: posts the ante 10
So_Nice LC: posts the ante 10
invisible271: posts the ante 10
Hung69Solo: posts the ante 10
Hung69Solo: posts small blind 40
dimetruk: posts big blind 80
*** HOLE CARDS ***
Dealt to dimetruk [Qs Tc]
fonshemis: folds
afalefex: folds
So_Nice LC: folds
invisible271: folds
Hung69Solo: calls 40
dimetruk: checks
*** FLOP *** [Ah 6h Jc]
Hung69Solo: checks
dimetruk: checks
*** TURN *** [Ah 6h Jc] [2c]
Hung69Solo: checks
dimetruk: bets 120
Hung69Solo: folds
Uncalled bet (120) returned to dimetruk
dimetruk collected 220 from pot
dimetruk: doesn't show hand
*** SUMMARY ***
Total pot 220 | Rake 0
Board [Ah 6h Jc 2c]
Seat 1: dimetruk (big blind) collected (220)
Seat 3: fonshemis folded before Flop (didn't bet)
Seat 5: afalefex folded before Flop (didn't bet)
Seat 6: So_Nice LC folded before Flop (didn't bet)
Seat 8: invisible271 (button) folded before Flop (didn't bet)
Seat 9: Hung69Solo (small blind) folded on the Turn


PokerStars Hand #228170872741: Tournament #3227151913, $13.70+$1.30 USD Hold'em No Limit - Level IV (40/80) - 2021/07/09 22:13:11 MSK [2021/07/09 15:13:11 ET]
Table '3227151913 1' 9-max Seat #9 is the button
Seat 1: dimetruk (1649 in chips)
Seat 3: fonshemis (1645 in chips)
Seat 5: afalefex (1754 in chips)
Seat 6: So_Nice LC (2204 in chips)
Seat 8: invisible271 (4659 in chips)
Seat 9: Hung69Solo (1589 in chips)
dimetruk: posts the ante 10
fonshemis: posts the ante 10
afalefex: posts the ante 10
So_Nice LC: posts the ante 10
invisible271: posts the ante 10
Hung69Solo: posts the ante 10
dimetruk: posts small blind 40
fonshemis: posts big blind 80
*** HOLE CARDS ***
Dealt to dimetruk [2h 9h]
afalefex: folds
So_Nice LC: folds
invisible271: folds
Hung69Solo: calls 80
dimetruk: calls 40
fonshemis: checks
*** FLOP *** [3h 7h 2s]
dimetruk: bets 80
fonshemis: folds
Hung69Solo: folds
Uncalled bet (80) returned to dimetruk
dimetruk collected 300 from pot
dimetruk: doesn't show hand
*** SUMMARY ***
Total pot 300 | Rake 0
Board [3h 7h 2s]
Seat 1: dimetruk (small blind) collected (300)
Seat 3: fonshemis (big blind) folded on the Flop
Seat 5: afalefex folded before Flop (didn't bet)
Seat 6: So_Nice LC folded before Flop (didn't bet)
Seat 8: invisible271 folded before Flop (didn't bet)
Seat 9: Hung69Solo (button) folded on the Flop


PokerStars Hand #228170917527: Tournament #3227151913, $13.70+$1.30 USD Hold'em No Limit - Level IV (40/80) - 2021/07/09 22:14:51 MSK [2021/07/09 15:14:51 ET]
Table '3227151913 1' 9-max Seat #3 is the button
Seat 1: dimetruk (1849 in chips)
Seat 3: fonshemis (3390 in chips)
Seat 5: afalefex (1654 in chips)
Seat 6: So_Nice LC (639 in chips)
Seat 8: invisible271 (4639 in chips)
Seat 9: Hung69Solo (1329 in chips)
dimetruk: posts the ante 10
fonshemis: posts the ante 10
afalefex: posts the ante 10
So_Nice LC: posts the ante 10
invisible271: posts the ante 10
Hung69Solo: posts the ante 10
afalefex: posts small blind 40
So_Nice LC: posts big blind 80
*** HOLE CARDS ***
Dealt to dimetruk [Ad Ac]
invisible271: raises 80 to 160
Hung69Solo: calls 160
dimetruk: calls 160
fonshemis: folds
afalefex: folds
So_Nice LC: folds
*** FLOP *** [7c Jd 4c]
invisible271: bets 429
Hung69Solo: folds
dimetruk: raises 1250 to 1679 and is all-in
invisible271: calls 1250
*** TURN *** [7c Jd 4c] [8d]
*** RIVER *** [7c Jd 4c 8d] [5c]
*** SHOW DOWN ***
invisible271: shows [Kd Ks] (a pair of Kings)
dimetruk: shows [Ad Ac] (a pair of Aces)
dimetruk collected 4018 from pot
*** SUMMARY ***
Total pot 4018 | Rake 0
Board [7c Jd 4c 8d 5c]
Seat 1: dimetruk showed [Ad Ac] and won (4018) with a pair of Aces
Seat 3: fonshemis (button) folded before Flop (didn't bet)
Seat 5: afalefex (small blind) folded before Flop
Seat 6: So_Nice LC (big blind) folded before Flop
Seat 8: invisible271 showed [Kd Ks] and lost with a pair of Kings
Seat 9: Hung69Solo folded on the Flop


PokerStars Hand #228170938279: Tournament #3227151913, $13.70+$1.30 USD Hold'em No Limit - Level IV (40/80) - 2021/07/09 22:15:37 MSK [2021/07/09 15:15:37 ET]
Table '3227151913 1' 9-max Seat #5 is the button
Seat 1: dimetruk (4018 in chips)
Seat 3: fonshemis (3380 in chips)
Seat 5: afalefex (1604 in chips)
Seat 6: So_Nice LC (549 in chips)
Seat 8: invisible271 (2790 in chips)
Seat 9: Hung69Solo (1159 in chips)
dimetruk: posts the ante 10
fonshemis: posts the ante 10
afalefex: posts the ante 10
So_Nice LC: posts the ante 10
invisible271: posts the ante 10
Hung69Solo: posts the ante 10
So_Nice LC: posts small blind 40
invisible271: posts big blind 80
*** HOLE CARDS ***
Dealt to dimetruk [Ac Qs]
Hung69Solo has timed out
Hung69Solo: folds
Hung69Solo is sitting out
dimetruk: raises 80 to 160
fonshemis: folds
Hung69Solo has returned
afalefex: folds
So_Nice LC: raises 379 to 539 and is all-in
invisible271: folds
dimetruk: calls 379
*** FLOP *** [Jh 5h 7d]
*** TURN *** [Jh 5h 7d] [3s]
*** RIVER *** [Jh 5h 7d 3s] [9s]
*** SHOW DOWN ***
So_Nice LC: shows [Ad 7h] (a pair of Sevens)
dimetruk: shows [Ac Qs] (high card Ace)
So_Nice LC collected 1218 from pot
*** SUMMARY ***
Total pot 1218 | Rake 0
Board [Jh 5h 7d 3s 9s]
Seat 1: dimetruk showed [Ac Qs] and lost with high card Ace
Seat 3: fonshemis folded before Flop (didn't bet)
Seat 5: afalefex (button) folded before Flop (didn't bet)
Seat 6: So_Nice LC (small blind) showed [Ad 7h] and won (1218) with a pair of Sevens
Seat 8: invisible271 (big blind) folded before Flop
Seat 9: Hung69Solo folded before Flop (didn't bet)


PokerStars Hand #228170963129: Tournament #3227151913, $13.70+$1.30 USD Hold'em No Limit - Level V (60/120) - 2021/07/09 22:16:32 MSK [2021/07/09 15:16:32 ET]
Table '3227151913 1' 9-max Seat #8 is the button
Seat 1: dimetruk (3454 in chips)
Seat 3: fonshemis (3355 in chips)
Seat 5: afalefex (1579 in chips)
Seat 6: So_Nice LC (1203 in chips)
Seat 8: invisible271 (2625 in chips)
Seat 9: Hung69Solo (1284 in chips)
dimetruk: posts the ante 15
fonshemis: posts the ante 15
afalefex: posts the ante 15
So_Nice LC: posts the ante 15
invisible271: posts the ante 15
Hung69Solo: posts the ante 15
Hung69Solo: posts small blind 60
dimetruk: posts big blind 120
*** HOLE CARDS ***
Dealt to dimetruk [2c Qs]
fonshemis: folds
afalefex: calls 120
So_Nice LC: folds
invisible271: folds
Hung69Solo: calls 60
dimetruk: checks
*** FLOP *** [7c Ah 4h]
Hung69Solo: checks
dimetruk: checks
afalefex: bets 225
Hung69Solo: folds
dimetruk: folds
Uncalled bet (225) returned to afalefex
afalefex collected 450 from pot
*** SUMMARY ***
Total pot 450 | Rake 0
Board [7c Ah 4h]
Seat 1: dimetruk (big blind) folded on the Flop
Seat 3: fonshemis folded before Flop (didn't bet)
Seat 5: afalefex collected (450)
Seat 6: So_Nice LC folded before Flop (didn't bet)
Seat 8: invisible271 (button) folded before Flop (didn't bet)
Seat 9: Hung69Solo (small blind) folded on the Flop


PokerStars Hand #228171052568: Tournament #3227151913, $13.70+$1.30 USD Hold'em No Limit - Level V (60/120) - 2021/07/09 22:19:50 MSK [2021/07/09 15:19:50 ET]
Table '3227151913 1' 9-max Seat #8 is the button
Seat 1: dimetruk (3214 in chips)
Seat 3: fonshemis (3745 in chips)
Seat 5: afalefex (1639 in chips)
Seat 6: So_Nice LC (813 in chips)
Seat 8: invisible271 (3255 in chips)
Seat 9: Hung69Solo (834 in chips) is sitting out
dimetruk: posts the ante 15
fonshemis: posts the ante 15
afalefex: posts the ante 15
So_Nice LC: posts the ante 15
invisible271: posts the ante 15
Hung69Solo: posts the ante 15
Hung69Solo: posts small blind 60
dimetruk: posts big blind 120
*** HOLE CARDS ***
Dealt to dimetruk [6c 6s]
fonshemis: folds
Hung69Solo has returned
afalefex: raises 120 to 240
So_Nice LC: folds
invisible271: folds
Hung69Solo: folds
dimetruk: calls 120
*** FLOP *** [7d 5h 9d]
dimetruk: checks
afalefex: bets 315
dimetruk: raises 2644 to 2959 and is all-in
afalefex: folds
Uncalled bet (2644) returned to dimetruk
dimetruk collected 1260 from pot
dimetruk: doesn't show hand
*** SUMMARY ***
Total pot 1260 | Rake 0
Board [7d 5h 9d]
Seat 1: dimetruk (big blind) collected (1260)
Seat 3: fonshemis folded before Flop (didn't bet)
Seat 5: afalefex folded on the Flop
Seat 6: So_Nice LC folded before Flop (didn't bet)
Seat 8: invisible271 (button) folded before Flop (didn't bet)
Seat 9: Hung69Solo (small blind) folded before Flop


PokerStars Hand #228171096575: Tournament #3227151913, $13.70+$1.30 USD Hold'em No Limit - Level V (60/120) - 2021/07/09 22:21:27 MSK [2021/07/09 15:21:27 ET]
Table '3227151913 1' 9-max Seat #3 is the button
Seat 1: dimetruk (4054 in chips)
Seat 3: fonshemis (5627 in chips)
Seat 8: invisible271 (3090 in chips)
Seat 9: Hung69Solo (729 in chips)
dimetruk: posts the ante 15
fonshemis: posts the ante 15
invisible271: posts the ante 15
Hung69Solo: posts the ante 15
invisible271: posts small blind 60
Hung69Solo: posts big blind 120
*** HOLE CARDS ***
Dealt to dimetruk [Qs Kc]
dimetruk: raises 120 to 240
fonshemis: calls 240
invisible271: calls 180
Hung69Solo: calls 120
*** FLOP *** [5s 5c 6s]
invisible271: checks
Hung69Solo: checks
dimetruk: checks
fonshemis: bets 360
invisible271: folds
Hung69Solo: calls 360
dimetruk: folds
*** TURN *** [5s 5c 6s] [6d]
Hung69Solo: checks
fonshemis: bets 120
Hung69Solo: calls 114 and is all-in
Uncalled bet (6) returned to fonshemis
*** RIVER *** [5s 5c 6s 6d] [Th]
*** SHOW DOWN ***
Hung69Solo: shows [5h Kh] (a full house, Fives full of Sixes)
fonshemis: shows [6h 6c] (four of a kind, Sixes)
fonshemis collected 1968 from pot
Hung69Solo finished the tournament in 4th place
*** SUMMARY ***
Total pot 1968 | Rake 0
Board [5s 5c 6s 6d Th]
Seat 1: dimetruk folded on the Flop
Seat 3: fonshemis (button) showed [6h 6c] and won (1968) with four of a kind, Sixes
Seat 8: invisible271 (small blind) folded on the Flop
Seat 9: Hung69Solo (big blind) showed [5h Kh] and lost with a full house, Fives full of Sixes


PokerStars Hand #228171161237: Tournament #3227151913, $13.70+$1.30 USD Hold'em No Limit - Level V (60/120) - 2021/07/09 22:23:50 MSK [2021/07/09 15:23:50 ET]
Table '3227151913 1' 9-max Seat #8 is the button
Seat 1: dimetruk (4039 in chips)
Seat 3: fonshemis (7535 in chips)
Seat 8: invisible271 (1926 in chips)
dimetruk: posts the ante 15
fonshemis: posts the ante 15
invisible271: posts the ante 15
dimetruk: posts small blind 60
fonshemis: posts big blind 120
*** HOLE CARDS ***
Dealt to dimetruk [3s As]
invisible271: folds
dimetruk: raises 120 to 240
fonshemis: calls 120
*** FLOP *** [Ad Jd 4c]
dimetruk: bets 184
fonshemis: folds
Uncalled bet (184) returned to dimetruk
dimetruk collected 525 from pot
dimetruk: doesn't show hand
*** SUMMARY ***
Total pot 525 | Rake 0
Board [Ad Jd 4c]
Seat 1: dimetruk (small blind) collected (525)
Seat 3: fonshemis (big blind) folded on the Flop
Seat 8: invisible271 (button) folded before Flop (didn't bet)


PokerStars Hand #228171204741: Tournament #3227151913, $13.70+$1.30 USD Hold'em No Limit - Level V (60/120) - 2021/07/09 22:25:13 MSK [2021/07/09 15:25:13 ET]
Table '3227151913 1' 9-max Seat #8 is the button
Seat 1: dimetruk (3949 in chips)
Seat 3: fonshemis (7865 in chips)
Seat 8: invisible271 (1686 in chips)
dimetruk: posts the ante 15
fonshemis: posts the ante 15
invisible271: posts the ante 15
dimetruk: posts small blind 60
fonshemis: posts big blind 120
*** HOLE CARDS ***
Dealt to dimetruk [3c Ac]
invisible271: raises 120 to 240
dimetruk: calls 180
fonshemis: folds
*** FLOP *** [4s 5s 5c]
dimetruk: checks
invisible271: bets 1431 and is all-in
dimetruk: folds
Uncalled bet (1431) returned to invisible271
invisible271 collected 645 from pot
invisible271: doesn't show hand
*** SUMMARY ***
Total pot 645 | Rake 0
Board [4s 5s 5c]
Seat 1: dimetruk (small blind) folded on the Flop
Seat 3: fonshemis (big blind) folded before Flop
Seat 8: invisible271 (button) collected (645)


PokerStars Hand #228171216080: Tournament #3227151913, $13.70+$1.30 USD Hold'em No Limit - Level V (60/120) - 2021/07/09 22:25:30 MSK [2021/07/09 15:25:30 ET]
Table '3227151913 1' 9-max Seat #1 is the button
Seat 1: dimetruk (3694 in chips)
Seat 3: fonshemis (7730 in chips)
Seat 8: invisible271 (2076 in chips)
dimetruk: posts the ante 15
fonshemis: posts the ante 15
invisible271: posts the ante 15
fonshemis: posts small blind 60
invisible271: posts big blind 120
*** HOLE CARDS ***
Dealt to dimetruk [Ah Th]
dimetruk: raises 120 to 240
fonshemis: folds
invisible271: calls 120
*** FLOP *** [Jd As 7h]
invisible271: checks
dimetruk: bets 205
invisible271: calls 205
*** TURN *** [Jd As 7h] [9d]
invisible271: checks
dimetruk: bets 498
invisible271: raises 1118 to 1616 and is all-in
dimetruk: calls 1118
*** RIVER *** [Jd As 7h 9d] [Ks]
*** SHOW DOWN ***
invisible271: shows [Ad 9s] (two pair, Aces and Nines)
dimetruk: shows [Ah Th] (a pair of Aces)
invisible271 collected 4227 from pot
*** SUMMARY ***
Total pot 4227 | Rake 0
Board [Jd As 7h 9d Ks]
Seat 1: dimetruk (button) showed [Ah Th] and lost with a pair of Aces
Seat 3: fonshemis (small blind) folded before Flop
Seat 8: invisible271 (big blind) showed [Ad 9s] and won (4227) with two pair, Aces and Nines


PokerStars Hand #228171234604: Tournament #3227151913, $13.70+$1.30 USD Hold'em No Limit - Level VI (80/160) - 2021/07/09 22:26:10 MSK [2021/07/09 15:26:10 ET]
Table '3227151913 1' 9-max Seat #3 is the button
Seat 1: dimetruk (1618 in chips)
Seat 3: fonshemis (7655 in chips)
Seat 8: invisible271 (4227 in chips)
dimetruk: posts the ante 20
fonshemis: posts the ante 20
invisible271: posts the ante 20
invisible271: posts small blind 80
dimetruk: posts big blind 160
*** HOLE CARDS ***
Dealt to dimetruk [Jh Ah]
fonshemis: folds
invisible271: raises 4047 to 4207 and is all-in
dimetruk: calls 1438 and is all-in
Uncalled bet (2609) returned to invisible271
*** FLOP *** [Qc 6s Ts]
*** TURN *** [Qc 6s Ts] [4h]
*** RIVER *** [Qc 6s Ts 4h] [Ad]
*** SHOW DOWN ***
invisible271: shows [8h 7d] (high card Ace)
dimetruk: shows [Jh Ah] (a pair of Aces)
dimetruk collected 3256 from pot
*** SUMMARY ***
Total pot 3256 | Rake 0
Board [Qc 6s Ts 4h Ad]
Seat 1: dimetruk (big blind) showed [Jh Ah] and won (3256) with a pair of Aces
Seat 3: fonshemis (button) folded before Flop (didn't bet)
Seat 8: invisible271 (small blind) showed [8h 7d] and lost with high card Ace


PokerStars Hand #228171247161: Tournament #3227151913, $13.70+$1.30 USD Hold'em No Limit - Level VI (80/160) - 2021/07/09 22:26:38 MSK [2021/07/09 15:26:38 ET]
Table '3227151913 1' 9-max Seat #3 is the button
Seat 1: dimetruk (3136 in chips)
Seat 3: fonshemis (7955 in chips)
Seat 8: invisible271 (2409 in chips)
dimetruk: posts the ante 20
fonshemis: posts the ante 20
invisible271: posts the ante 20
invisible271: posts small blind 80
dimetruk: posts big blind 160
*** HOLE CARDS ***
Dealt to dimetruk [Kc 6h]
fonshemis: raises 160 to 320
invisible271: folds
dimetruk: calls 160
*** FLOP *** [Qh 2d 9c]
dimetruk: checks
fonshemis: bets 257
dimetruk: folds
Uncalled bet (257) returned to fonshemis
fonshemis collected 780 from pot
fonshemis: doesn't show hand
*** SUMMARY ***
Total pot 780 | Rake 0
Board [Qh 2d 9c]
Seat 1: dimetruk (big blind) folded on the Flop
Seat 3: fonshemis (button) collected (780)
Seat 8: invisible271 (small blind) folded before Flop


PokerStars Hand #228171255542: Tournament #3227151913, $13.70+$1.30 USD Hold'em No Limit - Level VI (80/160) - 2021/07/09 22:26:57 MSK [2021/07/09 15:26:57 ET]
Table '3227151913 1' 9-max Seat #8 is the button
Seat 1: dimetruk (2796 in chips)
Seat 3: fonshemis (8395 in chips)
Seat 8: invisible271 (2309 in chips)
dimetruk: posts the ante 20
fonshemis: posts the ante 20
invisible271: posts the ante 20
dimetruk: posts small blind 80
fonshemis: posts big blind 160
*** HOLE CARDS ***
Dealt to dimetruk [Th 9s]
invisible271: folds
dimetruk: raises 160 to 320
fonshemis: calls 160
*** FLOP *** [3c Jd Td]
dimetruk: bets 350
fonshemis: calls 350
*** TURN *** [3c Jd Td] [Jh]
dimetruk: checks
fonshemis: checks
*** RIVER *** [3c Jd Td Jh] [Tc]
dimetruk: checks
fonshemis: bets 462
dimetruk: calls 462
*** SHOW DOWN ***
fonshemis: shows [Js Qc] (a full house, Jacks full of Tens)
dimetruk: mucks hand
fonshemis collected 2324 from pot
*** SUMMARY ***
Total pot 2324 | Rake 0
Board [3c Jd Td Jh Tc]
Seat 1: dimetruk (small blind) mucked [Th 9s]
Seat 3: fonshemis (big blind) showed [Js Qc] and won (2324) with a full house, Jacks full of Tens
Seat 8: invisible271 (button) folded before Flop (didn't bet)


PokerStars Hand #228171294664: Tournament #3227151913, $13.70+$1.30 USD Hold'em No Limit - Level VI (80/160) - 2021/07/09 22:28:23 MSK [2021/07/09 15:28:23 ET]
Table '3227151913 1' 9-max Seat #3 is the button
Seat 1: dimetruk (1704 in chips)
Seat 3: fonshemis (9827 in chips)
Seat 8: invisible271 (1969 in chips)
dimetruk: posts the ante 20
fonshemis: posts the ante 20
invisible271: posts the ante 20
invisible271: posts small blind 80
dimetruk: posts big blind 160
*** HOLE CARDS ***
Dealt to dimetruk [Ac 5s]
fonshemis: raises 160 to 320
invisible271: folds
dimetruk: calls 160
*** FLOP *** [8s 7h Jh]
dimetruk: checks
fonshemis: bets 257
dimetruk: folds
Uncalled bet (257) returned to fonshemis
fonshemis collected 780 from pot
fonshemis: doesn't show hand
*** SUMMARY ***
Total pot 780 | Rake 0
Board [8s 7h Jh]
Seat 1: dimetruk (big blind) folded on the Flop
Seat 3: fonshemis (button) collected (780)
Seat 8: invisible271 (small blind) folded before Flop


PokerStars Hand #228171304322: Tournament #3227151913, $13.70+$1.30 USD Hold'em No Limit - Level VI (80/160) - 2021/07/09 22:28:44 MSK [2021/07/09 15:28:44 ET]
Table '3227151913 1' 9-max Seat #8 is the button
Seat 1: dimetruk (1364 in chips)
Seat 3: fonshemis (10267 in chips)
Seat 8: invisible271 (1869 in chips)
dimetruk: posts the ante 20
fonshemis: posts the ante 20
invisible271: posts the ante 20
dimetruk: posts small blind 80
fonshemis: posts big blind 160
*** HOLE CARDS ***
Dealt to dimetruk [7c 8d]
invisible271: folds
dimetruk: calls 80
fonshemis: checks
*** FLOP *** [9h Th 6s]
dimetruk: checks
fonshemis: checks
*** TURN *** [9h Th 6s] [Qh]
dimetruk: checks
fonshemis: bets 160
dimetruk: raises 1024 to 1184 and is all-in
fonshemis: folds
Uncalled bet (1024) returned to dimetruk
dimetruk collected 700 from pot
dimetruk: doesn't show hand
*** SUMMARY ***
Total pot 700 | Rake 0
Board [9h Th 6s Qh]
Seat 1: dimetruk (small blind) collected (700)
Seat 3: fonshemis (big blind) folded on the Turn
Seat 8: invisible271 (button) folded before Flop (didn't bet)


PokerStars Hand #228171343132: Tournament #3227151913, $13.70+$1.30 USD Hold'em No Limit - Level VI (80/160) - 2021/07/09 22:30:09 MSK [2021/07/09 15:30:09 ET]
Table '3227151913 1' 9-max Seat #1 is the button
Seat 1: dimetruk (1524 in chips)
Seat 3: fonshemis (11976 in chips)
dimetruk: posts the ante 20
fonshemis: posts the ante 20
dimetruk: posts small blind 80
fonshemis: posts big blind 160
*** HOLE CARDS ***
Dealt to dimetruk [4d 4h]
dimetruk: raises 1344 to 1504 and is all-in
fonshemis: calls 1344
*** FLOP *** [6h 9h Qd]
*** TURN *** [6h 9h Qd] [8h]
*** RIVER *** [6h 9h Qd 8h] [8c]
*** SHOW DOWN ***
fonshemis: shows [Ah Ad] (two pair, Aces and Eights)
dimetruk: shows [4d 4h] (two pair, Eights and Fours)
fonshemis collected 3048 from pot
dimetruk finished the tournament in 2nd place and received $36.99.
fonshemis wins the tournament and receives $61.65 - congratulations!
*** SUMMARY ***
Total pot 3048 | Rake 0
Board [6h 9h Qd 8h 8c]
Seat 1: dimetruk (button) (small blind) showed [4d 4h] and lost with two pair, Eights and Fours
Seat 3: fonshemis (big blind) showed [Ah Ad] and won (3048) with two pair, Aces and Eights


PokerStars Hand #228170530689: Tournament #3227159788, $13.70+$1.30 USD Hold'em No Limit - Level I (10/20) - 2021/07/09 21:59:53 MSK [2021/07/09 14:59:53 ET]
Table '3227159788 1' 9-max Seat #3 is the button
Seat 1: AQUAROC (1494 in chips)
Seat 2: xNatik (1484 in chips)
Seat 3: PhiSlamaJama34 (1434 in chips)
Seat 4: HardRusskij (1561 in chips)
Seat 5: Magmus80 (1494 in chips) is sitting out
Seat 6: berlin1888 (1494 in chips)
Seat 7: dimetruk (1551 in chips)
Seat 8: Ironduke41 (1494 in chips)
Seat 9: alijster (1494 in chips)
AQUAROC: posts the ante 3
xNatik: posts the ante 3
PhiSlamaJama34: posts the ante 3
HardRusskij: posts the ante 3
Magmus80: posts the ante 3
berlin1888: posts the ante 3
dimetruk: posts the ante 3
Ironduke41: posts the ante 3
alijster: posts the ante 3
HardRusskij: posts small blind 10
Magmus80: posts big blind 20
*** HOLE CARDS ***
Dealt to dimetruk [Ts Td]
Magmus80 has returned
berlin1888: calls 20
dimetruk: raises 40 to 60
Ironduke41: folds
alijster: folds
AQUAROC: folds
xNatik: folds
PhiSlamaJama34: folds
HardRusskij: folds
Magmus80: folds
berlin1888: calls 40
*** FLOP *** [5s 8h 9d]
berlin1888: bets 60
dimetruk: raises 1428 to 1488 and is all-in
berlin1888: calls 1371 and is all-in
Uncalled bet (57) returned to dimetruk
*** TURN *** [5s 8h 9d] [5c]
*** RIVER *** [5s 8h 9d 5c] [Qh]
*** SHOW DOWN ***
berlin1888: shows [6c Tc] (a pair of Fives)
dimetruk: shows [Ts Td] (two pair, Tens and Fives)
dimetruk collected 3039 from pot
berlin1888 finished the tournament in 9th place
*** SUMMARY ***
Total pot 3039 | Rake 0
Board [5s 8h 9d 5c Qh]
Seat 1: AQUAROC folded before Flop (didn't bet)
Seat 2: xNatik folded before Flop (didn't bet)
Seat 3: PhiSlamaJama34 (button) folded before Flop (didn't bet)
Seat 4: HardRusskij (small blind) folded before Flop
Seat 5: Magmus80 (big blind) folded before Flop
Seat 6: berlin1888 showed [6c Tc] and lost with a pair of Fives
Seat 7: dimetruk showed [Ts Td] and won (3039) with two pair, Tens and Fives
Seat 8: Ironduke41 folded before Flop (didn't bet)
Seat 9: alijster folded before Flop (didn't bet)


PokerStars Hand #228170552951: Tournament #3227159788, $13.70+$1.30 USD Hold'em No Limit - Level I (10/20) - 2021/07/09 22:00:59 MSK [2021/07/09 15:00:59 ET]
Table '3227159788 1' 9-max Seat #4 is the button
Seat 1: AQUAROC (1491 in chips)
Seat 2: xNatik (1481 in chips)
Seat 3: PhiSlamaJama34 (1431 in chips)
Seat 4: HardRusskij (1548 in chips)
Seat 5: Magmus80 (1471 in chips)
Seat 7: dimetruk (3096 in chips)
Seat 8: Ironduke41 (1491 in chips)
Seat 9: alijster (1491 in chips)
AQUAROC: posts the ante 3
xNatik: posts the ante 3
PhiSlamaJama34: posts the ante 3
HardRusskij: posts the ante 3
Magmus80: posts the ante 3
dimetruk: posts the ante 3
Ironduke41: posts the ante 3
alijster: posts the ante 3
Magmus80: posts small blind 10
dimetruk: posts big blind 20
*** HOLE CARDS ***
Dealt to dimetruk [Qh Ah]
Ironduke41: folds
alijster: calls 20
AQUAROC: folds
xNatik: folds
PhiSlamaJama34: folds
HardRusskij: raises 50 to 70
Magmus80: folds
dimetruk: calls 50
alijster: calls 50
*** FLOP *** [8h 4d 8c]
dimetruk: checks
alijster: checks
HardRusskij: bets 90
dimetruk: calls 90
alijster: calls 90
*** TURN *** [8h 4d 8c] [2c]
dimetruk: checks
alijster: checks
HardRusskij: checks
*** RIVER *** [8h 4d 8c 2c] [9d]
dimetruk: bets 350
alijster: folds
HardRusskij: folds
Uncalled bet (350) returned to dimetruk
dimetruk collected 514 from pot
dimetruk: doesn't show hand
*** SUMMARY ***
Total pot 514 | Rake 0
Board [8h 4d 8c 2c 9d]
Seat 1: AQUAROC folded before Flop (didn't bet)
Seat 2: xNatik folded before Flop (didn't bet)
Seat 3: PhiSlamaJama34 folded before Flop (didn't bet)
Seat 4: HardRusskij (button) folded on the River
Seat 5: Magmus80 (small blind) folded before Flop
Seat 7: dimetruk (big blind) collected (514)
Seat 8: Ironduke41 folded before Flop (didn't bet)
Seat 9: alijster folded on the River


PokerStars Hand #228170603958: Tournament #3227159788, $13.70+$1.30 USD Hold'em No Limit - Level I (10/20) - 2021/07/09 22:03:07 MSK [2021/07/09 15:03:07 ET]
Table '3227159788 1' 9-max Seat #7 is the button
Seat 1: AQUAROC (1485 in chips)
Seat 2: xNatik (1475 in chips)
Seat 3: PhiSlamaJama34 (2079 in chips)
Seat 4: HardRusskij (1382 in chips)
Seat 5: Magmus80 (1455 in chips)
Seat 7: dimetruk (3434 in chips)
Seat 8: Ironduke41 (865 in chips)
Seat 9: alijster (1325 in chips)
AQUAROC: posts the ante 3
xNatik: posts the ante 3
PhiSlamaJama34: posts the ante 3
HardRusskij: posts the ante 3
Magmus80: posts the ante 3
dimetruk: posts the ante 3
Ironduke41: posts the ante 3
alijster: posts the ante 3
Ironduke41: posts small blind 10
alijster: posts big blind 20
*** HOLE CARDS ***
Dealt to dimetruk [9s Js]
AQUAROC: folds
xNatik: folds
PhiSlamaJama34: raises 30 to 50
HardRusskij: folds
Magmus80: folds
dimetruk: calls 50
Ironduke41: folds
alijster: calls 30
*** FLOP *** [Ad 5d Kc]
alijster: checks
PhiSlamaJama34: bets 60
dimetruk: folds
alijster: calls 60
*** TURN *** [Ad 5d Kc] [7c]
alijster: checks
PhiSlamaJama34: bets 100
alijster: calls 100
*** RIVER *** [Ad 5d Kc 7c] [Ac]
alijster: checks
PhiSlamaJama34: checks
*** SHOW DOWN ***
alijster: shows [4h Ah] (three of a kind, Aces)
PhiSlamaJama34: shows [Jc Kh] (two pair, Aces and Kings)
alijster collected 504 from pot
*** SUMMARY ***
Total pot 504 | Rake 0
Board [Ad 5d Kc 7c Ac]
Seat 1: AQUAROC folded before Flop (didn't bet)
Seat 2: xNatik folded before Flop (didn't bet)
Seat 3: PhiSlamaJama34 showed [Jc Kh] and lost with two pair, Aces and Kings
Seat 4: HardRusskij folded before Flop (didn't bet)
Seat 5: Magmus80 folded before Flop (didn't bet)
Seat 7: dimetruk (button) folded on the Flop
Seat 8: Ironduke41 (small blind) folded before Flop
Seat 9: alijster (big blind) showed [4h Ah] and won (504) with three of a kind, Aces


PokerStars Hand #228170708101: Tournament #3227159788, $13.70+$1.30 USD Hold'em No Limit - Level I (10/20) - 2021/07/09 22:07:05 MSK [2021/07/09 15:07:05 ET]
Table '3227159788 1' 9-max Seat #4 is the button
Seat 1: AQUAROC (1437 in chips)
Seat 2: xNatik (1895 in chips)
Seat 3: PhiSlamaJama34 (1481 in chips)
Seat 4: HardRusskij (1472 in chips)
Seat 5: Magmus80 (1417 in chips)
Seat 7: dimetruk (3366 in chips)
Seat 8: Ironduke41 (787 in chips)
Seat 9: alijster (1645 in chips)
AQUAROC: posts the ante 3
xNatik: posts the ante 3
PhiSlamaJama34: posts the ante 3
HardRusskij: posts the ante 3
Magmus80: posts the ante 3
dimetruk: posts the ante 3
Ironduke41: posts the ante 3
alijster: posts the ante 3
Magmus80: posts small blind 10
dimetruk: posts big blind 20
*** HOLE CARDS ***
Dealt to dimetruk [2h 4d]
Ironduke41: folds
alijster: folds
AQUAROC: folds
xNatik: folds
PhiSlamaJama34: raises 40 to 60
HardRusskij: folds
Magmus80: folds
dimetruk: calls 40
*** FLOP *** [Jc 7s As]
dimetruk: checks
PhiSlamaJama34: bets 60
dimetruk: folds
Uncalled bet (60) returned to PhiSlamaJama34
PhiSlamaJama34 collected 154 from pot
*** SUMMARY ***
Total pot 154 | Rake 0
Board [Jc 7s As]
Seat 1: AQUAROC folded before Flop (didn't bet)
Seat 2: xNatik folded before Flop (didn't bet)
Seat 3: PhiSlamaJama34 collected (154)
Seat 4: HardRusskij (button) folded before Flop (didn't bet)
Seat 5: Magmus80 (small blind) folded before Flop
Seat 7: dimetruk (big blind) folded on the Flop
Seat 8: Ironduke41 folded before Flop (didn't bet)
Seat 9: alijster folded before Flop (didn't bet)


PokerStars Hand #228170833165: Tournament #3227159788, $13.70+$1.30 USD Hold'em No Limit - Level II (15/30) - 2021/07/09 22:11:43 MSK [2021/07/09 15:11:43 ET]
Table '3227159788 1' 9-max Seat #4 is the button
Seat 1: AQUAROC (1361 in chips)
Seat 2: xNatik (1574 in chips)
Seat 3: PhiSlamaJama34 (1965 in chips)
Seat 4: HardRusskij (1473 in chips)
Seat 5: Magmus80 (1423 in chips)
Seat 7: dimetruk (3260 in chips)
Seat 8: Ironduke41 (1681 in chips)
Seat 9: alijster (763 in chips)
AQUAROC: posts the ante 4
xNatik: posts the ante 4
PhiSlamaJama34: posts the ante 4
HardRusskij: posts the ante 4
Magmus80: posts the ante 4
dimetruk: posts the ante 4
Ironduke41: posts the ante 4
alijster: posts the ante 4
Magmus80: posts small blind 15
dimetruk: posts big blind 30
*** HOLE CARDS ***
Dealt to dimetruk [Ts 4d]
Ironduke41: folds
alijster: raises 60 to 90
AQUAROC: folds
xNatik: folds
PhiSlamaJama34: calls 90
HardRusskij: folds
Magmus80: folds
dimetruk: calls 60
*** FLOP *** [3s 9d 3c]
dimetruk: checks
alijster: bets 669 and is all-in
PhiSlamaJama34: folds
dimetruk: folds
Uncalled bet (669) returned to alijster
alijster collected 317 from pot
alijster: doesn't show hand
*** SUMMARY ***
Total pot 317 | Rake 0
Board [3s 9d 3c]
Seat 1: AQUAROC folded before Flop (didn't bet)
Seat 2: xNatik folded before Flop (didn't bet)
Seat 3: PhiSlamaJama34 folded on the Flop
Seat 4: HardRusskij (button) folded before Flop (didn't bet)
Seat 5: Magmus80 (small blind) folded before Flop
Seat 7: dimetruk (big blind) folded on the Flop
Seat 8: Ironduke41 folded before Flop (didn't bet)
Seat 9: alijster collected (317)


PokerStars Hand #228170854524: Tournament #3227159788, $13.70+$1.30 USD Hold'em No Limit - Level II (15/30) - 2021/07/09 22:12:30 MSK [2021/07/09 15:12:30 ET]
Table '3227159788 1' 9-max Seat #5 is the button
Seat 1: AQUAROC (1357 in chips)
Seat 2: xNatik (1570 in chips)
Seat 3: PhiSlamaJama34 (1871 in chips)
Seat 4: HardRusskij (1469 in chips)
Seat 5: Magmus80 (1404 in chips)
Seat 7: dimetruk (3166 in chips)
Seat 8: Ironduke41 (1677 in chips)
Seat 9: alijster (986 in chips)
AQUAROC: posts the ante 4
xNatik: posts the ante 4
PhiSlamaJama34: posts the ante 4
HardRusskij: posts the ante 4
Magmus80: posts the ante 4
dimetruk: posts the ante 4
Ironduke41: posts the ante 4
alijster: posts the ante 4
dimetruk: posts small blind 15
Ironduke41: posts big blind 30
*** HOLE CARDS ***
Dealt to dimetruk [Tc Th]
alijster: folds
AQUAROC: folds
xNatik: folds
PhiSlamaJama34: raises 45 to 75
HardRusskij: folds
Magmus80: folds
dimetruk: raises 165 to 240
Ironduke41: folds
PhiSlamaJama34: calls 165
*** FLOP *** [Jh 4d 9c]
dimetruk: checks
PhiSlamaJama34: bets 90
dimetruk: calls 90
*** TURN *** [Jh 4d 9c] [Qc]
dimetruk: checks
PhiSlamaJama34: checks
*** RIVER *** [Jh 4d 9c Qc] [Js]
dimetruk: checks
PhiSlamaJama34: checks
*** SHOW DOWN ***
dimetruk: shows [Tc Th] (two pair, Jacks and Tens)
PhiSlamaJama34: mucks hand
dimetruk collected 722 from pot
*** SUMMARY ***
Total pot 722 | Rake 0
Board [Jh 4d 9c Qc Js]
Seat 1: AQUAROC folded before Flop (didn't bet)
Seat 2: xNatik folded before Flop (didn't bet)
Seat 3: PhiSlamaJama34 mucked [Ah 4s]
Seat 4: HardRusskij folded before Flop (didn't bet)
Seat 5: Magmus80 (button) folded before Flop (didn't bet)
Seat 7: dimetruk (small blind) showed [Tc Th] and won (722) with two pair, Jacks and Tens
Seat 8: Ironduke41 (big blind) folded before Flop
Seat 9: alijster folded before Flop (didn't bet)


PokerStars Hand #228171001239: Tournament #3227159788, $13.70+$1.30 USD Hold'em No Limit - Level III (25/50) - 2021/07/09 22:17:57 MSK [2021/07/09 15:17:57 ET]
Table '3227159788 1' 9-max Seat #4 is the button
Seat 1: AQUAROC (1391 in chips)
Seat 2: xNatik (1452 in chips)
Seat 3: PhiSlamaJama34 (1864 in chips)
Seat 4: HardRusskij (1443 in chips)
Seat 5: Magmus80 (1408 in chips)
Seat 7: dimetruk (3530 in chips)
Seat 8: Ironduke41 (1529 in chips)
Seat 9: alijster (883 in chips)
AQUAROC: posts the ante 6
xNatik: posts the ante 6
PhiSlamaJama34: posts the ante 6
HardRusskij: posts the ante 6
Magmus80: posts the ante 6
dimetruk: posts the ante 6
Ironduke41: posts the ante 6
alijster: posts the ante 6
Magmus80: posts small blind 25
dimetruk: posts big blind 50
*** HOLE CARDS ***
Dealt to dimetruk [3s 2s]
Ironduke41: folds
alijster: folds
AQUAROC: folds
xNatik: folds
PhiSlamaJama34: folds
HardRusskij: raises 50 to 100
Magmus80: folds
dimetruk: calls 50
*** FLOP *** [Ah 9s 5h]
dimetruk: checks
HardRusskij: checks
*** TURN *** [Ah 9s 5h] [7s]
dimetruk: bets 137
HardRusskij: folds
Uncalled bet (137) returned to dimetruk
dimetruk collected 273 from pot
dimetruk: doesn't show hand
*** SUMMARY ***
Total pot 273 | Rake 0
Board [Ah 9s 5h 7s]
Seat 1: AQUAROC folded before Flop (didn't bet)
Seat 2: xNatik folded before Flop (didn't bet)
Seat 3: PhiSlamaJama34 folded before Flop (didn't bet)
Seat 4: HardRusskij (button) folded on the Turn
Seat 5: Magmus80 (small blind) folded before Flop
Seat 7: dimetruk (big blind) collected (273)
Seat 8: Ironduke41 folded before Flop (didn't bet)
Seat 9: alijster folded before Flop (didn't bet)


PokerStars Hand #228171078649: Tournament #3227159788, $13.70+$1.30 USD Hold'em No Limit - Level III (25/50) - 2021/07/09 22:20:47 MSK [2021/07/09 15:20:47 ET]
Table '3227159788 1' 9-max Seat #1 is the button
Seat 1: AQUAROC (2776 in chips)
Seat 2: xNatik (999 in chips)
Seat 3: PhiSlamaJama34 (1840 in chips)
Seat 4: HardRusskij (1319 in chips)
Seat 5: Magmus80 (1209 in chips)
Seat 7: dimetruk (3927 in chips)
Seat 8: Ironduke41 (1430 in chips)
AQUAROC: posts the ante 6
xNatik: posts the ante 6
PhiSlamaJama34: posts the ante 6
HardRusskij: posts the ante 6
Magmus80: posts the ante 6
dimetruk: posts the ante 6
Ironduke41: posts the ante 6
xNatik: posts small blind 25
PhiSlamaJama34: posts big blind 50
*** HOLE CARDS ***
Dealt to dimetruk [Kc Qs]
HardRusskij: folds
Magmus80: folds
dimetruk: raises 50 to 100
Ironduke41: calls 100
AQUAROC: folds
xNatik: folds
PhiSlamaJama34: calls 50
*** FLOP *** [8s 6d 7d]
PhiSlamaJama34: checks
dimetruk: checks
Ironduke41: checks
*** TURN *** [8s 6d 7d] [4d]
PhiSlamaJama34: checks
dimetruk: checks
Ironduke41: checks
*** RIVER *** [8s 6d 7d 4d] [Tc]
PhiSlamaJama34: bets 150
dimetruk: folds
Ironduke41: folds
Uncalled bet (150) returned to PhiSlamaJama34
PhiSlamaJama34 collected 367 from pot
*** SUMMARY ***
Total pot 367 | Rake 0
Board [8s 6d 7d 4d Tc]
Seat 1: AQUAROC (button) folded before Flop (didn't bet)
Seat 2: xNatik (small blind) folded before Flop
Seat 3: PhiSlamaJama34 (big blind) collected (367)
Seat 4: HardRusskij folded before Flop (didn't bet)
Seat 5: Magmus80 folded before Flop (didn't bet)
Seat 7: dimetruk folded on the River
Seat 8: Ironduke41 folded on the River


PokerStars Hand #228171138290: Tournament #3227159788, $13.70+$1.30 USD Hold'em No Limit - Level III (25/50) - 2021/07/09 22:22:59 MSK [2021/07/09 15:22:59 ET]
Table '3227159788 1' 9-max Seat #4 is the button
Seat 1: AQUAROC (1440 in chips)
Seat 2: xNatik (956 in chips)
Seat 3: PhiSlamaJama34 (2181 in chips)
Seat 4: HardRusskij (1226 in chips)
Seat 5: Magmus80 (1141 in chips)
Seat 7: dimetruk (3809 in chips)
Seat 8: Ironduke41 (2747 in chips)
AQUAROC: posts the ante 6
xNatik: posts the ante 6
PhiSlamaJama34: posts the ante 6
HardRusskij: posts the ante 6
Magmus80: posts the ante 6
dimetruk: posts the ante 6
Ironduke41: posts the ante 6
Magmus80: posts small blind 25
dimetruk: posts big blind 50
*** HOLE CARDS ***
Dealt to dimetruk [6h 6c]
Ironduke41: calls 50
AQUAROC: folds
xNatik: folds
PhiSlamaJama34: folds
HardRusskij: raises 50 to 100
Magmus80: calls 75
dimetruk: calls 50
Ironduke41: calls 50
*** FLOP *** [Td Ah 8h]
Magmus80: checks
dimetruk: checks
Ironduke41: checks
HardRusskij: checks
*** TURN *** [Td Ah 8h] [9h]
Magmus80: checks
dimetruk: bets 221
Ironduke41: folds
HardRusskij: folds
Magmus80: raises 221 to 442
dimetruk: folds
Uncalled bet (221) returned to Magmus80
Magmus80 collected 884 from pot
Magmus80: doesn't show hand
*** SUMMARY ***
Total pot 884 | Rake 0
Board [Td Ah 8h 9h]
Seat 1: AQUAROC folded before Flop (didn't bet)
Seat 2: xNatik folded before Flop (didn't bet)
Seat 3: PhiSlamaJama34 folded before Flop (didn't bet)
Seat 4: HardRusskij (button) folded on the Turn
Seat 5: Magmus80 (small blind) collected (884)
Seat 7: dimetruk (big blind) folded on the Turn
Seat 8: Ironduke41 folded on the Turn


PokerStars Hand #228171222303: Tournament #3227159788, $13.70+$1.30 USD Hold'em No Limit - Level III (25/50) - 2021/07/09 22:25:44 MSK [2021/07/09 15:25:44 ET]
Table '3227159788 1' 9-max Seat #7 is the button
Seat 1: AQUAROC (1428 in chips)
Seat 2: xNatik (944 in chips)
Seat 3: PhiSlamaJama34 (2169 in chips)
Seat 4: HardRusskij (1014 in chips)
Seat 5: Magmus80 (2493 in chips)
Seat 7: dimetruk (3451 in chips)
Seat 8: Ironduke41 (2001 in chips)
AQUAROC: posts the ante 6
xNatik: posts the ante 6
PhiSlamaJama34: posts the ante 6
HardRusskij: posts the ante 6
Magmus80: posts the ante 6
dimetruk: posts the ante 6
Ironduke41: posts the ante 6
Ironduke41: posts small blind 25
AQUAROC: posts big blind 50
*** HOLE CARDS ***
Dealt to dimetruk [Jc Ad]
xNatik: folds
PhiSlamaJama34: folds
HardRusskij: folds
Magmus80: folds
dimetruk: raises 50 to 100
Ironduke41: calls 75
AQUAROC: folds
*** FLOP *** [5h 3s 9d]
Ironduke41: checks
dimetruk: bets 146
Ironduke41: folds
Uncalled bet (146) returned to dimetruk
dimetruk collected 292 from pot
dimetruk: doesn't show hand
*** SUMMARY ***
Total pot 292 | Rake 0
Board [5h 3s 9d]
Seat 1: AQUAROC (big blind) folded before Flop
Seat 2: xNatik folded before Flop (didn't bet)
Seat 3: PhiSlamaJama34 folded before Flop (didn't bet)
Seat 4: HardRusskij folded before Flop (didn't bet)
Seat 5: Magmus80 folded before Flop (didn't bet)
Seat 7: dimetruk (button) collected (292)
Seat 8: Ironduke41 (small blind) folded on the Flop


PokerStars Hand #228171306487: Tournament #3227159788, $13.70+$1.30 USD Hold'em No Limit - Level IV (40/80) - 2021/07/09 22:28:49 MSK [2021/07/09 15:28:49 ET]
Table '3227159788 1' 9-max Seat #4 is the button
Seat 1: AQUAROC (1582 in chips)
Seat 2: xNatik (798 in chips)
Seat 3: PhiSlamaJama34 (1841 in chips)
Seat 4: HardRusskij (856 in chips)
Seat 5: Magmus80 (2765 in chips)
Seat 7: dimetruk (3795 in chips)
Seat 8: Ironduke41 (1863 in chips)
AQUAROC: posts the ante 10
xNatik: posts the ante 10
PhiSlamaJama34: posts the ante 10
HardRusskij: posts the ante 10
Magmus80: posts the ante 10
dimetruk: posts the ante 10
Ironduke41: posts the ante 10
Magmus80: posts small blind 40
dimetruk: posts big blind 80
*** HOLE CARDS ***
Dealt to dimetruk [6c 9s]
Ironduke41: raises 80 to 160
AQUAROC: folds
xNatik: folds
PhiSlamaJama34: folds
HardRusskij: folds
Magmus80: folds
dimetruk: calls 80
*** FLOP *** [5c 6h Kc]
dimetruk: checks
Ironduke41: bets 240
dimetruk: calls 240
*** TURN *** [5c 6h Kc] [5h]
dimetruk: checks
Ironduke41: checks
*** RIVER *** [5c 6h Kc 5h] [2d]
dimetruk: bets 455
Ironduke41: calls 455
*** SHOW DOWN ***
dimetruk: shows [6c 9s] (two pair, Sixes and Fives)
Ironduke41: shows [8h 8s] (two pair, Eights and Fives)
Ironduke41 collected 1820 from pot
*** SUMMARY ***
Total pot 1820 | Rake 0
Board [5c 6h Kc 5h 2d]
Seat 1: AQUAROC folded before Flop (didn't bet)
Seat 2: xNatik folded before Flop (didn't bet)
Seat 3: PhiSlamaJama34 folded before Flop (didn't bet)
Seat 4: HardRusskij (button) folded before Flop (didn't bet)
Seat 5: Magmus80 (small blind) folded before Flop
Seat 7: dimetruk (big blind) showed [6c 9s] and lost with two pair, Sixes and Fives
Seat 8: Ironduke41 showed [8h 8s] and won (1820) with two pair, Eights and Fives


PokerStars Hand #228171355058: Tournament #3227159788, $13.70+$1.30 USD Hold'em No Limit - Level IV (40/80) - 2021/07/09 22:30:36 MSK [2021/07/09 15:30:36 ET]
Table '3227159788 1' 9-max Seat #8 is the button
Seat 1: AQUAROC (1472 in chips)
Seat 2: xNatik (1656 in chips)
Seat 3: PhiSlamaJama34 (2001 in chips)
Seat 4: HardRusskij (826 in chips)
Seat 5: Magmus80 (2695 in chips)
Seat 7: dimetruk (2870 in chips)
Seat 8: Ironduke41 (1980 in chips)
AQUAROC: posts the ante 10
xNatik: posts the ante 10
PhiSlamaJama34: posts the ante 10
HardRusskij: posts the ante 10
Magmus80: posts the ante 10
dimetruk: posts the ante 10
Ironduke41: posts the ante 10
AQUAROC: posts small blind 40
xNatik: posts big blind 80
*** HOLE CARDS ***
Dealt to dimetruk [9d 9s]
PhiSlamaJama34: raises 160 to 240
HardRusskij: folds
Magmus80: folds
dimetruk: calls 240
Ironduke41: folds
AQUAROC: folds
xNatik: folds
*** FLOP *** [Qh 2h Ah]
PhiSlamaJama34: checks
dimetruk: bets 235
PhiSlamaJama34: calls 235
*** TURN *** [Qh 2h Ah] [2c]
PhiSlamaJama34: checks
dimetruk: checks
*** RIVER *** [Qh 2h Ah 2c] [Kh]
PhiSlamaJama34: checks
dimetruk: bets 775
PhiSlamaJama34: folds
Uncalled bet (775) returned to dimetruk
dimetruk collected 1140 from pot
dimetruk: doesn't show hand
*** SUMMARY ***
Total pot 1140 | Rake 0
Board [Qh 2h Ah 2c Kh]
Seat 1: AQUAROC (small blind) folded before Flop
Seat 2: xNatik (big blind) folded before Flop
Seat 3: PhiSlamaJama34 folded on the River
Seat 4: HardRusskij folded before Flop (didn't bet)
Seat 5: Magmus80 folded before Flop (didn't bet)
Seat 7: dimetruk collected (1140)
Seat 8: Ironduke41 (button) folded before Flop (didn't bet)


PokerStars Hand #228171411891: Tournament #3227159788, $13.70+$1.30 USD Hold'em No Limit - Level IV (40/80) - 2021/07/09 22:32:40 MSK [2021/07/09 15:32:40 ET]
Table '3227159788 1' 9-max Seat #3 is the button
Seat 1: AQUAROC (1402 in chips)
Seat 2: xNatik (1506 in chips)
Seat 3: PhiSlamaJama34 (2472 in chips)
Seat 5: Magmus80 (2665 in chips)
Seat 7: dimetruk (3505 in chips)
Seat 8: Ironduke41 (1950 in chips)
AQUAROC: posts the ante 10
xNatik: posts the ante 10
PhiSlamaJama34: posts the ante 10
Magmus80: posts the ante 10
dimetruk: posts the ante 10
Ironduke41: posts the ante 10
Magmus80: posts small blind 40
dimetruk: posts big blind 80
*** HOLE CARDS ***
Dealt to dimetruk [7c Ad]
Ironduke41: folds
AQUAROC: folds
xNatik: raises 80 to 160
PhiSlamaJama34: folds
Magmus80: folds
dimetruk: calls 80
*** FLOP *** [7d 2s Qs]
dimetruk: checks
xNatik: bets 168
dimetruk: calls 168
*** TURN *** [7d 2s Qs] [3c]
dimetruk: checks
xNatik: checks
*** RIVER *** [7d 2s Qs 3c] [6d]
dimetruk: checks
xNatik: bets 249
dimetruk: calls 249
*** SHOW DOWN ***
xNatik: shows [9d 8d] (high card Queen)
dimetruk: shows [7c Ad] (a pair of Sevens)
dimetruk collected 1254 from pot
*** SUMMARY ***
Total pot 1254 | Rake 0
Board [7d 2s Qs 3c 6d]
Seat 1: AQUAROC folded before Flop (didn't bet)
Seat 2: xNatik showed [9d 8d] and lost with high card Queen
Seat 3: PhiSlamaJama34 (button) folded before Flop (didn't bet)
Seat 5: Magmus80 (small blind) folded before Flop
Seat 7: dimetruk (big blind) showed [7c Ad] and won (1254) with a pair of Sevens
Seat 8: Ironduke41 folded before Flop (didn't bet)


PokerStars Hand #228171443040: Tournament #3227159788, $13.70+$1.30 USD Hold'em No Limit - Level IV (40/80) - 2021/07/09 22:33:48 MSK [2021/07/09 15:33:48 ET]
Table '3227159788 1' 9-max Seat #5 is the button
Seat 1: AQUAROC (1392 in chips)
Seat 2: xNatik (919 in chips)
Seat 3: PhiSlamaJama34 (2462 in chips)
Seat 5: Magmus80 (2615 in chips)
Seat 7: dimetruk (4172 in chips)
Seat 8: Ironduke41 (1940 in chips)
AQUAROC: posts the ante 10
xNatik: posts the ante 10
PhiSlamaJama34: posts the ante 10
Magmus80: posts the ante 10
dimetruk: posts the ante 10
Ironduke41: posts the ante 10
dimetruk: posts small blind 40
Ironduke41: posts big blind 80
*** HOLE CARDS ***
Dealt to dimetruk [As 5d]
AQUAROC: folds
xNatik: folds
PhiSlamaJama34: folds
Magmus80: folds
dimetruk: raises 80 to 160
Ironduke41: calls 80
*** FLOP *** [Qs 8c 5h]
dimetruk: bets 133
Ironduke41: folds
Uncalled bet (133) returned to dimetruk
dimetruk collected 380 from pot
dimetruk: doesn't show hand
*** SUMMARY ***
Total pot 380 | Rake 0
Board [Qs 8c 5h]
Seat 1: AQUAROC folded before Flop (didn't bet)
Seat 2: xNatik folded before Flop (didn't bet)
Seat 3: PhiSlamaJama34 folded before Flop (didn't bet)
Seat 5: Magmus80 (button) folded before Flop (didn't bet)
Seat 7: dimetruk (small blind) collected (380)
Seat 8: Ironduke41 (big blind) folded on the Flop


PokerStars Hand #228171455546: Tournament #3227159788, $13.70+$1.30 USD Hold'em No Limit - Level IV (40/80) - 2021/07/09 22:34:15 MSK [2021/07/09 15:34:15 ET]
Table '3227159788 1' 9-max Seat #7 is the button
Seat 1: AQUAROC (1382 in chips)
Seat 2: xNatik (909 in chips)
Seat 3: PhiSlamaJama34 (2452 in chips)
Seat 5: Magmus80 (2605 in chips)
Seat 7: dimetruk (4382 in chips)
Seat 8: Ironduke41 (1770 in chips)
AQUAROC: posts the ante 10
xNatik: posts the ante 10
PhiSlamaJama34: posts the ante 10
Magmus80: posts the ante 10
dimetruk: posts the ante 10
Ironduke41: posts the ante 10
Ironduke41: posts small blind 40
AQUAROC: posts big blind 80
*** HOLE CARDS ***
Dealt to dimetruk [Qd Qh]
xNatik: folds
PhiSlamaJama34: folds
Magmus80: folds
dimetruk: raises 80 to 160
Ironduke41: calls 120
AQUAROC: raises 240 to 400
dimetruk: raises 3972 to 4372 and is all-in
Ironduke41: folds
AQUAROC: calls 972 and is all-in
Uncalled bet (3000) returned to dimetruk
*** FLOP *** [4c 2s 7s]
*** TURN *** [4c 2s 7s] [3h]
*** RIVER *** [4c 2s 7s 3h] [Jd]
*** SHOW DOWN ***
AQUAROC: shows [Jh Ad] (a pair of Jacks)
dimetruk: shows [Qd Qh] (a pair of Queens)
dimetruk collected 2964 from pot
AQUAROC finished the tournament in 6th place
*** SUMMARY ***
Total pot 2964 | Rake 0
Board [4c 2s 7s 3h Jd]
Seat 1: AQUAROC (big blind) showed [Jh Ad] and lost with a pair of Jacks
Seat 2: xNatik folded before Flop (didn't bet)
Seat 3: PhiSlamaJama34 folded before Flop (didn't bet)
Seat 5: Magmus80 folded before Flop (didn't bet)
Seat 7: dimetruk (button) showed [Qd Qh] and won (2964) with a pair of Queens
Seat 8: Ironduke41 (small blind) folded before Flop


PokerStars Hand #228171514616: Tournament #3227159788, $13.70+$1.30 USD Hold'em No Limit - Level IV (40/80) - 2021/07/09 22:36:25 MSK [2021/07/09 15:36:25 ET]
Table '3227159788 1' 9-max Seat #3 is the button
Seat 2: xNatik (799 in chips)
Seat 3: PhiSlamaJama34 (2512 in chips)
Seat 5: Magmus80 (2495 in chips)
Seat 7: dimetruk (6114 in chips)
Seat 8: Ironduke41 (1580 in chips)
xNatik: posts the ante 10
PhiSlamaJama34: posts the ante 10
Magmus80: posts the ante 10
dimetruk: posts the ante 10
Ironduke41: posts the ante 10
Magmus80: posts small blind 40
dimetruk: posts big blind 80
*** HOLE CARDS ***
Dealt to dimetruk [8c Kd]
Ironduke41: raises 80 to 160
xNatik: folds
PhiSlamaJama34: calls 160
Magmus80: folds
dimetruk: calls 80
*** FLOP *** [Tc 2s 6s]
dimetruk: checks
Ironduke41: checks
PhiSlamaJama34: bets 240
dimetruk: folds
Ironduke41: folds
Uncalled bet (240) returned to PhiSlamaJama34
PhiSlamaJama34 collected 570 from pot
*** SUMMARY ***
Total pot 570 | Rake 0
Board [Tc 2s 6s]
Seat 2: xNatik folded before Flop (didn't bet)
Seat 3: PhiSlamaJama34 (button) collected (570)
Seat 5: Magmus80 (small blind) folded before Flop
Seat 7: dimetruk (big blind) folded on the Flop
Seat 8: Ironduke41 folded on the Flop


PokerStars Hand #228171529779: Tournament #3227159788, $13.70+$1.30 USD Hold'em No Limit - Level IV (40/80) - 2021/07/09 22:36:59 MSK [2021/07/09 15:36:59 ET]
Table '3227159788 1' 9-max Seat #5 is the button
Seat 2: xNatik (789 in chips)
Seat 3: PhiSlamaJama34 (2912 in chips)
Seat 5: Magmus80 (2445 in chips)
Seat 7: dimetruk (5944 in chips)
Seat 8: Ironduke41 (1410 in chips)
xNatik: posts the ante 10
PhiSlamaJama34: posts the ante 10
Magmus80: posts the ante 10
dimetruk: posts the ante 10
Ironduke41: posts the ante 10
dimetruk: posts small blind 40
Ironduke41: posts big blind 80
*** HOLE CARDS ***
Dealt to dimetruk [2s Kh]
xNatik: folds
PhiSlamaJama34: folds
Magmus80: folds
dimetruk: raises 80 to 160
Ironduke41: calls 80
*** FLOP *** [Kd 4s 8c]
dimetruk: bets 185
Ironduke41: folds
Uncalled bet (185) returned to dimetruk
dimetruk collected 370 from pot
dimetruk: doesn't show hand
*** SUMMARY ***
Total pot 370 | Rake 0
Board [Kd 4s 8c]
Seat 2: xNatik folded before Flop (didn't bet)
Seat 3: PhiSlamaJama34 folded before Flop (didn't bet)
Seat 5: Magmus80 (button) folded before Flop (didn't bet)
Seat 7: dimetruk (small blind) collected (370)
Seat 8: Ironduke41 (big blind) folded on the Flop


PokerStars Hand #228171584654: Tournament #3227159788, $13.70+$1.30 USD Hold'em No Limit - Level V (60/120) - 2021/07/09 22:38:59 MSK [2021/07/09 15:38:59 ET]
Table '3227159788 1' 9-max Seat #5 is the button
Seat 3: PhiSlamaJama34 (2921 in chips)
Seat 5: Magmus80 (3355 in chips)
Seat 7: dimetruk (6224 in chips)
Seat 8: Ironduke41 (1000 in chips)
PhiSlamaJama34: posts the ante 15
Magmus80: posts the ante 15
dimetruk: posts the ante 15
Ironduke41: posts the ante 15
dimetruk: posts small blind 60
Ironduke41: posts big blind 120
*** HOLE CARDS ***
Dealt to dimetruk [Qc 5c]
PhiSlamaJama34: folds
Magmus80: folds
dimetruk: raises 6089 to 6209 and is all-in
Ironduke41: calls 865 and is all-in
Uncalled bet (5224) returned to dimetruk
*** FLOP *** [7d 9d Kd]
*** TURN *** [7d 9d Kd] [3d]
*** RIVER *** [7d 9d Kd 3d] [8s]
*** SHOW DOWN ***
dimetruk: shows [Qc 5c] (high card King)
Ironduke41: shows [Jd Ts] (a flush, King high)
Ironduke41 collected 2030 from pot
*** SUMMARY ***
Total pot 2030 | Rake 0
Board [7d 9d Kd 3d 8s]
Seat 3: PhiSlamaJama34 folded before Flop (didn't bet)
Seat 5: Magmus80 (button) folded before Flop (didn't bet)
Seat 7: dimetruk (small blind) showed [Qc 5c] and lost with high card King
Seat 8: Ironduke41 (big blind) showed [Jd Ts] and won (2030) with a flush, King high


PokerStars Hand #228171594716: Tournament #3227159788, $13.70+$1.30 USD Hold'em No Limit - Level V (60/120) - 2021/07/09 22:39:22 MSK [2021/07/09 15:39:22 ET]
Table '3227159788 1' 9-max Seat #7 is the button
Seat 3: PhiSlamaJama34 (2906 in chips)
Seat 5: Magmus80 (3340 in chips)
Seat 7: dimetruk (5224 in chips)
Seat 8: Ironduke41 (2030 in chips)
PhiSlamaJama34: posts the ante 15
Magmus80: posts the ante 15
dimetruk: posts the ante 15
Ironduke41: posts the ante 15
Ironduke41: posts small blind 60
PhiSlamaJama34: posts big blind 120
*** HOLE CARDS ***
Dealt to dimetruk [Qh Jh]
Magmus80: folds
dimetruk: raises 120 to 240
Ironduke41: calls 180
PhiSlamaJama34: calls 120
*** FLOP *** [Tc Qd Ac]
Ironduke41: checks
PhiSlamaJama34: checks
dimetruk: bets 273
Ironduke41: folds
PhiSlamaJama34: calls 273
*** TURN *** [Tc Qd Ac] [7h]
PhiSlamaJama34: checks
dimetruk: bets 663
PhiSlamaJama34: calls 663
*** RIVER *** [Tc Qd Ac 7h] [Th]
PhiSlamaJama34: checks
dimetruk: checks
*** SHOW DOWN ***
PhiSlamaJama34: shows [2c As] (two pair, Aces and Tens)
dimetruk: mucks hand
PhiSlamaJama34 collected 2652 from pot
*** SUMMARY ***
Total pot 2652 | Rake 0
Board [Tc Qd Ac 7h Th]
Seat 3: PhiSlamaJama34 (big blind) showed [2c As] and won (2652) with two pair, Aces and Tens
Seat 5: Magmus80 folded before Flop (didn't bet)
Seat 7: dimetruk (button) mucked [Qh Jh]
Seat 8: Ironduke41 (small blind) folded on the Flop


PokerStars Hand #228171616494: Tournament #3227159788, $13.70+$1.30 USD Hold'em No Limit - Level V (60/120) - 2021/07/09 22:40:09 MSK [2021/07/09 15:40:09 ET]
Table '3227159788 1' 9-max Seat #8 is the button
Seat 3: PhiSlamaJama34 (4367 in chips)
Seat 5: Magmus80 (3325 in chips)
Seat 7: dimetruk (4033 in chips)
Seat 8: Ironduke41 (1775 in chips)
PhiSlamaJama34: posts the ante 15
Magmus80: posts the ante 15
dimetruk: posts the ante 15
Ironduke41: posts the ante 15
PhiSlamaJama34: posts small blind 60
Magmus80: posts big blind 120
*** HOLE CARDS ***
Dealt to dimetruk [Qd Kd]
dimetruk: raises 120 to 240
Ironduke41: folds
PhiSlamaJama34: calls 180
Magmus80: folds
*** FLOP *** [9h 2d 8h]
PhiSlamaJama34: checks
dimetruk: checks
*** TURN *** [9h 2d 8h] [Ks]
PhiSlamaJama34: bets 240
dimetruk: calls 240
*** RIVER *** [9h 2d 8h Ks] [3s]
PhiSlamaJama34: checks
dimetruk: bets 570
PhiSlamaJama34: folds
Uncalled bet (570) returned to dimetruk
dimetruk collected 1140 from pot
dimetruk: doesn't show hand
*** SUMMARY ***
Total pot 1140 | Rake 0
Board [9h 2d 8h Ks 3s]
Seat 3: PhiSlamaJama34 (small blind) folded on the River
Seat 5: Magmus80 (big blind) folded before Flop
Seat 7: dimetruk collected (1140)
Seat 8: Ironduke41 (button) folded before Flop (didn't bet)


PokerStars Hand #228171652750: Tournament #3227159788, $13.70+$1.30 USD Hold'em No Limit - Level V (60/120) - 2021/07/09 22:41:28 MSK [2021/07/09 15:41:28 ET]
Table '3227159788 1' 9-max Seat #5 is the button
Seat 3: PhiSlamaJama34 (5842 in chips)
Seat 5: Magmus80 (3115 in chips)
Seat 7: dimetruk (4543 in chips)
PhiSlamaJama34: posts the ante 15
Magmus80: posts the ante 15
dimetruk: posts the ante 15
dimetruk: posts small blind 60
PhiSlamaJama34: posts big blind 120
*** HOLE CARDS ***
Dealt to dimetruk [Kh 4d]
Magmus80: folds
dimetruk: raises 120 to 240
PhiSlamaJama34: calls 120
*** FLOP *** [3c 8s 6c]
dimetruk: bets 263
PhiSlamaJama34: calls 263
*** TURN *** [3c 8s 6c] [Ac]
dimetruk: bets 715
PhiSlamaJama34: calls 715
*** RIVER *** [3c 8s 6c Ac] [2c]
dimetruk: checks
PhiSlamaJama34: checks
*** SHOW DOWN ***
dimetruk: shows [Kh 4d] (high card Ace)
PhiSlamaJama34: shows [As 9d] (a pair of Aces)
PhiSlamaJama34 collected 2481 from pot
*** SUMMARY ***
Total pot 2481 | Rake 0
Board [3c 8s 6c Ac 2c]
Seat 3: PhiSlamaJama34 (big blind) showed [As 9d] and won (2481) with a pair of Aces
Seat 5: Magmus80 (button) folded before Flop (didn't bet)
Seat 7: dimetruk (small blind) showed [Kh 4d] and lost with high card Ace


PokerStars Hand #228171685459: Tournament #3227159788, $13.70+$1.30 USD Hold'em No Limit - Level V (60/120) - 2021/07/09 22:42:37 MSK [2021/07/09 15:42:37 ET]
Table '3227159788 1' 9-max Seat #3 is the button
Seat 3: PhiSlamaJama34 (7300 in chips)
Seat 5: Magmus80 (3190 in chips)
Seat 7: dimetruk (3010 in chips)
PhiSlamaJama34: posts the ante 15
Magmus80: posts the ante 15
dimetruk: posts the ante 15
Magmus80: posts small blind 60
dimetruk: posts big blind 120
*** HOLE CARDS ***
Dealt to dimetruk [5h 2h]
PhiSlamaJama34: raises 180 to 300
Magmus80: folds
dimetruk: calls 180
*** FLOP *** [8d 8s Qd]
dimetruk: checks
PhiSlamaJama34: bets 240
dimetruk: folds
Uncalled bet (240) returned to PhiSlamaJama34
PhiSlamaJama34 collected 705 from pot
*** SUMMARY ***
Total pot 705 | Rake 0
Board [8d 8s Qd]
Seat 3: PhiSlamaJama34 (button) collected (705)
Seat 5: Magmus80 (small blind) folded before Flop
Seat 7: dimetruk (big blind) folded on the Flop


PokerStars Hand #228171693162: Tournament #3227159788, $13.70+$1.30 USD Hold'em No Limit - Level V (60/120) - 2021/07/09 22:42:54 MSK [2021/07/09 15:42:54 ET]
Table '3227159788 1' 9-max Seat #5 is the button
Seat 3: PhiSlamaJama34 (7690 in chips)
Seat 5: Magmus80 (3115 in chips)
Seat 7: dimetruk (2695 in chips)
PhiSlamaJama34: posts the ante 15
Magmus80: posts the ante 15
dimetruk: posts the ante 15
dimetruk: posts small blind 60
PhiSlamaJama34: posts big blind 120
*** HOLE CARDS ***
Dealt to dimetruk [3h Kd]
Magmus80: folds
dimetruk: calls 60
PhiSlamaJama34: checks
*** FLOP *** [Th 5h 7s]
dimetruk: bets 120
PhiSlamaJama34: folds
Uncalled bet (120) returned to dimetruk
dimetruk collected 285 from pot
dimetruk: doesn't show hand
*** SUMMARY ***
Total pot 285 | Rake 0
Board [Th 5h 7s]
Seat 3: PhiSlamaJama34 (big blind) folded on the Flop
Seat 5: Magmus80 (button) folded before Flop (didn't bet)
Seat 7: dimetruk (small blind) collected (285)


PokerStars Hand #228171720688: Tournament #3227159788, $13.70+$1.30 USD Hold'em No Limit - Level V (60/120) - 2021/07/09 22:43:54 MSK [2021/07/09 15:43:54 ET]
Table '3227159788 1' 9-max Seat #5 is the button
Seat 3: PhiSlamaJama34 (8530 in chips)
Seat 5: Magmus80 (2050 in chips)
Seat 7: dimetruk (2920 in chips)
PhiSlamaJama34: posts the ante 15
Magmus80: posts the ante 15
dimetruk: posts the ante 15
dimetruk: posts small blind 60
PhiSlamaJama34: posts big blind 120
*** HOLE CARDS ***
Dealt to dimetruk [9h Jd]
Magmus80: folds
dimetruk: calls 60
PhiSlamaJama34: checks
*** FLOP *** [Kd Ad 3h]
dimetruk: bets 120
PhiSlamaJama34: folds
Uncalled bet (120) returned to dimetruk
dimetruk collected 285 from pot
dimetruk: doesn't show hand
*** SUMMARY ***
Total pot 285 | Rake 0
Board [Kd Ad 3h]
Seat 3: PhiSlamaJama34 (big blind) folded on the Flop
Seat 5: Magmus80 (button) folded before Flop (didn't bet)
Seat 7: dimetruk (small blind) collected (285)


PokerStars Hand #228171746695: Tournament #3227159788, $13.70+$1.30 USD Hold'em No Limit - Level V (60/120) - 2021/07/09 22:44:31 MSK [2021/07/09 15:44:31 ET]
Table '3227159788 1' 9-max Seat #5 is the button
Seat 3: PhiSlamaJama34 (8305 in chips)
Seat 5: Magmus80 (1825 in chips)
Seat 7: dimetruk (3370 in chips)
PhiSlamaJama34: posts the ante 15
Magmus80: posts the ante 15
dimetruk: posts the ante 15
dimetruk: posts small blind 60
PhiSlamaJama34: posts big blind 120
*** HOLE CARDS ***
Dealt to dimetruk [8d Th]
Magmus80: folds
dimetruk: raises 120 to 240
PhiSlamaJama34: calls 120
*** FLOP *** [5c 3h 7d]
dimetruk: bets 263
PhiSlamaJama34: calls 263
*** TURN *** [5c 3h 7d] [Kd]
dimetruk: checks
PhiSlamaJama34: bets 360
dimetruk: folds
Uncalled bet (360) returned to PhiSlamaJama34
PhiSlamaJama34 collected 1051 from pot
*** SUMMARY ***
Total pot 1051 | Rake 0
Board [5c 3h 7d Kd]
Seat 3: PhiSlamaJama34 (big blind) collected (1051)
Seat 5: Magmus80 (button) folded before Flop (didn't bet)
Seat 7: dimetruk (small blind) folded on the Turn


PokerStars Hand #228171787635: Tournament #3227159788, $13.70+$1.30 USD Hold'em No Limit - Level V (60/120) - 2021/07/09 22:46:01 MSK [2021/07/09 15:46:01 ET]
Table '3227159788 1' 9-max Seat #7 is the button
Seat 3: PhiSlamaJama34 (9063 in chips)
Seat 5: Magmus80 (1585 in chips)
Seat 7: dimetruk (2852 in chips)
PhiSlamaJama34: posts the ante 15
Magmus80: posts the ante 15
dimetruk: posts the ante 15
PhiSlamaJama34: posts small blind 60
Magmus80: posts big blind 120
*** HOLE CARDS ***
Dealt to dimetruk [3s 3c]
dimetruk: raises 120 to 240
PhiSlamaJama34: calls 180
Magmus80: calls 120
*** FLOP *** [9c Ac 8d]
PhiSlamaJama34: checks
Magmus80: checks
dimetruk: bets 268
PhiSlamaJama34: raises 452 to 720
Magmus80: folds
dimetruk: folds
Uncalled bet (452) returned to PhiSlamaJama34
PhiSlamaJama34 collected 1301 from pot
*** SUMMARY ***
Total pot 1301 | Rake 0
Board [9c Ac 8d]
Seat 3: PhiSlamaJama34 (small blind) collected (1301)
Seat 5: Magmus80 (big blind) folded on the Flop
Seat 7: dimetruk (button) folded on the Flop


PokerStars Hand #228171811582: Tournament #3227159788, $13.70+$1.30 USD Hold'em No Limit - Level V (60/120) - 2021/07/09 22:46:53 MSK [2021/07/09 15:46:53 ET]
Table '3227159788 1' 9-max Seat #3 is the button
Seat 3: PhiSlamaJama34 (9616 in chips)
Seat 5: Magmus80 (1555 in chips)
Seat 7: dimetruk (2329 in chips)
PhiSlamaJama34: posts the ante 15
Magmus80: posts the ante 15
dimetruk: posts the ante 15
Magmus80: posts small blind 60
dimetruk: posts big blind 120
*** HOLE CARDS ***
Dealt to dimetruk [Qc Tc]
PhiSlamaJama34: folds
Magmus80: raises 240 to 360
dimetruk: calls 240
*** FLOP *** [6h Th Td]
Magmus80: bets 383
dimetruk: raises 1571 to 1954 and is all-in
Magmus80: calls 797 and is all-in
Uncalled bet (774) returned to dimetruk
*** TURN *** [6h Th Td] [Ts]
*** RIVER *** [6h Th Td Ts] [Kd]
*** SHOW DOWN ***
Magmus80: shows [Js Jh] (a full house, Tens full of Jacks)
dimetruk: shows [Qc Tc] (four of a kind, Tens)
dimetruk collected 3125 from pot
Magmus80 finished the tournament in 3rd place and received $24.66.
*** SUMMARY ***
Total pot 3125 | Rake 0
Board [6h Th Td Ts Kd]
Seat 3: PhiSlamaJama34 (button) folded before Flop (didn't bet)
Seat 5: Magmus80 (small blind) showed [Js Jh] and lost with a full house, Tens full of Jacks
Seat 7: dimetruk (big blind) showed [Qc Tc] and won (3125) with four of a kind, Tens


PokerStars Hand #228171829708: Tournament #3227159788, $13.70+$1.30 USD Hold'em No Limit - Level VI (80/160) - 2021/07/09 22:47:33 MSK [2021/07/09 15:47:33 ET]
Table '3227159788 1' 9-max Seat #3 is the button
Seat 3: PhiSlamaJama34 (9676 in chips)
Seat 7: dimetruk (3824 in chips)
PhiSlamaJama34: posts the ante 20
dimetruk: posts the ante 20
PhiSlamaJama34: posts small blind 80
dimetruk: posts big blind 160
*** HOLE CARDS ***
Dealt to dimetruk [7c Kd]
PhiSlamaJama34: calls 80
dimetruk: checks
*** FLOP *** [Tc 5h 3c]
dimetruk: checks
PhiSlamaJama34: bets 320
dimetruk: folds
Uncalled bet (320) returned to PhiSlamaJama34
PhiSlamaJama34 collected 360 from pot
*** SUMMARY ***
Total pot 360 | Rake 0
Board [Tc 5h 3c]
Seat 3: PhiSlamaJama34 (button) (small blind) collected (360)
Seat 7: dimetruk (big blind) folded on the Flop


PokerStars Hand #228171843023: Tournament #3227159788, $13.70+$1.30 USD Hold'em No Limit - Level VI (80/160) - 2021/07/09 22:48:02 MSK [2021/07/09 15:48:02 ET]
Table '3227159788 1' 9-max Seat #7 is the button
Seat 3: PhiSlamaJama34 (10136 in chips)
Seat 7: dimetruk (3364 in chips)
PhiSlamaJama34: posts the ante 20
dimetruk: posts the ante 20
dimetruk: posts small blind 80
PhiSlamaJama34: posts big blind 160
*** HOLE CARDS ***
Dealt to dimetruk [Jc 7d]
dimetruk: raises 160 to 320
PhiSlamaJama34: calls 160
*** FLOP *** [Qh Ac Kh]
PhiSlamaJama34: checks
dimetruk: checks
*** TURN *** [Qh Ac Kh] [Ad]
PhiSlamaJama34: checks
dimetruk: bets 340
PhiSlamaJama34: folds
Uncalled bet (340) returned to dimetruk
dimetruk collected 680 from pot
dimetruk: doesn't show hand
*** SUMMARY ***
Total pot 680 | Rake 0
Board [Qh Ac Kh Ad]
Seat 3: PhiSlamaJama34 (big blind) folded on the Turn
Seat 7: dimetruk (button) (small blind) collected (680)


PokerStars Hand #228171869997: Tournament #3227159788, $13.70+$1.30 USD Hold'em No Limit - Level VI (80/160) - 2021/07/09 22:48:48 MSK [2021/07/09 15:48:48 ET]
Table '3227159788 1' 9-max Seat #7 is the button
Seat 3: PhiSlamaJama34 (9936 in chips)
Seat 7: dimetruk (3564 in chips)
PhiSlamaJama34: posts the ante 20
dimetruk: posts the ante 20
dimetruk: posts small blind 80
PhiSlamaJama34: posts big blind 160
*** HOLE CARDS ***
Dealt to dimetruk [9s 5s]
dimetruk: raises 160 to 320
PhiSlamaJama34: calls 160
*** FLOP *** [3s 3d 3c]
PhiSlamaJama34: checks
dimetruk: checks
*** TURN *** [3s 3d 3c] [6c]
PhiSlamaJama34: bets 320
dimetruk: folds
Uncalled bet (320) returned to PhiSlamaJama34
PhiSlamaJama34 collected 680 from pot
*** SUMMARY ***
Total pot 680 | Rake 0
Board [3s 3d 3c 6c]
Seat 3: PhiSlamaJama34 (big blind) collected (680)
Seat 7: dimetruk (button) (small blind) folded on the Turn


PokerStars Hand #228171893154: Tournament #3227159788, $13.70+$1.30 USD Hold'em No Limit - Level VI (80/160) - 2021/07/09 22:49:39 MSK [2021/07/09 15:49:39 ET]
Table '3227159788 1' 9-max Seat #7 is the button
Seat 3: PhiSlamaJama34 (9416 in chips)
Seat 7: dimetruk (4084 in chips)
PhiSlamaJama34: posts the ante 20
dimetruk: posts the ante 20
dimetruk: posts small blind 80
PhiSlamaJama34: posts big blind 160
*** HOLE CARDS ***
Dealt to dimetruk [7h Qc]
dimetruk: raises 160 to 320
PhiSlamaJama34: calls 160
*** FLOP *** [9s 3s 8s]
PhiSlamaJama34: checks
dimetruk: bets 340
PhiSlamaJama34: calls 340
*** TURN *** [9s 3s 8s] [Qh]
PhiSlamaJama34: checks
dimetruk: bets 680
PhiSlamaJama34: calls 680
*** RIVER *** [9s 3s 8s Qh] [Ac]
PhiSlamaJama34: checks
dimetruk: checks
*** SHOW DOWN ***
PhiSlamaJama34: shows [7c 9d] (a pair of Nines)
dimetruk: shows [7h Qc] (a pair of Queens)
dimetruk collected 2720 from pot
*** SUMMARY ***
Total pot 2720 | Rake 0
Board [9s 3s 8s Qh Ac]
Seat 3: PhiSlamaJama34 (big blind) showed [7c 9d] and lost with a pair of Nines
Seat 7: dimetruk (button) (small blind) showed [7h Qc] and won (2720) with a pair of Queens


PokerStars Hand #228171906836: Tournament #3227159788, $13.70+$1.30 USD Hold'em No Limit - Level VI (80/160) - 2021/07/09 22:50:09 MSK [2021/07/09 15:50:09 ET]
Table '3227159788 1' 9-max Seat #7 is the button
Seat 3: PhiSlamaJama34 (8236 in chips)
Seat 7: dimetruk (5264 in chips)
PhiSlamaJama34: posts the ante 20
dimetruk: posts the ante 20
dimetruk: posts small blind 80
PhiSlamaJama34: posts big blind 160
*** HOLE CARDS ***
Dealt to dimetruk [Tc 7h]
dimetruk: raises 160 to 320
PhiSlamaJama34: calls 160
*** FLOP *** [9h 4c Ac]
PhiSlamaJama34: checks
dimetruk: bets 238
PhiSlamaJama34: calls 238
*** TURN *** [9h 4c Ac] [7d]
PhiSlamaJama34: checks
dimetruk: bets 578
PhiSlamaJama34: folds
Uncalled bet (578) returned to dimetruk
dimetruk collected 1156 from pot
dimetruk: doesn't show hand
*** SUMMARY ***
Total pot 1156 | Rake 0
Board [9h 4c Ac 7d]
Seat 3: PhiSlamaJama34 (big blind) folded on the Turn
Seat 7: dimetruk (button) (small blind) collected (1156)


PokerStars Hand #228171917389: Tournament #3227159788, $13.70+$1.30 USD Hold'em No Limit - Level VI (80/160) - 2021/07/09 22:50:32 MSK [2021/07/09 15:50:32 ET]
Table '3227159788 1' 9-max Seat #3 is the button
Seat 3: PhiSlamaJama34 (7658 in chips)
Seat 7: dimetruk (5842 in chips)
PhiSlamaJama34: posts the ante 20
dimetruk: posts the ante 20
PhiSlamaJama34: posts small blind 80
dimetruk: posts big blind 160
*** HOLE CARDS ***
Dealt to dimetruk [Th 7s]
PhiSlamaJama34: raises 160 to 320
dimetruk: calls 160
*** FLOP *** [8h 7d 2c]
dimetruk: checks
PhiSlamaJama34: bets 320
dimetruk: calls 320
*** TURN *** [8h 7d 2c] [5h]
dimetruk: checks
PhiSlamaJama34: checks
*** RIVER *** [8h 7d 2c 5h] [9c]
dimetruk: checks
PhiSlamaJama34: checks
*** SHOW DOWN ***
dimetruk: shows [Th 7s] (a pair of Sevens)
PhiSlamaJama34: shows [Jc Kd] (high card King)
dimetruk collected 1320 from pot
*** SUMMARY ***
Total pot 1320 | Rake 0
Board [8h 7d 2c 5h 9c]
Seat 3: PhiSlamaJama34 (button) (small blind) showed [Jc Kd] and lost with high card King
Seat 7: dimetruk (big blind) showed [Th 7s] and won (1320) with a pair of Sevens


PokerStars Hand #228171926267: Tournament #3227159788, $13.70+$1.30 USD Hold'em No Limit - Level VI (80/160) - 2021/07/09 22:50:52 MSK [2021/07/09 15:50:52 ET]
Table '3227159788 1' 9-max Seat #7 is the button
Seat 3: PhiSlamaJama34 (6998 in chips)
Seat 7: dimetruk (6502 in chips)
PhiSlamaJama34: posts the ante 20
dimetruk: posts the ante 20
dimetruk: posts small blind 80
PhiSlamaJama34: posts big blind 160
*** HOLE CARDS ***
Dealt to dimetruk [8h 3h]
dimetruk: raises 160 to 320
PhiSlamaJama34: calls 160
*** FLOP *** [Ac Ah 3s]
PhiSlamaJama34: checks
dimetruk: bets 238
PhiSlamaJama34: calls 238
*** TURN *** [Ac Ah 3s] [5c]
PhiSlamaJama34: checks
dimetruk: bets 578
PhiSlamaJama34: raises 578 to 1156
dimetruk: folds
Uncalled bet (578) returned to PhiSlamaJama34
PhiSlamaJama34 collected 2312 from pot
*** SUMMARY ***
Total pot 2312 | Rake 0
Board [Ac Ah 3s 5c]
Seat 3: PhiSlamaJama34 (big blind) collected (2312)
Seat 7: dimetruk (button) (small blind) folded on the Turn


PokerStars Hand #228171935150: Tournament #3227159788, $13.70+$1.30 USD Hold'em No Limit - Level VI (80/160) - 2021/07/09 22:51:12 MSK [2021/07/09 15:51:12 ET]
Table '3227159788 1' 9-max Seat #3 is the button
Seat 3: PhiSlamaJama34 (8154 in chips)
Seat 7: dimetruk (5346 in chips)
PhiSlamaJama34: posts the ante 20
dimetruk: posts the ante 20
PhiSlamaJama34: posts small blind 80
dimetruk: posts big blind 160
*** HOLE CARDS ***
Dealt to dimetruk [2h As]
PhiSlamaJama34: raises 160 to 320
dimetruk: calls 160
*** FLOP *** [6s 6h 3h]
dimetruk: checks
PhiSlamaJama34: bets 320
dimetruk: calls 320
*** TURN *** [6s 6h 3h] [5d]
dimetruk: checks
PhiSlamaJama34: bets 800
dimetruk: calls 800
*** RIVER *** [6s 6h 3h 5d] [9c]
dimetruk: checks
PhiSlamaJama34: checks
*** SHOW DOWN ***
dimetruk: shows [2h As] (a pair of Sixes)
PhiSlamaJama34: shows [Ac Ad] (two pair, Aces and Sixes)
PhiSlamaJama34 collected 2920 from pot
*** SUMMARY ***
Total pot 2920 | Rake 0
Board [6s 6h 3h 5d 9c]
Seat 3: PhiSlamaJama34 (button) (small blind) showed [Ac Ad] and won (2920) with two pair, Aces and Sixes
Seat 7: dimetruk (big blind) showed [2h As] and lost with a pair of Sixes


PokerStars Hand #228171946868: Tournament #3227159788, $13.70+$1.30 USD Hold'em No Limit - Level VI (80/160) - 2021/07/09 22:51:37 MSK [2021/07/09 15:51:37 ET]
Table '3227159788 1' 9-max Seat #7 is the button
Seat 3: PhiSlamaJama34 (9614 in chips)
Seat 7: dimetruk (3886 in chips)
PhiSlamaJama34: posts the ante 20
dimetruk: posts the ante 20
dimetruk: posts small blind 80
PhiSlamaJama34: posts big blind 160
*** HOLE CARDS ***
Dealt to dimetruk [3c 3s]
dimetruk: raises 160 to 320
PhiSlamaJama34: calls 160
*** FLOP *** [6d Ac 8h]
PhiSlamaJama34: checks
dimetruk: bets 238
PhiSlamaJama34: calls 238
*** TURN *** [6d Ac 8h] [5h]
PhiSlamaJama34: checks
dimetruk: checks
*** RIVER *** [6d Ac 8h 5h] [2d]
PhiSlamaJama34: bets 480
dimetruk: calls 480
*** SHOW DOWN ***
PhiSlamaJama34: shows [6c Kc] (a pair of Sixes)
dimetruk: mucks hand
PhiSlamaJama34 collected 2116 from pot
*** SUMMARY ***
Total pot 2116 | Rake 0
Board [6d Ac 8h 5h 2d]
Seat 3: PhiSlamaJama34 (big blind) showed [6c Kc] and won (2116) with a pair of Sixes
Seat 7: dimetruk (button) (small blind) mucked [3c 3s]


PokerStars Hand #228171957541: Tournament #3227159788, $13.70+$1.30 USD Hold'em No Limit - Level VI (80/160) - 2021/07/09 22:52:01 MSK [2021/07/09 15:52:01 ET]
Table '3227159788 1' 9-max Seat #7 is the button
Seat 3: PhiSlamaJama34 (10572 in chips)
Seat 7: dimetruk (2928 in chips)
PhiSlamaJama34: posts the ante 20
dimetruk: posts the ante 20
dimetruk: posts small blind 80
PhiSlamaJama34: posts big blind 160
*** HOLE CARDS ***
Dealt to dimetruk [6h 9h]
dimetruk: raises 160 to 320
PhiSlamaJama34: calls 160
*** FLOP *** [9d Jc 4c]
PhiSlamaJama34: checks
dimetruk: bets 340
PhiSlamaJama34: calls 340
*** TURN *** [9d Jc 4c] [8d]
PhiSlamaJama34: checks
dimetruk: bets 680
PhiSlamaJama34: folds
Uncalled bet (680) returned to dimetruk
dimetruk collected 1360 from pot
dimetruk: doesn't show hand
*** SUMMARY ***
Total pot 1360 | Rake 0
Board [9d Jc 4c 8d]
Seat 3: PhiSlamaJama34 (big blind) folded on the Turn
Seat 7: dimetruk (button) (small blind) collected (1360)


PokerStars Hand #228171969576: Tournament #3227159788, $13.70+$1.30 USD Hold'em No Limit - Level VI (80/160) - 2021/07/09 22:52:27 MSK [2021/07/09 15:52:27 ET]
Table '3227159788 1' 9-max Seat #7 is the button
Seat 3: PhiSlamaJama34 (10072 in chips)
Seat 7: dimetruk (3428 in chips)
PhiSlamaJama34: posts the ante 20
dimetruk: posts the ante 20
dimetruk: posts small blind 80
PhiSlamaJama34: posts big blind 160
*** HOLE CARDS ***
Dealt to dimetruk [7h Qs]
dimetruk: raises 160 to 320
PhiSlamaJama34: calls 160
*** FLOP *** [5c Ah 2h]
PhiSlamaJama34: checks
dimetruk: checks
*** TURN *** [5c Ah 2h] [2s]
PhiSlamaJama34: checks
dimetruk: bets 238
PhiSlamaJama34: calls 238
*** RIVER *** [5c Ah 2h 2s] [Ad]
PhiSlamaJama34: checks
dimetruk: checks
*** SHOW DOWN ***
PhiSlamaJama34: shows [Jh 8h] (two pair, Aces and Deuces)
dimetruk: shows [7h Qs] (two pair, Aces and Deuces - Queen kicker)
dimetruk collected 1156 from pot
*** SUMMARY ***
Total pot 1156 | Rake 0
Board [5c Ah 2h 2s Ad]
Seat 3: PhiSlamaJama34 (big blind) showed [Jh 8h] and lost with two pair, Aces and Deuces
Seat 7: dimetruk (button) (small blind) showed [7h Qs] and won (1156) with two pair, Aces and Deuces


PokerStars Hand #228171982155: Tournament #3227159788, $13.70+$1.30 USD Hold'em No Limit - Level VI (80/160) - 2021/07/09 22:52:55 MSK [2021/07/09 15:52:55 ET]
Table '3227159788 1' 9-max Seat #7 is the button
Seat 3: PhiSlamaJama34 (9394 in chips)
Seat 7: dimetruk (4106 in chips)
PhiSlamaJama34: posts the ante 20
dimetruk: posts the ante 20
dimetruk: posts small blind 80
PhiSlamaJama34: posts big blind 160
*** HOLE CARDS ***
Dealt to dimetruk [Td 7c]
dimetruk: raises 160 to 320
PhiSlamaJama34: calls 160
*** FLOP *** [3s 4h 4c]
PhiSlamaJama34: checks
dimetruk: checks
*** TURN *** [3s 4h 4c] [9s]
PhiSlamaJama34: bets 320
dimetruk: folds
Uncalled bet (320) returned to PhiSlamaJama34
PhiSlamaJama34 collected 680 from pot
*** SUMMARY ***
Total pot 680 | Rake 0
Board [3s 4h 4c 9s]
Seat 3: PhiSlamaJama34 (big blind) collected (680)
Seat 7: dimetruk (button) (small blind) folded on the Turn


PokerStars Hand #228171991551: Tournament #3227159788, $13.70+$1.30 USD Hold'em No Limit - Level VI (80/160) - 2021/07/09 22:53:16 MSK [2021/07/09 15:53:16 ET]
Table '3227159788 1' 9-max Seat #7 is the button
Seat 3: PhiSlamaJama34 (9914 in chips)
Seat 7: dimetruk (3586 in chips)
PhiSlamaJama34: posts the ante 20
dimetruk: posts the ante 20
dimetruk: posts small blind 80
PhiSlamaJama34: posts big blind 160
*** HOLE CARDS ***
Dealt to dimetruk [3h Kc]
dimetruk: calls 80
PhiSlamaJama34: checks
*** FLOP *** [4c 6d Th]
PhiSlamaJama34: checks
dimetruk: checks
*** TURN *** [4c 6d Th] [Ah]
PhiSlamaJama34: checks
dimetruk: bets 160
PhiSlamaJama34: calls 160
*** RIVER *** [4c 6d Th Ah] [8s]
PhiSlamaJama34: bets 680
dimetruk: folds
Uncalled bet (680) returned to PhiSlamaJama34
PhiSlamaJama34 collected 680 from pot
*** SUMMARY ***
Total pot 680 | Rake 0
Board [4c 6d Th Ah 8s]
Seat 3: PhiSlamaJama34 (big blind) collected (680)
Seat 7: dimetruk (button) (small blind) folded on the River


PokerStars Hand #228172009365: Tournament #3227159788, $13.70+$1.30 USD Hold'em No Limit - Level VI (80/160) - 2021/07/09 22:53:55 MSK [2021/07/09 15:53:55 ET]
Table '3227159788 1' 9-max Seat #7 is the button
Seat 3: PhiSlamaJama34 (9874 in chips)
Seat 7: dimetruk (3626 in chips)
PhiSlamaJama34: posts the ante 20
dimetruk: posts the ante 20
dimetruk: posts small blind 80
PhiSlamaJama34: posts big blind 160
*** HOLE CARDS ***
Dealt to dimetruk [Qd Js]
dimetruk: raises 160 to 320
PhiSlamaJama34: calls 160
*** FLOP *** [8d 4h 4c]
PhiSlamaJama34: checks
dimetruk: checks
*** TURN *** [8d 4h 4c] [3c]
PhiSlamaJama34: bets 320
dimetruk: calls 320
*** RIVER *** [8d 4h 4c 3c] [Ts]
PhiSlamaJama34: bets 924
dimetruk: folds
Uncalled bet (924) returned to PhiSlamaJama34
PhiSlamaJama34 collected 1320 from pot
*** SUMMARY ***
Total pot 1320 | Rake 0
Board [8d 4h 4c 3c Ts]
Seat 3: PhiSlamaJama34 (big blind) collected (1320)
Seat 7: dimetruk (button) (small blind) folded on the River


PokerStars Hand #228172032500: Tournament #3227159788, $13.70+$1.30 USD Hold'em No Limit - Level VI (80/160) - 2021/07/09 22:54:47 MSK [2021/07/09 15:54:47 ET]
Table '3227159788 1' 9-max Seat #3 is the button
Seat 3: PhiSlamaJama34 (10534 in chips)
Seat 7: dimetruk (2966 in chips)
PhiSlamaJama34: posts the ante 20
dimetruk: posts the ante 20
PhiSlamaJama34: posts small blind 80
dimetruk: posts big blind 160
*** HOLE CARDS ***
Dealt to dimetruk [6d 7s]
PhiSlamaJama34: raises 160 to 320
dimetruk: calls 160
*** FLOP *** [8c Ac 9d]
dimetruk: checks
PhiSlamaJama34: checks
*** TURN *** [8c Ac 9d] [4d]
dimetruk: bets 340
PhiSlamaJama34: folds
Uncalled bet (340) returned to dimetruk
dimetruk collected 680 from pot
dimetruk: doesn't show hand
*** SUMMARY ***
Total pot 680 | Rake 0
Board [8c Ac 9d 4d]
Seat 3: PhiSlamaJama34 (button) (small blind) folded on the Turn
Seat 7: dimetruk (big blind) collected (680)


PokerStars Hand #228172038809: Tournament #3227159788, $13.70+$1.30 USD Hold'em No Limit - Level VI (80/160) - 2021/07/09 22:55:01 MSK [2021/07/09 15:55:01 ET]
Table '3227159788 1' 9-max Seat #7 is the button
Seat 3: PhiSlamaJama34 (10194 in chips)
Seat 7: dimetruk (3306 in chips)
PhiSlamaJama34: posts the ante 20
dimetruk: posts the ante 20
dimetruk: posts small blind 80
PhiSlamaJama34: posts big blind 160
*** HOLE CARDS ***
Dealt to dimetruk [Ah 9h]
dimetruk: raises 160 to 320
PhiSlamaJama34: calls 160
*** FLOP *** [3s 8d 5c]
PhiSlamaJama34: checks
dimetruk: checks
*** TURN *** [3s 8d 5c] [4d]
PhiSlamaJama34: checks
dimetruk: bets 340
PhiSlamaJama34: calls 340
*** RIVER *** [3s 8d 5c 4d] [Kc]
PhiSlamaJama34: checks
dimetruk: bets 925
PhiSlamaJama34: folds
Uncalled bet (925) returned to dimetruk
dimetruk collected 1360 from pot
dimetruk: doesn't show hand
*** SUMMARY ***
Total pot 1360 | Rake 0
Board [3s 8d 5c 4d Kc]
Seat 3: PhiSlamaJama34 (big blind) folded on the River
Seat 7: dimetruk (button) (small blind) collected (1360)


PokerStars Hand #228172050736: Tournament #3227159788, $13.70+$1.30 USD Hold'em No Limit - Level VI (80/160) - 2021/07/09 22:55:34 MSK [2021/07/09 15:55:34 ET]
Table '3227159788 1' 9-max Seat #3 is the button
Seat 3: PhiSlamaJama34 (9514 in chips)
Seat 7: dimetruk (3986 in chips)
PhiSlamaJama34: posts the ante 20
dimetruk: posts the ante 20
PhiSlamaJama34: posts small blind 80
dimetruk: posts big blind 160
*** HOLE CARDS ***
Dealt to dimetruk [7h Js]
PhiSlamaJama34: raises 160 to 320
dimetruk: calls 160
*** FLOP *** [7s 3s Ts]
dimetruk: checks
PhiSlamaJama34: bets 160
dimetruk: calls 160
*** TURN *** [7s 3s Ts] [3c]
dimetruk: checks
PhiSlamaJama34: bets 160
dimetruk: calls 160
*** RIVER *** [7s 3s Ts 3c] [9d]
dimetruk: checks
PhiSlamaJama34: bets 640
dimetruk: calls 640
*** SHOW DOWN ***
PhiSlamaJama34: shows [Kc 9c] (two pair, Nines and Threes)
dimetruk: mucks hand
PhiSlamaJama34 collected 2600 from pot
*** SUMMARY ***
Total pot 2600 | Rake 0
Board [7s 3s Ts 3c 9d]
Seat 3: PhiSlamaJama34 (button) (small blind) showed [Kc 9c] and won (2600) with two pair, Nines and Threes
Seat 7: dimetruk (big blind) mucked [7h Js]


PokerStars Hand #228172057300: Tournament #3227159788, $13.70+$1.30 USD Hold'em No Limit - Level VI (80/160) - 2021/07/09 22:55:53 MSK [2021/07/09 15:55:53 ET]
Table '3227159788 1' 9-max Seat #7 is the button
Seat 3: PhiSlamaJama34 (10814 in chips)
Seat 7: dimetruk (2686 in chips)
PhiSlamaJama34: posts the ante 20
dimetruk: posts the ante 20
dimetruk: posts small blind 80
PhiSlamaJama34: posts big blind 160
*** HOLE CARDS ***
Dealt to dimetruk [3s 7s]
dimetruk: raises 160 to 320
PhiSlamaJama34: calls 160
*** FLOP *** [Jd Qs 5c]
PhiSlamaJama34: checks
dimetruk: checks
*** TURN *** [Jd Qs 5c] [Jc]
PhiSlamaJama34: checks
dimetruk: bets 462
PhiSlamaJama34: folds
Uncalled bet (462) returned to dimetruk
dimetruk collected 680 from pot
dimetruk: doesn't show hand
*** SUMMARY ***
Total pot 680 | Rake 0
Board [Jd Qs 5c Jc]
Seat 3: PhiSlamaJama34 (big blind) folded on the Turn
Seat 7: dimetruk (button) (small blind) collected (680)


PokerStars Hand #228172064996: Tournament #3227159788, $13.70+$1.30 USD Hold'em No Limit - Level VI (80/160) - 2021/07/09 22:56:17 MSK [2021/07/09 15:56:17 ET]
Table '3227159788 1' 9-max Seat #3 is the button
Seat 3: PhiSlamaJama34 (10474 in chips)
Seat 7: dimetruk (3026 in chips)
PhiSlamaJama34: posts the ante 20
dimetruk: posts the ante 20
PhiSlamaJama34: posts small blind 80
dimetruk: posts big blind 160
*** HOLE CARDS ***
Dealt to dimetruk [8s Qh]
PhiSlamaJama34: raises 160 to 320
dimetruk: calls 160
*** FLOP *** [8c Ac 9s]
dimetruk: checks
PhiSlamaJama34: bets 320
dimetruk: calls 320
*** TURN *** [8c Ac 9s] [2s]
dimetruk: checks
PhiSlamaJama34: bets 480
dimetruk: calls 480
*** RIVER *** [8c Ac 9s 2s] [5h]
dimetruk: checks
PhiSlamaJama34: checks
*** SHOW DOWN ***
dimetruk: shows [8s Qh] (a pair of Eights)
PhiSlamaJama34: mucks hand
dimetruk collected 2280 from pot
*** SUMMARY ***
Total pot 2280 | Rake 0
Board [8c Ac 9s 2s 5h]
Seat 3: PhiSlamaJama34 (button) (small blind) mucked [Kd 5s]
Seat 7: dimetruk (big blind) showed [8s Qh] and won (2280) with a pair of Eights


PokerStars Hand #228172071697: Tournament #3227159788, $13.70+$1.30 USD Hold'em No Limit - Level VI (80/160) - 2021/07/09 22:56:37 MSK [2021/07/09 15:56:37 ET]
Table '3227159788 1' 9-max Seat #7 is the button
Seat 3: PhiSlamaJama34 (9334 in chips)
Seat 7: dimetruk (4166 in chips)
PhiSlamaJama34: posts the ante 20
dimetruk: posts the ante 20
dimetruk: posts small blind 80
PhiSlamaJama34: posts big blind 160
*** HOLE CARDS ***
Dealt to dimetruk [As Js]
dimetruk: raises 160 to 320
PhiSlamaJama34: calls 160
*** FLOP *** [6c Jc 9s]
PhiSlamaJama34: checks
dimetruk: bets 340
PhiSlamaJama34: calls 340
*** TURN *** [6c Jc 9s] [Qd]
PhiSlamaJama34: checks
dimetruk: bets 680
PhiSlamaJama34: calls 680
*** RIVER *** [6c Jc 9s Qd] [3d]
PhiSlamaJama34: checks
dimetruk: checks
*** SHOW DOWN ***
PhiSlamaJama34: shows [Kd Ah] (high card Ace)
dimetruk: shows [As Js] (a pair of Jacks)
dimetruk collected 2720 from pot
*** SUMMARY ***
Total pot 2720 | Rake 0
Board [6c Jc 9s Qd 3d]
Seat 3: PhiSlamaJama34 (big blind) showed [Kd Ah] and lost with high card Ace
Seat 7: dimetruk (button) (small blind) showed [As Js] and won (2720) with a pair of Jacks


PokerStars Hand #228172078797: Tournament #3227159788, $13.70+$1.30 USD Hold'em No Limit - Level VI (80/160) - 2021/07/09 22:56:58 MSK [2021/07/09 15:56:58 ET]
Table '3227159788 1' 9-max Seat #3 is the button
Seat 3: PhiSlamaJama34 (7974 in chips)
Seat 7: dimetruk (5526 in chips)
PhiSlamaJama34: posts the ante 20
dimetruk: posts the ante 20
PhiSlamaJama34: posts small blind 80
dimetruk: posts big blind 160
*** HOLE CARDS ***
Dealt to dimetruk [Kd 6s]
PhiSlamaJama34: calls 80
dimetruk: raises 160 to 320
PhiSlamaJama34: calls 160
*** FLOP *** [Th 6d Kc]
dimetruk: bets 340
PhiSlamaJama34: folds
Uncalled bet (340) returned to dimetruk
dimetruk collected 680 from pot
dimetruk: doesn't show hand
*** SUMMARY ***
Total pot 680 | Rake 0
Board [Th 6d Kc]
Seat 3: PhiSlamaJama34 (button) (small blind) folded on the Flop
Seat 7: dimetruk (big blind) collected (680)


PokerStars Hand #228172084397: Tournament #3227159788, $13.70+$1.30 USD Hold'em No Limit - Level VI (80/160) - 2021/07/09 22:57:15 MSK [2021/07/09 15:57:15 ET]
Table '3227159788 1' 9-max Seat #3 is the button
Seat 3: PhiSlamaJama34 (7734 in chips)
Seat 7: dimetruk (5766 in chips)
PhiSlamaJama34: posts the ante 20
dimetruk: posts the ante 20
PhiSlamaJama34: posts small blind 80
dimetruk: posts big blind 160
*** HOLE CARDS ***
Dealt to dimetruk [Ac Jh]
PhiSlamaJama34: raises 160 to 320
dimetruk: calls 160
*** FLOP *** [2d 7h 8d]
dimetruk: checks
PhiSlamaJama34: bets 320
dimetruk: calls 320
*** TURN *** [2d 7h 8d] [6s]
dimetruk: checks
PhiSlamaJama34: bets 320
dimetruk: calls 320
*** RIVER *** [2d 7h 8d 6s] [2c]
dimetruk: checks
PhiSlamaJama34: checks
*** SHOW DOWN ***
dimetruk: shows [Ac Jh] (a pair of Deuces)
PhiSlamaJama34: shows [8c 9h] (two pair, Eights and Deuces)
PhiSlamaJama34 collected 1960 from pot
*** SUMMARY ***
Total pot 1960 | Rake 0
Board [2d 7h 8d 6s 2c]
Seat 3: PhiSlamaJama34 (button) (small blind) showed [8c 9h] and won (1960) with two pair, Eights and Deuces
Seat 7: dimetruk (big blind) showed [Ac Jh] and lost with a pair of Deuces


PokerStars Hand #228172091743: Tournament #3227159788, $13.70+$1.30 USD Hold'em No Limit - Level VII (100/200) - 2021/07/09 22:57:37 MSK [2021/07/09 15:57:37 ET]
Table '3227159788 1' 9-max Seat #7 is the button
Seat 3: PhiSlamaJama34 (8714 in chips)
Seat 7: dimetruk (4786 in chips)
PhiSlamaJama34: posts the ante 25
dimetruk: posts the ante 25
dimetruk: posts small blind 100
PhiSlamaJama34: posts big blind 200
*** HOLE CARDS ***
Dealt to dimetruk [4c Ac]
dimetruk: raises 200 to 400
PhiSlamaJama34: calls 200
*** FLOP *** [7h 5s 6d]
PhiSlamaJama34: checks
dimetruk: checks
*** TURN *** [7h 5s 6d] [9h]
PhiSlamaJama34: bets 400
dimetruk: calls 400
*** RIVER *** [7h 5s 6d 9h] [8h]
PhiSlamaJama34: checks
dimetruk: checks
*** SHOW DOWN ***
PhiSlamaJama34: shows [6s Ad] (a straight, Five to Nine)
dimetruk: shows [4c Ac] (a straight, Five to Nine)
PhiSlamaJama34 collected 825 from pot
dimetruk collected 825 from pot
*** SUMMARY ***
Total pot 1650 | Rake 0
Board [7h 5s 6d 9h 8h]
Seat 3: PhiSlamaJama34 (big blind) showed [6s Ad] and won (825) with a straight, Five to Nine
Seat 7: dimetruk (button) (small blind) showed [4c Ac] and won (825) with a straight, Five to Nine


PokerStars Hand #228172098796: Tournament #3227159788, $13.70+$1.30 USD Hold'em No Limit - Level VII (100/200) - 2021/07/09 22:57:58 MSK [2021/07/09 15:57:58 ET]
Table '3227159788 1' 9-max Seat #7 is the button
Seat 3: PhiSlamaJama34 (8589 in chips)
Seat 7: dimetruk (4911 in chips)
PhiSlamaJama34: posts the ante 25
dimetruk: posts the ante 25
dimetruk: posts small blind 100
PhiSlamaJama34: posts big blind 200
*** HOLE CARDS ***
Dealt to dimetruk [Ad 2c]
dimetruk: raises 200 to 400
PhiSlamaJama34: calls 200
*** FLOP *** [2d 9c 7d]
PhiSlamaJama34: checks
dimetruk: checks
*** TURN *** [2d 9c 7d] [As]
PhiSlamaJama34: bets 400
dimetruk: raises 4086 to 4486 and is all-in
PhiSlamaJama34: folds
Uncalled bet (4086) returned to dimetruk
dimetruk collected 1650 from pot
dimetruk: doesn't show hand
*** SUMMARY ***
Total pot 1650 | Rake 0
Board [2d 9c 7d As]
Seat 3: PhiSlamaJama34 (big blind) folded on the Turn
Seat 7: dimetruk (button) (small blind) collected (1650)


PokerStars Hand #228172104918: Tournament #3227159788, $13.70+$1.30 USD Hold'em No Limit - Level VII (100/200) - 2021/07/09 22:58:16 MSK [2021/07/09 15:58:16 ET]
Table '3227159788 1' 9-max Seat #3 is the button
Seat 3: PhiSlamaJama34 (7764 in chips)
Seat 7: dimetruk (5736 in chips)
PhiSlamaJama34: posts the ante 25
dimetruk: posts the ante 25
PhiSlamaJama34: posts small blind 100
dimetruk: posts big blind 200
*** HOLE CARDS ***
Dealt to dimetruk [Ts Kh]
PhiSlamaJama34: raises 200 to 400
dimetruk: calls 200
*** FLOP *** [Js Tc Qc]
dimetruk: checks
PhiSlamaJama34: checks
*** TURN *** [Js Tc Qc] [9c]
dimetruk: bets 425
PhiSlamaJama34: folds
Uncalled bet (425) returned to dimetruk
dimetruk collected 850 from pot
dimetruk: doesn't show hand
*** SUMMARY ***
Total pot 850 | Rake 0
Board [Js Tc Qc 9c]
Seat 3: PhiSlamaJama34 (button) (small blind) folded on the Turn
Seat 7: dimetruk (big blind) collected (850)


PokerStars Hand #228172109998: Tournament #3227159788, $13.70+$1.30 USD Hold'em No Limit - Level VII (100/200) - 2021/07/09 22:58:31 MSK [2021/07/09 15:58:31 ET]
Table '3227159788 1' 9-max Seat #7 is the button
Seat 3: PhiSlamaJama34 (7339 in chips)
Seat 7: dimetruk (6161 in chips)
PhiSlamaJama34: posts the ante 25
dimetruk: posts the ante 25
dimetruk: posts small blind 100
PhiSlamaJama34: posts big blind 200
*** HOLE CARDS ***
Dealt to dimetruk [9h 8s]
dimetruk: raises 200 to 400
PhiSlamaJama34: calls 200
*** FLOP *** [3c 3h Th]
PhiSlamaJama34: checks
dimetruk: checks
*** TURN *** [3c 3h Th] [Jc]
PhiSlamaJama34: checks
dimetruk: bets 425
PhiSlamaJama34: calls 425
*** RIVER *** [3c 3h Th Jc] [Qh]
PhiSlamaJama34: checks
dimetruk: bets 595
PhiSlamaJama34: folds
Uncalled bet (595) returned to dimetruk
dimetruk collected 1700 from pot
dimetruk: doesn't show hand
*** SUMMARY ***
Total pot 1700 | Rake 0
Board [3c 3h Th Jc Qh]
Seat 3: PhiSlamaJama34 (big blind) folded on the River
Seat 7: dimetruk (button) (small blind) collected (1700)


PokerStars Hand #228172117089: Tournament #3227159788, $13.70+$1.30 USD Hold'em No Limit - Level VII (100/200) - 2021/07/09 22:58:52 MSK [2021/07/09 15:58:52 ET]
Table '3227159788 1' 9-max Seat #3 is the button
Seat 3: PhiSlamaJama34 (6489 in chips)
Seat 7: dimetruk (7011 in chips)
PhiSlamaJama34: posts the ante 25
dimetruk: posts the ante 25
PhiSlamaJama34: posts small blind 100
dimetruk: posts big blind 200
*** HOLE CARDS ***
Dealt to dimetruk [8d 7d]
PhiSlamaJama34: raises 200 to 400
dimetruk: calls 200
*** FLOP *** [Qd Ks 6d]
dimetruk: checks
PhiSlamaJama34: bets 400
dimetruk: calls 400
*** TURN *** [Qd Ks 6d] [2h]
dimetruk: checks
PhiSlamaJama34: bets 600
dimetruk: calls 600
*** RIVER *** [Qd Ks 6d 2h] [Jh]
dimetruk: checks
PhiSlamaJama34: checks
*** SHOW DOWN ***
dimetruk: shows [8d 7d] (high card King)
PhiSlamaJama34: shows [Kc 5c] (a pair of Kings)
PhiSlamaJama34 collected 2850 from pot
*** SUMMARY ***
Total pot 2850 | Rake 0
Board [Qd Ks 6d 2h Jh]
Seat 3: PhiSlamaJama34 (button) (small blind) showed [Kc 5c] and won (2850) with a pair of Kings
Seat 7: dimetruk (big blind) showed [8d 7d] and lost with high card King


PokerStars Hand #228172124495: Tournament #3227159788, $13.70+$1.30 USD Hold'em No Limit - Level VII (100/200) - 2021/07/09 22:59:14 MSK [2021/07/09 15:59:14 ET]
Table '3227159788 1' 9-max Seat #7 is the button
Seat 3: PhiSlamaJama34 (7914 in chips)
Seat 7: dimetruk (5586 in chips)
PhiSlamaJama34: posts the ante 25
dimetruk: posts the ante 25
dimetruk: posts small blind 100
PhiSlamaJama34: posts big blind 200
*** HOLE CARDS ***
Dealt to dimetruk [Kh 5c]
dimetruk: raises 200 to 400
PhiSlamaJama34: calls 200
*** FLOP *** [4h Qc 7s]
PhiSlamaJama34: checks
dimetruk: bets 425
PhiSlamaJama34: folds
Uncalled bet (425) returned to dimetruk
dimetruk collected 850 from pot
dimetruk: doesn't show hand
*** SUMMARY ***
Total pot 850 | Rake 0
Board [4h Qc 7s]
Seat 3: PhiSlamaJama34 (big blind) folded on the Flop
Seat 7: dimetruk (button) (small blind) collected (850)


PokerStars Hand #228172130989: Tournament #3227159788, $13.70+$1.30 USD Hold'em No Limit - Level VII (100/200) - 2021/07/09 22:59:33 MSK [2021/07/09 15:59:33 ET]
Table '3227159788 1' 9-max Seat #3 is the button
Seat 3: PhiSlamaJama34 (7489 in chips)
Seat 7: dimetruk (6011 in chips)
PhiSlamaJama34: posts the ante 25
dimetruk: posts the ante 25
PhiSlamaJama34: posts small blind 100
dimetruk: posts big blind 200
*** HOLE CARDS ***
Dealt to dimetruk [Ts Jc]
PhiSlamaJama34: raises 200 to 400
dimetruk: calls 200
*** FLOP *** [6d 2h 9h]
dimetruk: checks
PhiSlamaJama34: bets 400
dimetruk: calls 400
*** TURN *** [6d 2h 9h] [Th]
dimetruk: checks
PhiSlamaJama34: bets 600
dimetruk: calls 600
*** RIVER *** [6d 2h 9h Th] [6c]
dimetruk: checks
PhiSlamaJama34: bets 1995
dimetruk: folds
Uncalled bet (1995) returned to PhiSlamaJama34
PhiSlamaJama34 collected 2850 from pot
*** SUMMARY ***
Total pot 2850 | Rake 0
Board [6d 2h 9h Th 6c]
Seat 3: PhiSlamaJama34 (button) (small blind) collected (2850)
Seat 7: dimetruk (big blind) folded on the River


PokerStars Hand #228172154975: Tournament #3227159788, $13.70+$1.30 USD Hold'em No Limit - Level VII (100/200) - 2021/07/09 23:00:42 MSK [2021/07/09 16:00:42 ET]
Table '3227159788 1' 9-max Seat #3 is the button
Seat 3: PhiSlamaJama34 (9339 in chips)
Seat 7: dimetruk (4161 in chips)
PhiSlamaJama34: posts the ante 25
dimetruk: posts the ante 25
PhiSlamaJama34: posts small blind 100
dimetruk: posts big blind 200
*** HOLE CARDS ***
Dealt to dimetruk [5d 6c]
PhiSlamaJama34: raises 200 to 400
dimetruk: calls 200
*** FLOP *** [9h 7h Jh]
dimetruk: checks
PhiSlamaJama34: checks
*** TURN *** [9h 7h Jh] [Kd]
dimetruk: checks
PhiSlamaJama34: bets 400
dimetruk: folds
Uncalled bet (400) returned to PhiSlamaJama34
PhiSlamaJama34 collected 850 from pot
*** SUMMARY ***
Total pot 850 | Rake 0
Board [9h 7h Jh Kd]
Seat 3: PhiSlamaJama34 (button) (small blind) collected (850)
Seat 7: dimetruk (big blind) folded on the Turn


PokerStars Hand #228172160501: Tournament #3227159788, $13.70+$1.30 USD Hold'em No Limit - Level VII (100/200) - 2021/07/09 23:00:56 MSK [2021/07/09 16:00:56 ET]
Table '3227159788 1' 9-max Seat #7 is the button
Seat 3: PhiSlamaJama34 (9764 in chips)
Seat 7: dimetruk (3736 in chips)
PhiSlamaJama34: posts the ante 25
dimetruk: posts the ante 25
dimetruk: posts small blind 100
PhiSlamaJama34: posts big blind 200
*** HOLE CARDS ***
Dealt to dimetruk [8c Td]
dimetruk: raises 200 to 400
PhiSlamaJama34: calls 200
*** FLOP *** [4h 3h 7h]
PhiSlamaJama34: checks
dimetruk: bets 425
PhiSlamaJama34: raises 1700 to 2125
dimetruk: folds
Uncalled bet (1700) returned to PhiSlamaJama34
PhiSlamaJama34 collected 1700 from pot
*** SUMMARY ***
Total pot 1700 | Rake 0
Board [4h 3h 7h]
Seat 3: PhiSlamaJama34 (big blind) collected (1700)
Seat 7: dimetruk (button) (small blind) folded on the Flop


PokerStars Hand #228172176190: Tournament #3227159788, $13.70+$1.30 USD Hold'em No Limit - Level VII (100/200) - 2021/07/09 23:01:34 MSK [2021/07/09 16:01:34 ET]
Table '3227159788 1' 9-max Seat #7 is the button
Seat 3: PhiSlamaJama34 (10189 in chips)
Seat 7: dimetruk (3311 in chips)
PhiSlamaJama34: posts the ante 25
dimetruk: posts the ante 25
dimetruk: posts small blind 100
PhiSlamaJama34: posts big blind 200
*** HOLE CARDS ***
Dealt to dimetruk [Kc 4h]
dimetruk: calls 100
PhiSlamaJama34: checks
*** FLOP *** [Ah 6h 6c]
PhiSlamaJama34: checks
dimetruk: bets 200
PhiSlamaJama34: calls 200
*** TURN *** [Ah 6h 6c] [Qd]
PhiSlamaJama34: checks
dimetruk: checks
*** RIVER *** [Ah 6h 6c Qd] [3s]
PhiSlamaJama34: bets 400
dimetruk: calls 400
*** SHOW DOWN ***
PhiSlamaJama34: shows [Qs 9s] (two pair, Queens and Sixes)
dimetruk: mucks hand
PhiSlamaJama34 collected 1650 from pot
*** SUMMARY ***
Total pot 1650 | Rake 0
Board [Ah 6h 6c Qd 3s]
Seat 3: PhiSlamaJama34 (big blind) showed [Qs 9s] and won (1650) with two pair, Queens and Sixes
Seat 7: dimetruk (button) (small blind) mucked [Kc 4h]


PokerStars Hand #228172191855: Tournament #3227159788, $13.70+$1.30 USD Hold'em No Limit - Level VII (100/200) - 2021/07/09 23:02:09 MSK [2021/07/09 16:02:09 ET]
Table '3227159788 1' 9-max Seat #3 is the button
Seat 3: PhiSlamaJama34 (10364 in chips)
Seat 7: dimetruk (3136 in chips)
PhiSlamaJama34: posts the ante 25
dimetruk: posts the ante 25
PhiSlamaJama34: posts small blind 100
dimetruk: posts big blind 200
*** HOLE CARDS ***
Dealt to dimetruk [5s Ah]
PhiSlamaJama34: raises 200 to 400
dimetruk: calls 200
*** FLOP *** [3c Jc Kh]
dimetruk: checks
PhiSlamaJama34: checks
*** TURN *** [3c Jc Kh] [Tc]
dimetruk: checks
PhiSlamaJama34: bets 400
dimetruk: folds
Uncalled bet (400) returned to PhiSlamaJama34
PhiSlamaJama34 collected 850 from pot
*** SUMMARY ***
Total pot 850 | Rake 0
Board [3c Jc Kh Tc]
Seat 3: PhiSlamaJama34 (button) (small blind) collected (850)
Seat 7: dimetruk (big blind) folded on the Turn


PokerStars Hand #228172200964: Tournament #3227159788, $13.70+$1.30 USD Hold'em No Limit - Level VII (100/200) - 2021/07/09 23:02:29 MSK [2021/07/09 16:02:29 ET]
Table '3227159788 1' 9-max Seat #7 is the button
Seat 3: PhiSlamaJama34 (10789 in chips)
Seat 7: dimetruk (2711 in chips)
PhiSlamaJama34: posts the ante 25
dimetruk: posts the ante 25
dimetruk: posts small blind 100
PhiSlamaJama34: posts big blind 200
*** HOLE CARDS ***
Dealt to dimetruk [Jh 9c]
dimetruk: raises 200 to 400
PhiSlamaJama34: calls 200
*** FLOP *** [Kh 3d 7c]
PhiSlamaJama34: checks
dimetruk: bets 298
PhiSlamaJama34: calls 298
*** TURN *** [Kh 3d 7c] [4c]
PhiSlamaJama34: checks
dimetruk: checks
*** RIVER *** [Kh 3d 7c 4c] [3h]
PhiSlamaJama34: checks
dimetruk: checks
*** SHOW DOWN ***
PhiSlamaJama34: shows [As 2d] (a pair of Threes)
dimetruk: mucks hand
PhiSlamaJama34 collected 1446 from pot
*** SUMMARY ***
Total pot 1446 | Rake 0
Board [Kh 3d 7c 4c 3h]
Seat 3: PhiSlamaJama34 (big blind) showed [As 2d] and won (1446) with a pair of Threes
Seat 7: dimetruk (button) (small blind) mucked [Jh 9c]


PokerStars Hand #228172212639: Tournament #3227159788, $13.70+$1.30 USD Hold'em No Limit - Level VII (100/200) - 2021/07/09 23:02:55 MSK [2021/07/09 16:02:55 ET]
Table '3227159788 1' 9-max Seat #3 is the button
Seat 3: PhiSlamaJama34 (11512 in chips)
Seat 7: dimetruk (1988 in chips)
PhiSlamaJama34: posts the ante 25
dimetruk: posts the ante 25
PhiSlamaJama34: posts small blind 100
dimetruk: posts big blind 200
*** HOLE CARDS ***
Dealt to dimetruk [3h Kd]
PhiSlamaJama34: raises 200 to 400
dimetruk: calls 200
*** FLOP *** [2s Qh 8s]
dimetruk: checks
PhiSlamaJama34: bets 400
dimetruk: folds
Uncalled bet (400) returned to PhiSlamaJama34
PhiSlamaJama34 collected 850 from pot
*** SUMMARY ***
Total pot 850 | Rake 0
Board [2s Qh 8s]
Seat 3: PhiSlamaJama34 (button) (small blind) collected (850)
Seat 7: dimetruk (big blind) folded on the Flop


PokerStars Hand #228172217663: Tournament #3227159788, $13.70+$1.30 USD Hold'em No Limit - Level VII (100/200) - 2021/07/09 23:03:07 MSK [2021/07/09 16:03:07 ET]
Table '3227159788 1' 9-max Seat #7 is the button
Seat 3: PhiSlamaJama34 (11937 in chips)
Seat 7: dimetruk (1563 in chips)
PhiSlamaJama34: posts the ante 25
dimetruk: posts the ante 25
dimetruk: posts small blind 100
PhiSlamaJama34: posts big blind 200
*** HOLE CARDS ***
Dealt to dimetruk [Ts 4s]
dimetruk: calls 100
PhiSlamaJama34: checks
*** FLOP *** [Ad Qc Ah]
PhiSlamaJama34: checks
dimetruk: bets 200
PhiSlamaJama34: folds
Uncalled bet (200) returned to dimetruk
dimetruk collected 450 from pot
dimetruk: doesn't show hand
*** SUMMARY ***
Total pot 450 | Rake 0
Board [Ad Qc Ah]
Seat 3: PhiSlamaJama34 (big blind) folded on the Flop
Seat 7: dimetruk (button) (small blind) collected (450)


PokerStars Hand #228172222619: Tournament #3227159788, $13.70+$1.30 USD Hold'em No Limit - Level VII (100/200) - 2021/07/09 23:03:18 MSK [2021/07/09 16:03:18 ET]
Table '3227159788 1' 9-max Seat #3 is the button
Seat 3: PhiSlamaJama34 (11712 in chips)
Seat 7: dimetruk (1788 in chips)
PhiSlamaJama34: posts the ante 25
dimetruk: posts the ante 25
PhiSlamaJama34: posts small blind 100
dimetruk: posts big blind 200
*** HOLE CARDS ***
Dealt to dimetruk [8h 7s]
PhiSlamaJama34: raises 200 to 400
dimetruk: calls 200
*** FLOP *** [Jh Qh Td]
dimetruk: checks
PhiSlamaJama34: bets 400
dimetruk: folds
Uncalled bet (400) returned to PhiSlamaJama34
PhiSlamaJama34 collected 850 from pot
*** SUMMARY ***
Total pot 850 | Rake 0
Board [Jh Qh Td]
Seat 3: PhiSlamaJama34 (button) (small blind) collected (850)
Seat 7: dimetruk (big blind) folded on the Flop


PokerStars Hand #228172231112: Tournament #3227159788, $13.70+$1.30 USD Hold'em No Limit - Level VII (100/200) - 2021/07/09 23:03:36 MSK [2021/07/09 16:03:36 ET]
Table '3227159788 1' 9-max Seat #3 is the button
Seat 3: PhiSlamaJama34 (12262 in chips)
Seat 7: dimetruk (1238 in chips)
PhiSlamaJama34: posts the ante 25
dimetruk: posts the ante 25
PhiSlamaJama34: posts small blind 100
dimetruk: posts big blind 200
*** HOLE CARDS ***
Dealt to dimetruk [Qd Kc]
PhiSlamaJama34: calls 100
dimetruk: raises 1013 to 1213 and is all-in
PhiSlamaJama34: calls 1013
*** FLOP *** [8d 6s Td]
*** TURN *** [8d 6s Td] [Ts]
*** RIVER *** [8d 6s Td Ts] [9h]
*** SHOW DOWN ***
dimetruk: shows [Qd Kc] (a pair of Tens)
PhiSlamaJama34: shows [5c Ac] (a pair of Tens - Ace kicker)
PhiSlamaJama34 collected 2476 from pot
dimetruk finished the tournament in 2nd place and received $36.99.
PhiSlamaJama34 wins the tournament and receives $61.65 - congratulations!
*** SUMMARY ***
Total pot 2476 | Rake 0
Board [8d 6s Td Ts 9h]
Seat 3: PhiSlamaJama34 (button) (small blind) showed [5c Ac] and won (2476) with a pair of Tens
Seat 7: dimetruk (big blind) showed [Qd Kc] and lost with a pair of Tens


PokerStars Hand #228182120913: Tournament #3227430197, $13.70+$1.30 USD Hold'em No Limit - Level II (15/30) - 2021/07/10 7:37:30 MSK [2021/07/10 0:37:30 ET]
Table '3227430197 1' 9-max Seat #9 is the button
Seat 2: Luke141269 (3160 in chips)
Seat 3: Schwartz0007 (407 in chips)
Seat 4: dimetruk (1381 in chips)
Seat 5: Toallin_eze (2185 in chips)
Seat 6: terr888 (1264 in chips)
Seat 7: Jung0Bridge (1007 in chips)
Seat 8: invisible271 (2180 in chips)
Seat 9: gnella13 (1916 in chips)
Luke141269: posts the ante 4
Schwartz0007: posts the ante 4
dimetruk: posts the ante 4
Toallin_eze: posts the ante 4
terr888: posts the ante 4
Jung0Bridge: posts the ante 4
invisible271: posts the ante 4
gnella13: posts the ante 4
Luke141269: posts small blind 15
Schwartz0007: posts big blind 30
*** HOLE CARDS ***
Dealt to dimetruk [As 2s]
dimetruk: raises 30 to 60
Toallin_eze: folds
terr888: folds
Jung0Bridge: folds
invisible271: folds
gnella13: folds
Luke141269: folds
Schwartz0007: calls 30
*** FLOP *** [Ad Qd 7c]
Schwartz0007: checks
dimetruk: bets 58
Schwartz0007: calls 58
*** TURN *** [Ad Qd 7c] [8s]
Schwartz0007: checks
dimetruk: bets 300
Schwartz0007: folds
Uncalled bet (300) returned to dimetruk
dimetruk collected 283 from pot
dimetruk: doesn't show hand
*** SUMMARY ***
Total pot 283 | Rake 0
Board [Ad Qd 7c 8s]
Seat 2: Luke141269 (small blind) folded before Flop
Seat 3: Schwartz0007 (big blind) folded on the Turn
Seat 4: dimetruk collected (283)
Seat 5: Toallin_eze folded before Flop (didn't bet)
Seat 6: terr888 folded before Flop (didn't bet)
Seat 7: Jung0Bridge folded before Flop (didn't bet)
Seat 8: invisible271 folded before Flop (didn't bet)
Seat 9: gnella13 (button) folded before Flop (didn't bet)


PokerStars Hand #228182127885: Tournament #3227430197, $13.70+$1.30 USD Hold'em No Limit - Level II (15/30) - 2021/07/10 7:38:10 MSK [2021/07/10 0:38:10 ET]
Table '3227430197 1' 9-max Seat #2 is the button
Seat 2: Luke141269 (3141 in chips)
Seat 3: Schwartz0007 (285 in chips)
Seat 4: dimetruk (1542 in chips)
Seat 5: Toallin_eze (2181 in chips)
Seat 6: terr888 (1260 in chips)
Seat 7: Jung0Bridge (1003 in chips)
Seat 8: invisible271 (2176 in chips)
Seat 9: gnella13 (1912 in chips)
Luke141269: posts the ante 4
Schwartz0007: posts the ante 4
dimetruk: posts the ante 4
Toallin_eze: posts the ante 4
terr888: posts the ante 4
Jung0Bridge: posts the ante 4
invisible271: posts the ante 4
gnella13: posts the ante 4
Schwartz0007: posts small blind 15
dimetruk: posts big blind 30
*** HOLE CARDS ***
Dealt to dimetruk [7c 4h]
Toallin_eze: folds
terr888: calls 30
Jung0Bridge: folds
invisible271: folds
gnella13: folds
Luke141269: folds
Schwartz0007: calls 15
dimetruk: checks
*** FLOP *** [Ks 2s 8d]
Schwartz0007: checks
dimetruk: checks
terr888: bets 30
Schwartz0007: folds
dimetruk: folds
Uncalled bet (30) returned to terr888
terr888 collected 122 from pot
*** SUMMARY ***
Total pot 122 | Rake 0
Board [Ks 2s 8d]
Seat 2: Luke141269 (button) folded before Flop (didn't bet)
Seat 3: Schwartz0007 (small blind) folded on the Flop
Seat 4: dimetruk (big blind) folded on the Flop
Seat 5: Toallin_eze folded before Flop (didn't bet)
Seat 6: terr888 collected (122)
Seat 7: Jung0Bridge folded before Flop (didn't bet)
Seat 8: invisible271 folded before Flop (didn't bet)
Seat 9: gnella13 folded before Flop (didn't bet)


PokerStars Hand #228182147557: Tournament #3227430197, $13.70+$1.30 USD Hold'em No Limit - Level II (15/30) - 2021/07/10 7:39:27 MSK [2021/07/10 0:39:27 ET]
Table '3227430197 1' 9-max Seat #4 is the button
Seat 2: Luke141269 (3133 in chips)
Seat 3: Schwartz0007 (324 in chips)
Seat 4: dimetruk (1489 in chips)
Seat 5: Toallin_eze (2143 in chips)
Seat 6: terr888 (1344 in chips)
Seat 7: Jung0Bridge (995 in chips)
Seat 8: invisible271 (2168 in chips)
Seat 9: gnella13 (1904 in chips)
Luke141269: posts the ante 4
Schwartz0007: posts the ante 4
dimetruk: posts the ante 4
Toallin_eze: posts the ante 4
terr888: posts the ante 4
Jung0Bridge: posts the ante 4
invisible271: posts the ante 4
gnella13: posts the ante 4
Toallin_eze: posts small blind 15
terr888: posts big blind 30
*** HOLE CARDS ***
Dealt to dimetruk [3c 3s]
Jung0Bridge: folds
invisible271: folds
gnella13: raises 30 to 60
Luke141269: folds
Schwartz0007: folds
dimetruk: calls 60
Toallin_eze: folds
terr888: calls 30
*** FLOP *** [Qd Th 9s]
terr888: checks
gnella13: checks
dimetruk: bets 79
terr888: folds
gnella13: folds
Uncalled bet (79) returned to dimetruk
dimetruk collected 227 from pot
dimetruk: doesn't show hand
*** SUMMARY ***
Total pot 227 | Rake 0
Board [Qd Th 9s]
Seat 2: Luke141269 folded before Flop (didn't bet)
Seat 3: Schwartz0007 folded before Flop (didn't bet)
Seat 4: dimetruk (button) collected (227)
Seat 5: Toallin_eze (small blind) folded before Flop
Seat 6: terr888 (big blind) folded on the Flop
Seat 7: Jung0Bridge folded before Flop (didn't bet)
Seat 8: invisible271 folded before Flop (didn't bet)
Seat 9: gnella13 folded on the Flop


PokerStars Hand #228182170050: Tournament #3227430197, $13.70+$1.30 USD Hold'em No Limit - Level II (15/30) - 2021/07/10 7:41:36 MSK [2021/07/10 0:41:36 ET]
Table '3227430197 1' 9-max Seat #6 is the button
Seat 2: Luke141269 (2960 in chips)
Seat 3: Schwartz0007 (316 in chips)
Seat 4: dimetruk (1648 in chips)
Seat 5: Toallin_eze (2120 in chips)
Seat 6: terr888 (1261 in chips)
Seat 7: Jung0Bridge (1199 in chips)
Seat 8: invisible271 (2160 in chips)
Seat 9: gnella13 (1836 in chips)
Luke141269: posts the ante 4
Schwartz0007: posts the ante 4
dimetruk: posts the ante 4
Toallin_eze: posts the ante 4
terr888: posts the ante 4
Jung0Bridge: posts the ante 4
invisible271: posts the ante 4
gnella13: posts the ante 4
Jung0Bridge: posts small blind 15
invisible271: posts big blind 30
*** HOLE CARDS ***
Dealt to dimetruk [Ad Kc]
gnella13: folds
Luke141269: folds
Schwartz0007: raises 282 to 312 and is all-in
dimetruk: raises 1332 to 1644 and is all-in
Toallin_eze: folds
terr888: folds
Jung0Bridge: folds
invisible271: folds
Uncalled bet (1332) returned to dimetruk
*** FLOP *** [7h 6s 6c]
*** TURN *** [7h 6s 6c] [Ks]
*** RIVER *** [7h 6s 6c Ks] [8h]
*** SHOW DOWN ***
Schwartz0007: shows [9h 7s] (two pair, Sevens and Sixes)
dimetruk: shows [Ad Kc] (two pair, Kings and Sixes)
dimetruk collected 701 from pot
Schwartz0007 finished the tournament in 8th place
*** SUMMARY ***
Total pot 701 | Rake 0
Board [7h 6s 6c Ks 8h]
Seat 2: Luke141269 folded before Flop (didn't bet)
Seat 3: Schwartz0007 showed [9h 7s] and lost with two pair, Sevens and Sixes
Seat 4: dimetruk showed [Ad Kc] and won (701) with two pair, Kings and Sixes
Seat 5: Toallin_eze folded before Flop (didn't bet)
Seat 6: terr888 (button) folded before Flop (didn't bet)
Seat 7: Jung0Bridge (small blind) folded before Flop
Seat 8: invisible271 (big blind) folded before Flop
Seat 9: gnella13 folded before Flop (didn't bet)


PokerStars Hand #228182188345: Tournament #3227430197, $13.70+$1.30 USD Hold'em No Limit - Level III (25/50) - 2021/07/10 7:42:52 MSK [2021/07/10 0:42:52 ET]
Table '3227430197 1' 9-max Seat #8 is the button
Seat 2: Luke141269 (2952 in chips)
Seat 4: dimetruk (2029 in chips)
Seat 5: Toallin_eze (2112 in chips)
Seat 6: terr888 (1223 in chips)
Seat 7: Jung0Bridge (1176 in chips)
Seat 8: invisible271 (2107 in chips)
Seat 9: gnella13 (1901 in chips)
Luke141269: posts the ante 6
dimetruk: posts the ante 6
Toallin_eze: posts the ante 6
terr888: posts the ante 6
Jung0Bridge: posts the ante 6
invisible271: posts the ante 6
gnella13: posts the ante 6
gnella13: posts small blind 25
Luke141269: posts big blind 50
*** HOLE CARDS ***
Dealt to dimetruk [9c 9h]
dimetruk: raises 50 to 100
Toallin_eze: calls 100
terr888: folds
Jung0Bridge: folds
invisible271: folds
gnella13: folds
Luke141269: calls 50
*** FLOP *** [Tc 5h Ks]
Luke141269: checks
dimetruk: bets 128
Toallin_eze: calls 128
Luke141269: folds
*** TURN *** [Tc 5h Ks] [8s]
dimetruk: checks
Toallin_eze: checks
*** RIVER *** [Tc 5h Ks 8s] [Qd]
dimetruk: checks
Toallin_eze: checks
*** SHOW DOWN ***
dimetruk: shows [9c 9h] (a pair of Nines)
Toallin_eze: shows [Kh Js] (a pair of Kings)
Toallin_eze collected 623 from pot
*** SUMMARY ***
Total pot 623 | Rake 0
Board [Tc 5h Ks 8s Qd]
Seat 2: Luke141269 (big blind) folded on the Flop
Seat 4: dimetruk showed [9c 9h] and lost with a pair of Nines
Seat 5: Toallin_eze showed [Kh Js] and won (623) with a pair of Kings
Seat 6: terr888 folded before Flop (didn't bet)
Seat 7: Jung0Bridge folded before Flop (didn't bet)
Seat 8: invisible271 (button) folded before Flop (didn't bet)
Seat 9: gnella13 (small blind) folded before Flop


PokerStars Hand #228182195425: Tournament #3227430197, $13.70+$1.30 USD Hold'em No Limit - Level III (25/50) - 2021/07/10 7:43:33 MSK [2021/07/10 0:43:33 ET]
Table '3227430197 1' 9-max Seat #9 is the button
Seat 2: Luke141269 (2846 in chips)
Seat 4: dimetruk (1795 in chips)
Seat 5: Toallin_eze (2501 in chips)
Seat 6: terr888 (1217 in chips)
Seat 7: Jung0Bridge (1170 in chips)
Seat 8: invisible271 (2101 in chips)
Seat 9: gnella13 (1870 in chips)
Luke141269: posts the ante 6
dimetruk: posts the ante 6
Toallin_eze: posts the ante 6
terr888: posts the ante 6
Jung0Bridge: posts the ante 6
invisible271: posts the ante 6
gnella13: posts the ante 6
Luke141269: posts small blind 25
dimetruk: posts big blind 50
*** HOLE CARDS ***
Dealt to dimetruk [Jd Th]
Toallin_eze: folds
terr888: folds
Jung0Bridge: raises 100 to 150
invisible271: folds
gnella13: folds
Luke141269: folds
dimetruk: calls 100
*** FLOP *** [9c Qs As]
dimetruk: checks
Jung0Bridge: checks
*** TURN *** [9c Qs As] [Ad]
dimetruk: bets 128
Jung0Bridge: calls 128
*** RIVER *** [9c Qs As Ad] [8c]
dimetruk: bets 1511 and is all-in
Jung0Bridge: calls 886 and is all-in
Uncalled bet (625) returned to dimetruk
*** SHOW DOWN ***
dimetruk: shows [Jd Th] (a straight, Eight to Queen)
Jung0Bridge: shows [Jc Qc] (two pair, Aces and Queens)
dimetruk collected 2395 from pot
Jung0Bridge finished the tournament in 7th place
*** SUMMARY ***
Total pot 2395 | Rake 0
Board [9c Qs As Ad 8c]
Seat 2: Luke141269 (small blind) folded before Flop
Seat 4: dimetruk (big blind) showed [Jd Th] and won (2395) with a straight, Eight to Queen
Seat 5: Toallin_eze folded before Flop (didn't bet)
Seat 6: terr888 folded before Flop (didn't bet)
Seat 7: Jung0Bridge showed [Jc Qc] and lost with two pair, Aces and Queens
Seat 8: invisible271 folded before Flop (didn't bet)
Seat 9: gnella13 (button) folded before Flop (didn't bet)


PokerStars Hand #228182231659: Tournament #3227430197, $13.70+$1.30 USD Hold'em No Limit - Level III (25/50) - 2021/07/10 7:47:04 MSK [2021/07/10 0:47:04 ET]
Table '3227430197 1' 9-max Seat #5 is the button
Seat 2: Luke141269 (2964 in chips)
Seat 4: dimetruk (2983 in chips)
Seat 5: Toallin_eze (2333 in chips)
Seat 6: terr888 (1099 in chips)
Seat 8: invisible271 (2083 in chips)
Seat 9: gnella13 (2038 in chips)
Luke141269: posts the ante 6
dimetruk: posts the ante 6
Toallin_eze: posts the ante 6
terr888: posts the ante 6
invisible271: posts the ante 6
gnella13: posts the ante 6
terr888: posts small blind 25
invisible271: posts big blind 50
*** HOLE CARDS ***
Dealt to dimetruk [Qs Ks]
gnella13: folds
Luke141269: folds
dimetruk: raises 50 to 100
Toallin_eze: folds
terr888: folds
invisible271: calls 50
*** FLOP *** [Qd 7h Jd]
invisible271: checks
dimetruk: bets 131
invisible271: calls 131
*** TURN *** [Qd 7h Jd] [Js]
invisible271: bets 340
dimetruk: calls 340
*** RIVER *** [Qd 7h Jd Js] [Jc]
invisible271: checks
dimetruk: checks
*** SHOW DOWN ***
invisible271: shows [Ts Kh] (three of a kind, Jacks)
dimetruk: shows [Qs Ks] (a full house, Jacks full of Queens)
dimetruk collected 1203 from pot
*** SUMMARY ***
Total pot 1203 | Rake 0
Board [Qd 7h Jd Js Jc]
Seat 2: Luke141269 folded before Flop (didn't bet)
Seat 4: dimetruk showed [Qs Ks] and won (1203) with a full house, Jacks full of Queens
Seat 5: Toallin_eze (button) folded before Flop (didn't bet)
Seat 6: terr888 (small blind) folded before Flop
Seat 8: invisible271 (big blind) showed [Ts Kh] and lost with three of a kind, Jacks
Seat 9: gnella13 folded before Flop (didn't bet)


PokerStars Hand #228182241362: Tournament #3227430197, $13.70+$1.30 USD Hold'em No Limit - Level III (25/50) - 2021/07/10 7:48:00 MSK [2021/07/10 0:48:00 ET]
Table '3227430197 1' 9-max Seat #6 is the button
Seat 2: Luke141269 (2958 in chips)
Seat 4: dimetruk (3609 in chips)
Seat 5: Toallin_eze (2327 in chips)
Seat 6: terr888 (1068 in chips)
Seat 8: invisible271 (1506 in chips)
Seat 9: gnella13 (2032 in chips)
Luke141269: posts the ante 6
dimetruk: posts the ante 6
Toallin_eze: posts the ante 6
terr888: posts the ante 6
invisible271: posts the ante 6
gnella13: posts the ante 6
invisible271: posts small blind 25
gnella13: posts big blind 50
*** HOLE CARDS ***
Dealt to dimetruk [9c Jc]
Luke141269: folds
dimetruk: raises 50 to 100
Toallin_eze: folds
terr888: calls 100
invisible271: folds
gnella13: calls 50
*** FLOP *** [3d 5h Kc]
gnella13: checks
dimetruk: bets 126
terr888: folds
gnella13: folds
Uncalled bet (126) returned to dimetruk
dimetruk collected 361 from pot
dimetruk: doesn't show hand
*** SUMMARY ***
Total pot 361 | Rake 0
Board [3d 5h Kc]
Seat 2: Luke141269 folded before Flop (didn't bet)
Seat 4: dimetruk collected (361)
Seat 5: Toallin_eze folded before Flop (didn't bet)
Seat 6: terr888 (button) folded on the Flop
Seat 8: invisible271 (small blind) folded before Flop
Seat 9: gnella13 (big blind) folded on the Flop


PokerStars Hand #228182304935: Tournament #3227430197, $13.70+$1.30 USD Hold'em No Limit - Level IV (40/80) - 2021/07/10 7:53:31 MSK [2021/07/10 0:53:31 ET]
Table '3227430197 1' 9-max Seat #9 is the button
Seat 2: Luke141269 (2906 in chips)
Seat 4: dimetruk (4040 in chips)
Seat 5: Toallin_eze (2804 in chips)
Seat 6: terr888 (996 in chips)
Seat 8: invisible271 (1154 in chips)
Seat 9: gnella13 (1600 in chips)
Luke141269: posts the ante 10
dimetruk: posts the ante 10
Toallin_eze: posts the ante 10
terr888: posts the ante 10
invisible271: posts the ante 10
gnella13: posts the ante 10
Luke141269: posts small blind 40
dimetruk: posts big blind 80
*** HOLE CARDS ***
Dealt to dimetruk [Ah As]
Toallin_eze: folds
terr888: folds
invisible271: folds
gnella13: folds
Luke141269: calls 40
dimetruk: raises 160 to 240
Luke141269: calls 160
*** FLOP *** [4d Jh Qc]
Luke141269: checks
dimetruk: bets 270
Luke141269: folds
Uncalled bet (270) returned to dimetruk
dimetruk collected 540 from pot
dimetruk: doesn't show hand
*** SUMMARY ***
Total pot 540 | Rake 0
Board [4d Jh Qc]
Seat 2: Luke141269 (small blind) folded on the Flop
Seat 4: dimetruk (big blind) collected (540)
Seat 5: Toallin_eze folded before Flop (didn't bet)
Seat 6: terr888 folded before Flop (didn't bet)
Seat 8: invisible271 folded before Flop (didn't bet)
Seat 9: gnella13 (button) folded before Flop (didn't bet)


PokerStars Hand #228182333982: Tournament #3227430197, $13.70+$1.30 USD Hold'em No Limit - Level IV (40/80) - 2021/07/10 7:56:35 MSK [2021/07/10 0:56:35 ET]
Table '3227430197 1' 9-max Seat #9 is the button
Seat 2: Luke141269 (2786 in chips)
Seat 4: dimetruk (4080 in chips)
Seat 5: Toallin_eze (2624 in chips)
Seat 6: terr888 (1226 in chips)
Seat 8: invisible271 (1674 in chips)
Seat 9: gnella13 (1110 in chips)
Luke141269: posts the ante 10
dimetruk: posts the ante 10
Toallin_eze: posts the ante 10
terr888: posts the ante 10
invisible271: posts the ante 10
gnella13: posts the ante 10
Luke141269: posts small blind 40
dimetruk: posts big blind 80
*** HOLE CARDS ***
Dealt to dimetruk [Td Jd]
Toallin_eze: folds
terr888 has timed out
terr888: folds
terr888 is sitting out
invisible271: raises 80 to 160
terr888 has returned
gnella13: folds
Luke141269: folds
dimetruk: calls 80
*** FLOP *** [5h 3c Kd]
dimetruk: checks
invisible271: bets 139
dimetruk: folds
Uncalled bet (139) returned to invisible271
invisible271 collected 420 from pot
invisible271: doesn't show hand
*** SUMMARY ***
Total pot 420 | Rake 0
Board [5h 3c Kd]
Seat 2: Luke141269 (small blind) folded before Flop
Seat 4: dimetruk (big blind) folded on the Flop
Seat 5: Toallin_eze folded before Flop (didn't bet)
Seat 6: terr888 folded before Flop (didn't bet)
Seat 8: invisible271 collected (420)
Seat 9: gnella13 (button) folded before Flop (didn't bet)


PokerStars Hand #228182339602: Tournament #3227430197, $13.70+$1.30 USD Hold'em No Limit - Level IV (40/80) - 2021/07/10 7:57:14 MSK [2021/07/10 0:57:14 ET]
Table '3227430197 1' 9-max Seat #2 is the button
Seat 2: Luke141269 (2736 in chips)
Seat 4: dimetruk (3910 in chips)
Seat 5: Toallin_eze (2614 in chips)
Seat 6: terr888 (1216 in chips)
Seat 8: invisible271 (1924 in chips)
Seat 9: gnella13 (1100 in chips)
Luke141269: posts the ante 10
dimetruk: posts the ante 10
Toallin_eze: posts the ante 10
terr888: posts the ante 10
invisible271: posts the ante 10
gnella13: posts the ante 10
dimetruk: posts small blind 40
Toallin_eze: posts big blind 80
*** HOLE CARDS ***
Dealt to dimetruk [7c 7h]
terr888 has timed out
terr888: folds
terr888 is sitting out
invisible271: folds
gnella13: raises 80 to 160
Luke141269: folds
terr888 has returned
dimetruk: calls 120
Toallin_eze: calls 80
*** FLOP *** [Qh Kh 2s]
dimetruk: checks
Toallin_eze: checks
gnella13: bets 930 and is all-in
dimetruk: folds
Toallin_eze: folds
Uncalled bet (930) returned to gnella13
gnella13 collected 540 from pot
*** SUMMARY ***
Total pot 540 | Rake 0
Board [Qh Kh 2s]
Seat 2: Luke141269 (button) folded before Flop (didn't bet)
Seat 4: dimetruk (small blind) folded on the Flop
Seat 5: Toallin_eze (big blind) folded on the Flop
Seat 6: terr888 folded before Flop (didn't bet)
Seat 8: invisible271 folded before Flop (didn't bet)
Seat 9: gnella13 collected (540)


PokerStars Hand #228182394974: Tournament #3227430197, $13.70+$1.30 USD Hold'em No Limit - Level V (60/120) - 2021/07/10 8:03:03 MSK [2021/07/10 1:03:03 ET]
Table '3227430197 1' 9-max Seat #8 is the button
Seat 2: Luke141269 (3784 in chips)
Seat 4: dimetruk (3390 in chips)
Seat 5: Toallin_eze (1834 in chips)
Seat 6: terr888 (1096 in chips)
Seat 8: invisible271 (2104 in chips)
Seat 9: gnella13 (1292 in chips)
Luke141269: posts the ante 15
dimetruk: posts the ante 15
Toallin_eze: posts the ante 15
terr888: posts the ante 15
invisible271: posts the ante 15
gnella13: posts the ante 15
gnella13: posts small blind 60
Luke141269: posts big blind 120
*** HOLE CARDS ***
Dealt to dimetruk [Ac Ks]
dimetruk: raises 120 to 240
Toallin_eze: folds
terr888: calls 240
invisible271: folds
gnella13: folds
Luke141269: folds
*** FLOP *** [Td 9c Ah]
dimetruk: bets 240
terr888: folds
Uncalled bet (240) returned to dimetruk
dimetruk collected 750 from pot
dimetruk: doesn't show hand
*** SUMMARY ***
Total pot 750 | Rake 0
Board [Td 9c Ah]
Seat 2: Luke141269 (big blind) folded before Flop
Seat 4: dimetruk collected (750)
Seat 5: Toallin_eze folded before Flop (didn't bet)
Seat 6: terr888 folded on the Flop
Seat 8: invisible271 (button) folded before Flop (didn't bet)
Seat 9: gnella13 (small blind) folded before Flop


PokerStars Hand #228182400819: Tournament #3227430197, $13.70+$1.30 USD Hold'em No Limit - Level V (60/120) - 2021/07/10 8:03:39 MSK [2021/07/10 1:03:39 ET]
Table '3227430197 1' 9-max Seat #9 is the button
Seat 2: Luke141269 (3649 in chips)
Seat 4: dimetruk (3885 in chips)
Seat 5: Toallin_eze (1819 in chips)
Seat 6: terr888 (841 in chips)
Seat 8: invisible271 (2089 in chips)
Seat 9: gnella13 (1217 in chips)
Luke141269: posts the ante 15
dimetruk: posts the ante 15
Toallin_eze: posts the ante 15
terr888: posts the ante 15
invisible271: posts the ante 15
gnella13: posts the ante 15
Luke141269: posts small blind 60
dimetruk: posts big blind 120
*** HOLE CARDS ***
Dealt to dimetruk [Tc Kc]
Toallin_eze: folds
terr888: folds
invisible271: folds
gnella13: folds
Luke141269: raises 180 to 300
dimetruk: calls 180
*** FLOP *** [As 2d 7c]
Luke141269: bets 228
dimetruk: folds
Uncalled bet (228) returned to Luke141269
Luke141269 collected 690 from pot
Luke141269: doesn't show hand
*** SUMMARY ***
Total pot 690 | Rake 0
Board [As 2d 7c]
Seat 2: Luke141269 (small blind) collected (690)
Seat 4: dimetruk (big blind) folded on the Flop
Seat 5: Toallin_eze folded before Flop (didn't bet)
Seat 6: terr888 folded before Flop (didn't bet)
Seat 8: invisible271 folded before Flop (didn't bet)
Seat 9: gnella13 (button) folded before Flop (didn't bet)


PokerStars Hand #228182425579: Tournament #3227430197, $13.70+$1.30 USD Hold'em No Limit - Level V (60/120) - 2021/07/10 8:06:10 MSK [2021/07/10 1:06:10 ET]
Table '3227430197 1' 9-max Seat #6 is the button
Seat 2: Luke141269 (4909 in chips)
Seat 4: dimetruk (3075 in chips)
Seat 5: Toallin_eze (1399 in chips)
Seat 6: terr888 (1051 in chips)
Seat 8: invisible271 (1909 in chips)
Seat 9: gnella13 (1157 in chips)
Luke141269: posts the ante 15
dimetruk: posts the ante 15
Toallin_eze: posts the ante 15
terr888: posts the ante 15
invisible271: posts the ante 15
gnella13: posts the ante 15
invisible271: posts small blind 60
gnella13: posts big blind 120
*** HOLE CARDS ***
Dealt to dimetruk [Qd Jh]
Luke141269: folds
dimetruk: raises 120 to 240
Toallin_eze: folds
terr888: folds
invisible271: folds
gnella13: calls 120
*** FLOP *** [3s 9s 5d]
gnella13: checks
dimetruk: checks
*** TURN *** [3s 9s 5d] [4d]
gnella13: bets 120
dimetruk: calls 120
*** RIVER *** [3s 9s 5d 4d] [7h]
gnella13: bets 240
dimetruk: folds
Uncalled bet (240) returned to gnella13
gnella13 collected 870 from pot
*** SUMMARY ***
Total pot 870 | Rake 0
Board [3s 9s 5d 4d 7h]
Seat 2: Luke141269 folded before Flop (didn't bet)
Seat 4: dimetruk folded on the River
Seat 5: Toallin_eze folded before Flop (didn't bet)
Seat 6: terr888 (button) folded before Flop (didn't bet)
Seat 8: invisible271 (small blind) folded before Flop
Seat 9: gnella13 (big blind) collected (870)


PokerStars Hand #228182438842: Tournament #3227430197, $13.70+$1.30 USD Hold'em No Limit - Level V (60/120) - 2021/07/10 8:07:32 MSK [2021/07/10 1:07:32 ET]
Table '3227430197 1' 9-max Seat #9 is the button
Seat 2: Luke141269 (4759 in chips)
Seat 4: dimetruk (2685 in chips)
Seat 5: Toallin_eze (1369 in chips)
Seat 6: terr888 (1021 in chips)
Seat 8: invisible271 (1819 in chips)
Seat 9: gnella13 (1847 in chips)
Luke141269: posts the ante 15
dimetruk: posts the ante 15
Toallin_eze: posts the ante 15
terr888: posts the ante 15
invisible271: posts the ante 15
gnella13: posts the ante 15
Luke141269: posts small blind 60
dimetruk: posts big blind 120
*** HOLE CARDS ***
Dealt to dimetruk [8s Qs]
Toallin_eze: folds
terr888: folds
invisible271: folds
gnella13: calls 120
Luke141269: folds
dimetruk: checks
*** FLOP *** [Js 8c Kc]
dimetruk: bets 120
gnella13: calls 120
*** TURN *** [Js 8c Kc] [Td]
dimetruk: bets 315
gnella13: calls 315
*** RIVER *** [Js 8c Kc Td] [2d]
dimetruk: checks
gnella13: checks
*** SHOW DOWN ***
dimetruk: shows [8s Qs] (a pair of Eights)
gnella13: shows [9d Ts] (a pair of Tens)
gnella13 collected 1260 from pot
*** SUMMARY ***
Total pot 1260 | Rake 0
Board [Js 8c Kc Td 2d]
Seat 2: Luke141269 (small blind) folded before Flop
Seat 4: dimetruk (big blind) showed [8s Qs] and lost with a pair of Eights
Seat 5: Toallin_eze folded before Flop (didn't bet)
Seat 6: terr888 folded before Flop (didn't bet)
Seat 8: invisible271 folded before Flop (didn't bet)
Seat 9: gnella13 (button) showed [9d Ts] and won (1260) with a pair of Tens


PokerStars Hand #228182492476: Tournament #3227430197, $13.70+$1.30 USD Hold'em No Limit - Level V (60/120) - 2021/07/10 8:12:27 MSK [2021/07/10 1:12:27 ET]
Table '3227430197 1' 9-max Seat #9 is the button
Seat 2: Luke141269 (3739 in chips)
Seat 4: dimetruk (3270 in chips)
Seat 5: Toallin_eze (769 in chips)
Seat 6: terr888 (811 in chips)
Seat 8: invisible271 (1549 in chips)
Seat 9: gnella13 (3362 in chips)
Luke141269: posts the ante 15
dimetruk: posts the ante 15
Toallin_eze: posts the ante 15
terr888: posts the ante 15
invisible271: posts the ante 15
gnella13: posts the ante 15
Luke141269: posts small blind 60
dimetruk: posts big blind 120
*** HOLE CARDS ***
Dealt to dimetruk [Td 8d]
Toallin_eze: raises 240 to 360
terr888 has timed out
terr888: folds
terr888 is sitting out
invisible271: folds
terr888 has returned
gnella13: calls 360
Luke141269: folds
dimetruk: calls 240
*** FLOP *** [3s Kd 7c]
dimetruk: checks
Toallin_eze: bets 394 and is all-in
gnella13: folds
dimetruk: calls 394
*** TURN *** [3s Kd 7c] [2s]
*** RIVER *** [3s Kd 7c 2s] [6h]
*** SHOW DOWN ***
dimetruk: shows [Td 8d] (high card King)
Toallin_eze: shows [As Ac] (a pair of Aces)
Toallin_eze collected 2018 from pot
*** SUMMARY ***
Total pot 2018 | Rake 0
Board [3s Kd 7c 2s 6h]
Seat 2: Luke141269 (small blind) folded before Flop
Seat 4: dimetruk (big blind) showed [Td 8d] and lost with high card King
Seat 5: Toallin_eze showed [As Ac] and won (2018) with a pair of Aces
Seat 6: terr888 folded before Flop (didn't bet)
Seat 8: invisible271 folded before Flop (didn't bet)
Seat 9: gnella13 (button) folded on the Flop


PokerStars Hand #228182568410: Tournament #3227430197, $13.70+$1.30 USD Hold'em No Limit - Level VI (80/160) - 2021/07/10 8:20:07 MSK [2021/07/10 1:20:07 ET]
Table '3227430197 1' 9-max Seat #9 is the button
Seat 2: Luke141269 (2370 in chips)
Seat 4: dimetruk (3161 in chips)
Seat 5: Toallin_eze (1758 in chips)
Seat 6: terr888 (852 in chips)
Seat 8: invisible271 (1908 in chips)
Seat 9: gnella13 (3451 in chips)
Luke141269: posts the ante 20
dimetruk: posts the ante 20
Toallin_eze: posts the ante 20
terr888: posts the ante 20
invisible271: posts the ante 20
gnella13: posts the ante 20
Luke141269: posts small blind 80
dimetruk: posts big blind 160
*** HOLE CARDS ***
Dealt to dimetruk [Kd 8d]
Toallin_eze: folds
terr888: raises 160 to 320
invisible271: folds
gnella13: folds
Luke141269: folds
dimetruk: calls 160
*** FLOP *** [5s 2s Jc]
dimetruk: checks
terr888: bets 512 and is all-in
dimetruk: folds
Uncalled bet (512) returned to terr888
terr888 collected 840 from pot
*** SUMMARY ***
Total pot 840 | Rake 0
Board [5s 2s Jc]
Seat 2: Luke141269 (small blind) folded before Flop
Seat 4: dimetruk (big blind) folded on the Flop
Seat 5: Toallin_eze folded before Flop (didn't bet)
Seat 6: terr888 collected (840)
Seat 8: invisible271 folded before Flop (didn't bet)
Seat 9: gnella13 (button) folded before Flop (didn't bet)


PokerStars Hand #228182588965: Tournament #3227430197, $13.70+$1.30 USD Hold'em No Limit - Level VI (80/160) - 2021/07/10 8:21:57 MSK [2021/07/10 1:21:57 ET]
Table '3227430197 1' 9-max Seat #6 is the button
Seat 2: Luke141269 (2210 in chips)
Seat 4: dimetruk (2681 in chips)
Seat 5: Toallin_eze (1438 in chips)
Seat 6: terr888 (1052 in chips)
Seat 8: invisible271 (2028 in chips)
Seat 9: gnella13 (4091 in chips)
Luke141269: posts the ante 20
dimetruk: posts the ante 20
Toallin_eze: posts the ante 20
terr888: posts the ante 20
invisible271: posts the ante 20
gnella13: posts the ante 20
invisible271: posts small blind 80
gnella13: posts big blind 160
*** HOLE CARDS ***
Dealt to dimetruk [3s As]
Luke141269: folds
dimetruk: raises 160 to 320
Toallin_eze: folds
terr888: folds
invisible271: folds
gnella13: calls 160
*** FLOP *** [Qd 5d Td]
gnella13: checks
dimetruk: bets 294
gnella13: folds
Uncalled bet (294) returned to dimetruk
dimetruk collected 840 from pot
dimetruk: doesn't show hand
*** SUMMARY ***
Total pot 840 | Rake 0
Board [Qd 5d Td]
Seat 2: Luke141269 folded before Flop (didn't bet)
Seat 4: dimetruk collected (840)
Seat 5: Toallin_eze folded before Flop (didn't bet)
Seat 6: terr888 (button) folded before Flop (didn't bet)
Seat 8: invisible271 (small blind) folded before Flop
Seat 9: gnella13 (big blind) folded on the Flop


PokerStars Hand #228182615374: Tournament #3227430197, $13.70+$1.30 USD Hold'em No Limit - Level VII (100/200) - 2021/07/10 8:24:42 MSK [2021/07/10 1:24:42 ET]
Table '3227430197 1' 9-max Seat #8 is the button
Seat 2: Luke141269 (2190 in chips)
Seat 4: dimetruk (3631 in chips)
Seat 6: terr888 (807 in chips)
Seat 8: invisible271 (1503 in chips)
Seat 9: gnella13 (5369 in chips)
Luke141269: posts the ante 25
dimetruk: posts the ante 25
terr888: posts the ante 25
invisible271: posts the ante 25
gnella13: posts the ante 25
gnella13: posts small blind 100
Luke141269: posts big blind 200
*** HOLE CARDS ***
Dealt to dimetruk [9d As]
dimetruk: raises 200 to 400
terr888: folds
invisible271: folds
gnella13: calls 300
Luke141269: folds
*** FLOP *** [Qs 5d 4d]
gnella13: checks
dimetruk: checks
*** TURN *** [Qs 5d 4d] [4h]
gnella13: bets 200
dimetruk: calls 200
*** RIVER *** [Qs 5d 4d 4h] [2c]
gnella13: bets 400
dimetruk: calls 400
*** SHOW DOWN ***
gnella13: shows [8s Ks] (a pair of Fours)
dimetruk: shows [9d As] (a pair of Fours - Ace kicker)
dimetruk collected 2325 from pot
*** SUMMARY ***
Total pot 2325 | Rake 0
Board [Qs 5d 4d 4h 2c]
Seat 2: Luke141269 (big blind) folded before Flop
Seat 4: dimetruk showed [9d As] and won (2325) with a pair of Fours
Seat 6: terr888 folded before Flop (didn't bet)
Seat 8: invisible271 (button) folded before Flop (didn't bet)
Seat 9: gnella13 (small blind) showed [8s Ks] and lost with a pair of Fours


PokerStars Hand #228182624646: Tournament #3227430197, $13.70+$1.30 USD Hold'em No Limit - Level VII (100/200) - 2021/07/10 8:25:39 MSK [2021/07/10 1:25:39 ET]
Table '3227430197 1' 9-max Seat #2 is the button
Seat 2: Luke141269 (2265 in chips)
Seat 4: dimetruk (4706 in chips)
Seat 6: terr888 (757 in chips)
Seat 8: invisible271 (1453 in chips)
Seat 9: gnella13 (4319 in chips)
Luke141269: posts the ante 25
dimetruk: posts the ante 25
terr888: posts the ante 25
invisible271: posts the ante 25
gnella13: posts the ante 25
dimetruk: posts small blind 100
terr888: posts big blind 200
*** HOLE CARDS ***
Dealt to dimetruk [Qs 5s]
invisible271: folds
gnella13: calls 200
Luke141269: folds
dimetruk: calls 100
terr888: checks
*** FLOP *** [4s 4d 2c]
dimetruk: checks
terr888: checks
gnella13: checks
*** TURN *** [4s 4d 2c] [Td]
dimetruk: checks
terr888: bets 400
gnella13: folds
dimetruk: folds
Uncalled bet (400) returned to terr888
terr888 collected 725 from pot
*** SUMMARY ***
Total pot 725 | Rake 0
Board [4s 4d 2c Td]
Seat 2: Luke141269 (button) folded before Flop (didn't bet)
Seat 4: dimetruk (small blind) folded on the Turn
Seat 6: terr888 (big blind) collected (725)
Seat 8: invisible271 folded before Flop (didn't bet)
Seat 9: gnella13 folded on the Turn


PokerStars Hand #228182631822: Tournament #3227430197, $13.70+$1.30 USD Hold'em No Limit - Level VII (100/200) - 2021/07/10 8:26:24 MSK [2021/07/10 1:26:24 ET]
Table '3227430197 1' 9-max Seat #4 is the button
Seat 2: Luke141269 (2240 in chips)
Seat 4: dimetruk (4481 in chips)
Seat 6: terr888 (1257 in chips)
Seat 8: invisible271 (1428 in chips)
Seat 9: gnella13 (4094 in chips)
Luke141269: posts the ante 25
dimetruk: posts the ante 25
terr888: posts the ante 25
invisible271: posts the ante 25
gnella13: posts the ante 25
terr888: posts small blind 100
invisible271: posts big blind 200
*** HOLE CARDS ***
Dealt to dimetruk [Ad Jh]
gnella13: calls 200
Luke141269: folds
dimetruk: raises 400 to 600
terr888: folds
invisible271: folds
gnella13: calls 400
*** FLOP *** [6c 6d Ac]
gnella13: checks
dimetruk: checks
*** TURN *** [6c 6d Ac] [8h]
gnella13: checks
dimetruk: bets 569
gnella13: folds
Uncalled bet (569) returned to dimetruk
dimetruk collected 1625 from pot
dimetruk: doesn't show hand
*** SUMMARY ***
Total pot 1625 | Rake 0
Board [6c 6d Ac 8h]
Seat 2: Luke141269 folded before Flop (didn't bet)
Seat 4: dimetruk (button) collected (1625)
Seat 6: terr888 (small blind) folded before Flop
Seat 8: invisible271 (big blind) folded before Flop
Seat 9: gnella13 folded on the Turn


PokerStars Hand #228182647398: Tournament #3227430197, $13.70+$1.30 USD Hold'em No Limit - Level VII (100/200) - 2021/07/10 8:28:02 MSK [2021/07/10 1:28:02 ET]
Table '3227430197 1' 9-max Seat #4 is the button
Seat 2: Luke141269 (2640 in chips)
Seat 4: dimetruk (5506 in chips)
Seat 6: terr888 (832 in chips)
Seat 8: invisible271 (1428 in chips)
Seat 9: gnella13 (3094 in chips)
Luke141269: posts the ante 25
dimetruk: posts the ante 25
terr888: posts the ante 25
invisible271: posts the ante 25
gnella13: posts the ante 25
terr888: posts small blind 100
invisible271: posts big blind 200
*** HOLE CARDS ***
Dealt to dimetruk [Qc Kd]
gnella13: folds
Luke141269: folds
dimetruk: raises 1400 to 1600
terr888: calls 707 and is all-in
invisible271: folds
Uncalled bet (793) returned to dimetruk
*** FLOP *** [8c 7s Jc]
*** TURN *** [8c 7s Jc] [5h]
*** RIVER *** [8c 7s Jc 5h] [6s]
*** SHOW DOWN ***
terr888: shows [5c 5d] (three of a kind, Fives)
dimetruk: shows [Qc Kd] (high card King)
terr888 collected 1939 from pot
*** SUMMARY ***
Total pot 1939 | Rake 0
Board [8c 7s Jc 5h 6s]
Seat 2: Luke141269 folded before Flop (didn't bet)
Seat 4: dimetruk (button) showed [Qc Kd] and lost with high card King
Seat 6: terr888 (small blind) showed [5c 5d] and won (1939) with three of a kind, Fives
Seat 8: invisible271 (big blind) folded before Flop
Seat 9: gnella13 folded before Flop (didn't bet)


PokerStars Hand #228182713312: Tournament #3227430197, $13.70+$1.30 USD Hold'em No Limit - Level VIII (150/300) - 2021/07/10 8:33:26 MSK [2021/07/10 1:33:26 ET]
Table '3227430197 1' 9-max Seat #2 is the button
Seat 2: Luke141269 (51 in chips)
Seat 4: dimetruk (3899 in chips)
Seat 6: terr888 (3303 in chips)
Seat 8: invisible271 (2303 in chips)
Seat 9: gnella13 (3944 in chips)
Luke141269: posts the ante 25
dimetruk: posts the ante 25
terr888: posts the ante 25
invisible271: posts the ante 25
gnella13: posts the ante 25
dimetruk: posts small blind 150
terr888: posts big blind 300
*** HOLE CARDS ***
Dealt to dimetruk [9s 3d]
invisible271: folds
gnella13: folds
Luke141269: calls 26 and is all-in
dimetruk: calls 150
terr888: checks
*** FLOP *** [3h Qc 8c]
dimetruk: bets 300
terr888: folds
Uncalled bet (300) returned to dimetruk
*** TURN *** [3h Qc 8c] [4s]
*** RIVER *** [3h Qc 8c 4s] [2d]
*** SHOW DOWN ***
dimetruk: shows [9s 3d] (a pair of Threes)
dimetruk collected 548 from side pot
Luke141269: shows [Tc 8s] (a pair of Eights)
Luke141269 collected 203 from main pot
*** SUMMARY ***
Total pot 751 Main pot 203. Side pot 548. | Rake 0
Board [3h Qc 8c 4s 2d]
Seat 2: Luke141269 (button) showed [Tc 8s] and won (203) with a pair of Eights
Seat 4: dimetruk (small blind) showed [9s 3d] and won (548) with a pair of Threes
Seat 6: terr888 (big blind) folded on the Flop
Seat 8: invisible271 folded before Flop (didn't bet)
Seat 9: gnella13 folded before Flop (didn't bet)


PokerStars Hand #228182731102: Tournament #3227430197, $13.70+$1.30 USD Hold'em No Limit - Level VIII (150/300) - 2021/07/10 8:35:19 MSK [2021/07/10 1:35:19 ET]
Table '3227430197 1' 9-max Seat #8 is the button
Seat 2: Luke141269 (734 in chips)
Seat 4: dimetruk (4072 in chips)
Seat 6: terr888 (5250 in chips)
Seat 8: invisible271 (2353 in chips)
Seat 9: gnella13 (1091 in chips)
Luke141269: posts the ante 25
dimetruk: posts the ante 25
terr888: posts the ante 25
invisible271: posts the ante 25
gnella13: posts the ante 25
gnella13: posts small blind 150
Luke141269: posts big blind 300
*** HOLE CARDS ***
Dealt to dimetruk [Qd Jc]
dimetruk: raises 300 to 600
terr888: folds
invisible271: folds
gnella13: folds
Luke141269: raises 109 to 709 and is all-in
dimetruk: calls 109
*** FLOP *** [6s 5h 5c]
*** TURN *** [6s 5h 5c] [5s]
*** RIVER *** [6s 5h 5c 5s] [Ad]
*** SHOW DOWN ***
Luke141269: shows [Ks Qs] (three of a kind, Fives)
dimetruk: shows [Qd Jc] (three of a kind, Fives - lower kicker)
Luke141269 collected 1693 from pot
*** SUMMARY ***
Total pot 1693 | Rake 0
Board [6s 5h 5c 5s Ad]
Seat 2: Luke141269 (big blind) showed [Ks Qs] and won (1693) with three of a kind, Fives
Seat 4: dimetruk showed [Qd Jc] and lost with three of a kind, Fives
Seat 6: terr888 folded before Flop (didn't bet)
Seat 8: invisible271 (button) folded before Flop (didn't bet)
Seat 9: gnella13 (small blind) folded before Flop


PokerStars Hand #228182755635: Tournament #3227430197, $13.70+$1.30 USD Hold'em No Limit - Level VIII (150/300) - 2021/07/10 8:37:54 MSK [2021/07/10 1:37:54 ET]
Table '3227430197 1' 9-max Seat #2 is the button
Seat 2: Luke141269 (4086 in chips)
Seat 4: dimetruk (3013 in chips)
Seat 6: terr888 (3234 in chips)
Seat 8: invisible271 (310 in chips)
Seat 9: gnella13 (2857 in chips)
Luke141269: posts the ante 25
dimetruk: posts the ante 25
terr888: posts the ante 25
invisible271: posts the ante 25
gnella13: posts the ante 25
dimetruk: posts small blind 150
terr888: posts big blind 300
*** HOLE CARDS ***
Dealt to dimetruk [Ad 4c]
invisible271: calls 285 and is all-in
gnella13: folds
Luke141269: folds
dimetruk: calls 150
terr888: checks
*** FLOP *** [8c 6h Ac]
dimetruk: bets 450
terr888: folds
Uncalled bet (450) returned to dimetruk
*** TURN *** [8c 6h Ac] [Kc]
*** RIVER *** [8c 6h Ac Kc] [Ah]
*** SHOW DOWN ***
dimetruk: shows [Ad 4c] (three of a kind, Aces)
dimetruk collected 30 from side pot
invisible271: shows [6d 4d] (two pair, Aces and Sixes)
dimetruk collected 980 from main pot
invisible271 finished the tournament in 5th place
*** SUMMARY ***
Total pot 1010 Main pot 980. Side pot 30. | Rake 0
Board [8c 6h Ac Kc Ah]
Seat 2: Luke141269 (button) folded before Flop (didn't bet)
Seat 4: dimetruk (small blind) showed [Ad 4c] and won (1010) with three of a kind, Aces
Seat 6: terr888 (big blind) folded on the Flop
Seat 8: invisible271 showed [6d 4d] and lost with two pair, Aces and Sixes
Seat 9: gnella13 folded before Flop (didn't bet)


PokerStars Hand #228182762423: Tournament #3227430197, $13.70+$1.30 USD Hold'em No Limit - Level VIII (150/300) - 2021/07/10 8:38:37 MSK [2021/07/10 1:38:37 ET]
Table '3227430197 1' 9-max Seat #4 is the button
Seat 2: Luke141269 (4061 in chips)
Seat 4: dimetruk (3698 in chips)
Seat 6: terr888 (2909 in chips)
Seat 9: gnella13 (2832 in chips)
Luke141269: posts the ante 25
dimetruk: posts the ante 25
terr888: posts the ante 25
gnella13: posts the ante 25
terr888: posts small blind 150
gnella13: posts big blind 300
*** HOLE CARDS ***
Dealt to dimetruk [8d 9d]
Luke141269: folds
dimetruk: raises 300 to 600
terr888: folds
gnella13: calls 300
*** FLOP *** [Kc 6s Jc]
gnella13: checks
dimetruk: bets 508
gnella13: folds
Uncalled bet (508) returned to dimetruk
dimetruk collected 1450 from pot
dimetruk: doesn't show hand
*** SUMMARY ***
Total pot 1450 | Rake 0
Board [Kc 6s Jc]
Seat 2: Luke141269 folded before Flop (didn't bet)
Seat 4: dimetruk (button) collected (1450)
Seat 6: terr888 (small blind) folded before Flop
Seat 9: gnella13 (big blind) folded on the Flop


PokerStars Hand #228182805592: Tournament #3227430197, $13.70+$1.30 USD Hold'em No Limit - Level IX (200/400) - 2021/07/10 8:43:14 MSK [2021/07/10 1:43:14 ET]
Table '3227430197 1' 9-max Seat #2 is the button
Seat 2: Luke141269 (2286 in chips)
Seat 4: dimetruk (5873 in chips)
Seat 6: terr888 (3543 in chips)
Seat 9: gnella13 (1798 in chips)
Luke141269: posts the ante 25
dimetruk: posts the ante 25
terr888: posts the ante 25
gnella13: posts the ante 25
dimetruk: posts small blind 200
terr888: posts big blind 400
*** HOLE CARDS ***
Dealt to dimetruk [Js As]
gnella13: raises 1373 to 1773 and is all-in
Luke141269: folds
dimetruk: raises 4075 to 5848 and is all-in
terr888: folds
Uncalled bet (4075) returned to dimetruk
*** FLOP *** [Qd 4c 3h]
*** TURN *** [Qd 4c 3h] [Ts]
*** RIVER *** [Qd 4c 3h Ts] [9h]
*** SHOW DOWN ***
dimetruk: shows [Js As] (high card Ace)
gnella13: shows [8c 8d] (a pair of Eights)
gnella13 collected 4046 from pot
*** SUMMARY ***
Total pot 4046 | Rake 0
Board [Qd 4c 3h Ts 9h]
Seat 2: Luke141269 (button) folded before Flop (didn't bet)
Seat 4: dimetruk (small blind) showed [Js As] and lost with high card Ace
Seat 6: terr888 (big blind) folded before Flop
Seat 9: gnella13 showed [8c 8d] and won (4046) with a pair of Eights


PokerStars Hand #228182818134: Tournament #3227430197, $13.70+$1.30 USD Hold'em No Limit - Level IX (200/400) - 2021/07/10 8:44:30 MSK [2021/07/10 1:44:30 ET]
Table '3227430197 1' 9-max Seat #4 is the button
Seat 2: Luke141269 (5172 in chips)
Seat 4: dimetruk (3375 in chips)
Seat 6: terr888 (1514 in chips)
Seat 9: gnella13 (3439 in chips)
Luke141269: posts the ante 25
dimetruk: posts the ante 25
terr888: posts the ante 25
gnella13: posts the ante 25
terr888: posts small blind 200
gnella13: posts big blind 400
*** HOLE CARDS ***
Dealt to dimetruk [Jh Qd]
Luke141269: folds
dimetruk: raises 400 to 800
terr888: folds
gnella13: calls 400
*** FLOP *** [Kc 5c 6c]
gnella13: checks
dimetruk: bets 400
gnella13: calls 400
*** TURN *** [Kc 5c 6c] [Th]
gnella13: checks
dimetruk: checks
*** RIVER *** [Kc 5c 6c Th] [3d]
gnella13: bets 400
dimetruk: folds
Uncalled bet (400) returned to gnella13
gnella13 collected 2700 from pot
*** SUMMARY ***
Total pot 2700 | Rake 0
Board [Kc 5c 6c Th 3d]
Seat 2: Luke141269 folded before Flop (didn't bet)
Seat 4: dimetruk (button) folded on the River
Seat 6: terr888 (small blind) folded before Flop
Seat 9: gnella13 (big blind) collected (2700)


PokerStars Hand #228182836411: Tournament #3227430197, $13.70+$1.30 USD Hold'em No Limit - Level IX (200/400) - 2021/07/10 8:46:28 MSK [2021/07/10 1:46:28 ET]
Table '3227430197 1' 9-max Seat #4 is the button
Seat 2: Luke141269 (3608 in chips)
Seat 4: dimetruk (2175 in chips)
Seat 9: gnella13 (7717 in chips)
Luke141269: posts the ante 25
dimetruk: posts the ante 25
gnella13: posts the ante 25
gnella13: posts small blind 200
Luke141269: posts big blind 400
*** HOLE CARDS ***
Dealt to dimetruk [7h 7s]
dimetruk: raises 1750 to 2150 and is all-in
gnella13: raises 5542 to 7692 and is all-in
Luke141269: folds
Uncalled bet (5542) returned to gnella13
*** FLOP *** [5h 2h Kc]
*** TURN *** [5h 2h Kc] [3h]
*** RIVER *** [5h 2h Kc 3h] [5c]
*** SHOW DOWN ***
gnella13: shows [Js Ah] (a pair of Fives)
dimetruk: shows [7h 7s] (two pair, Sevens and Fives)
dimetruk collected 4775 from pot
*** SUMMARY ***
Total pot 4775 | Rake 0
Board [5h 2h Kc 3h 5c]
Seat 2: Luke141269 (big blind) folded before Flop
Seat 4: dimetruk (button) showed [7h 7s] and won (4775) with two pair, Sevens and Fives
Seat 9: gnella13 (small blind) showed [Js Ah] and lost with a pair of Fives


PokerStars Hand #228182839161: Tournament #3227430197, $13.70+$1.30 USD Hold'em No Limit - Level IX (200/400) - 2021/07/10 8:46:45 MSK [2021/07/10 1:46:45 ET]
Table '3227430197 1' 9-max Seat #9 is the button
Seat 2: Luke141269 (3183 in chips)
Seat 4: dimetruk (4775 in chips)
Seat 9: gnella13 (5542 in chips)
Luke141269: posts the ante 25
dimetruk: posts the ante 25
gnella13: posts the ante 25
Luke141269: posts small blind 200
dimetruk: posts big blind 400
*** HOLE CARDS ***
Dealt to dimetruk [Ac 5h]
gnella13: calls 400
Luke141269: folds
dimetruk: checks
*** FLOP *** [Jd Qh Qc]
dimetruk: checks
gnella13: bets 400
dimetruk: calls 400
*** TURN *** [Jd Qh Qc] [6d]
dimetruk: checks
gnella13: checks
*** RIVER *** [Jd Qh Qc 6d] [Kd]
dimetruk: bets 938
gnella13: calls 938
*** SHOW DOWN ***
dimetruk: shows [Ac 5h] (a pair of Queens)
gnella13: shows [9c Tc] (a straight, Nine to King)
gnella13 collected 3751 from pot
*** SUMMARY ***
Total pot 3751 | Rake 0
Board [Jd Qh Qc 6d Kd]
Seat 2: Luke141269 (small blind) folded before Flop
Seat 4: dimetruk (big blind) showed [Ac 5h] and lost with a pair of Queens
Seat 9: gnella13 (button) showed [9c Tc] and won (3751) with a straight, Nine to King


PokerStars Hand #228182845929: Tournament #3227430197, $13.70+$1.30 USD Hold'em No Limit - Level IX (200/400) - 2021/07/10 8:47:30 MSK [2021/07/10 1:47:30 ET]
Table '3227430197 1' 9-max Seat #9 is the button
Seat 2: Luke141269 (2508 in chips)
Seat 4: dimetruk (2762 in chips)
Seat 9: gnella13 (8230 in chips)
Luke141269: posts the ante 25
dimetruk: posts the ante 25
gnella13: posts the ante 25
Luke141269: posts small blind 200
dimetruk: posts big blind 400
*** HOLE CARDS ***
Dealt to dimetruk [5c 5s]
gnella13: folds
Luke141269: raises 2083 to 2483 and is all-in
dimetruk: calls 2083
*** FLOP *** [Td Kh Th]
*** TURN *** [Td Kh Th] [2c]
*** RIVER *** [Td Kh Th 2c] [Ad]
*** SHOW DOWN ***
Luke141269: shows [Tc 8s] (three of a kind, Tens)
dimetruk: shows [5c 5s] (two pair, Tens and Fives)
Luke141269 collected 5041 from pot
*** SUMMARY ***
Total pot 5041 | Rake 0
Board [Td Kh Th 2c Ad]
Seat 2: Luke141269 (small blind) showed [Tc 8s] and won (5041) with three of a kind, Tens
Seat 4: dimetruk (big blind) showed [5c 5s] and lost with two pair, Tens and Fives
Seat 9: gnella13 (button) folded before Flop (didn't bet)


PokerStars Hand #228182848632: Tournament #3227430197, $13.70+$1.30 USD Hold'em No Limit - Level IX (200/400) - 2021/07/10 8:47:48 MSK [2021/07/10 1:47:48 ET]
Table '3227430197 1' 9-max Seat #2 is the button
Seat 2: Luke141269 (5041 in chips)
Seat 4: dimetruk (254 in chips)
Seat 9: gnella13 (8205 in chips)
Luke141269: posts the ante 25
dimetruk: posts the ante 25
gnella13: posts the ante 25
dimetruk: posts small blind 200
gnella13: posts big blind 400
*** HOLE CARDS ***
Dealt to dimetruk [4c 4s]
Luke141269: folds
dimetruk: calls 29 and is all-in
Uncalled bet (171) returned to gnella13
*** FLOP *** [3h 6d 7d]
*** TURN *** [3h 6d 7d] [8d]
*** RIVER *** [3h 6d 7d 8d] [6h]
*** SHOW DOWN ***
dimetruk: shows [4c 4s] (two pair, Sixes and Fours)
gnella13: shows [Qc 7c] (two pair, Sevens and Sixes)
gnella13 collected 533 from pot
dimetruk finished the tournament in 3rd place and received $24.66.
*** SUMMARY ***
Total pot 533 | Rake 0
Board [3h 6d 7d 8d 6h]
Seat 2: Luke141269 (button) folded before Flop (didn't bet)
Seat 4: dimetruk (small blind) showed [4c 4s] and lost with two pair, Sixes and Fours
Seat 9: gnella13 (big blind) showed [Qc 7c] and won (533) with two pair, Sevens and Sixes


PokerStars Hand #228242890835: Tournament #3228689682, $27.40+$2.60 USD Hold'em No Limit - Level I (10/20) - 2021/07/12 21:25:36 MSK [2021/07/12 14:25:36 ET]
Table '3228689682 1' 9-max Seat #1 is the button
Seat 1: dimetruk (1500 in chips)
Seat 2: Matrixxx47 (1500 in chips)
Seat 3: Commercial1 (1500 in chips) is sitting out
Seat 4: JonnyKilo (1500 in chips)
Seat 5: daleaf54 (1500 in chips)
Seat 6: Wlado0711 (1500 in chips)
Seat 7: dclucasPS (1500 in chips)
Seat 8: RaulG777 (1500 in chips)
Seat 9: Latrell1988 (1500 in chips)
dimetruk: posts the ante 3
Matrixxx47: posts the ante 3
Commercial1: posts the ante 3
JonnyKilo: posts the ante 3
daleaf54: posts the ante 3
Wlado0711: posts the ante 3
dclucasPS: posts the ante 3
RaulG777: posts the ante 3
Latrell1988: posts the ante 3
Matrixxx47: posts small blind 10
Commercial1: posts big blind 20
*** HOLE CARDS ***
Dealt to dimetruk [9h 9s]
JonnyKilo: folds
daleaf54: raises 40 to 60
Wlado0711: folds
dclucasPS: folds
RaulG777: folds
Latrell1988: folds
dimetruk: calls 60
Matrixxx47: folds
Commercial1: folds
*** FLOP *** [As 4s Kc]
daleaf54: bets 89
dimetruk: folds
Uncalled bet (89) returned to daleaf54
daleaf54 collected 177 from pot
daleaf54: doesn't show hand
*** SUMMARY ***
Total pot 177 | Rake 0
Board [As 4s Kc]
Seat 1: dimetruk (button) folded on the Flop
Seat 2: Matrixxx47 (small blind) folded before Flop
Seat 3: Commercial1 (big blind) folded before Flop
Seat 4: JonnyKilo folded before Flop (didn't bet)
Seat 5: daleaf54 collected (177)
Seat 6: Wlado0711 folded before Flop (didn't bet)
Seat 7: dclucasPS folded before Flop (didn't bet)
Seat 8: RaulG777 folded before Flop (didn't bet)
Seat 9: Latrell1988 folded before Flop (didn't bet)


PokerStars Hand #228243000314: Tournament #3228689682, $27.40+$2.60 USD Hold'em No Limit - Level I (10/20) - 2021/07/12 21:29:53 MSK [2021/07/12 14:29:53 ET]
Table '3228689682 1' 9-max Seat #8 is the button
Seat 1: dimetruk (1259 in chips)
Seat 2: Matrixxx47 (1526 in chips)
Seat 3: Commercial1 (1449 in chips) is sitting out
Seat 4: JonnyKilo (1813 in chips)
Seat 5: daleaf54 (1566 in chips)
Seat 6: Wlado0711 (1496 in chips)
Seat 7: dclucasPS (1449 in chips)
Seat 8: RaulG777 (1446 in chips)
Seat 9: Latrell1988 (1496 in chips)
dimetruk: posts the ante 3
Matrixxx47: posts the ante 3
Commercial1: posts the ante 3
JonnyKilo: posts the ante 3
daleaf54: posts the ante 3
Wlado0711: posts the ante 3
dclucasPS: posts the ante 3
RaulG777: posts the ante 3
Latrell1988: posts the ante 3
Latrell1988: posts small blind 10
dimetruk: posts big blind 20
*** HOLE CARDS ***
Dealt to dimetruk [Td 8d]
Matrixxx47: folds
Commercial1: folds
JonnyKilo: folds
daleaf54: folds
Wlado0711: folds
dclucasPS: raises 20 to 40
RaulG777: folds
Latrell1988: calls 30
dimetruk: calls 20
*** FLOP *** [Jc 4s 6d]
Latrell1988: checks
dimetruk: checks
dclucasPS: bets 49
Latrell1988: folds
dimetruk: folds
Uncalled bet (49) returned to dclucasPS
dclucasPS collected 147 from pot
dclucasPS: doesn't show hand
*** SUMMARY ***
Total pot 147 | Rake 0
Board [Jc 4s 6d]
Seat 1: dimetruk (big blind) folded on the Flop
Seat 2: Matrixxx47 folded before Flop (didn't bet)
Seat 3: Commercial1 folded before Flop (didn't bet)
Seat 4: JonnyKilo folded before Flop (didn't bet)
Seat 5: daleaf54 folded before Flop (didn't bet)
Seat 6: Wlado0711 folded before Flop (didn't bet)
Seat 7: dclucasPS collected (147)
Seat 8: RaulG777 (button) folded before Flop (didn't bet)
Seat 9: Latrell1988 (small blind) folded on the Flop


PokerStars Hand #228243261953: Tournament #3228689682, $27.40+$2.60 USD Hold'em No Limit - Level II (15/30) - 2021/07/12 21:39:14 MSK [2021/07/12 14:39:14 ET]
Table '3228689682 1' 9-max Seat #8 is the button
Seat 1: dimetruk (1178 in chips)
Seat 2: Matrixxx47 (1980 in chips)
Seat 3: Commercial1 (1388 in chips) is sitting out
Seat 4: JonnyKilo (1794 in chips)
Seat 5: daleaf54 (1576 in chips)
Seat 6: Wlado0711 (1457 in chips)
Seat 7: dclucasPS (1647 in chips)
Seat 8: RaulG777 (1130 in chips)
Seat 9: Latrell1988 (1350 in chips)
dimetruk: posts the ante 4
Matrixxx47: posts the ante 4
Commercial1: posts the ante 4
JonnyKilo: posts the ante 4
daleaf54: posts the ante 4
Wlado0711: posts the ante 4
dclucasPS: posts the ante 4
RaulG777: posts the ante 4
Latrell1988: posts the ante 4
Latrell1988: posts small blind 15
dimetruk: posts big blind 30
*** HOLE CARDS ***
Dealt to dimetruk [4c Ts]
Matrixxx47: folds
Commercial1: folds
JonnyKilo: folds
daleaf54: folds
Wlado0711: folds
dclucasPS: folds
RaulG777: raises 45 to 75
Latrell1988: folds
dimetruk: calls 45
*** FLOP *** [Ks 8s 9s]
dimetruk: checks
RaulG777: bets 66
dimetruk: calls 66
*** TURN *** [Ks 8s 9s] [9d]
dimetruk: checks
RaulG777: bets 110
dimetruk: folds
Uncalled bet (110) returned to RaulG777
RaulG777 collected 333 from pot
RaulG777: doesn't show hand
*** SUMMARY ***
Total pot 333 | Rake 0
Board [Ks 8s 9s 9d]
Seat 1: dimetruk (big blind) folded on the Turn
Seat 2: Matrixxx47 folded before Flop (didn't bet)
Seat 3: Commercial1 folded before Flop (didn't bet)
Seat 4: JonnyKilo folded before Flop (didn't bet)
Seat 5: daleaf54 folded before Flop (didn't bet)
Seat 6: Wlado0711 folded before Flop (didn't bet)
Seat 7: dclucasPS folded before Flop (didn't bet)
Seat 8: RaulG777 (button) collected (333)
Seat 9: Latrell1988 (small blind) folded before Flop


PokerStars Hand #228243482155: Tournament #3228689682, $27.40+$2.60 USD Hold'em No Limit - Level III (25/50) - 2021/07/12 21:47:16 MSK [2021/07/12 14:47:16 ET]
Table '3228689682 1' 9-max Seat #1 is the button
Seat 1: dimetruk (1002 in chips)
Seat 2: Matrixxx47 (1209 in chips)
Seat 3: Commercial1 (1297 in chips) is sitting out
Seat 4: JonnyKilo (2660 in chips)
Seat 5: daleaf54 (1626 in chips)
Seat 6: Wlado0711 (1441 in chips)
Seat 7: dclucasPS (1577 in chips)
Seat 8: RaulG777 (1609 in chips)
Seat 9: Latrell1988 (1079 in chips)
dimetruk: posts the ante 6
Matrixxx47: posts the ante 6
Commercial1: posts the ante 6
JonnyKilo: posts the ante 6
daleaf54: posts the ante 6
Wlado0711: posts the ante 6
dclucasPS: posts the ante 6
RaulG777: posts the ante 6
Latrell1988: posts the ante 6
Matrixxx47: posts small blind 25
Commercial1: posts big blind 50
*** HOLE CARDS ***
Dealt to dimetruk [Kc As]
JonnyKilo: folds
daleaf54: raises 100 to 150
Wlado0711: raises 1285 to 1435 and is all-in
dclucasPS: folds
RaulG777: folds
Latrell1988: folds
dimetruk: calls 996 and is all-in
Matrixxx47: folds
Commercial1: folds
daleaf54: folds
Uncalled bet (439) returned to Wlado0711
*** FLOP *** [Td 6s 4c]
*** TURN *** [Td 6s 4c] [8c]
*** RIVER *** [Td 6s 4c 8c] [Jd]
*** SHOW DOWN ***
Wlado0711: shows [Ah Kh] (high card Ace)
dimetruk: shows [Kc As] (high card Ace)
Wlado0711 collected 1136 from pot
dimetruk collected 1135 from pot
*** SUMMARY ***
Total pot 2271 | Rake 0
Board [Td 6s 4c 8c Jd]
Seat 1: dimetruk (button) showed [Kc As] and won (1135) with high card Ace
Seat 2: Matrixxx47 (small blind) folded before Flop
Seat 3: Commercial1 (big blind) folded before Flop
Seat 4: JonnyKilo folded before Flop (didn't bet)
Seat 5: daleaf54 folded before Flop
Seat 6: Wlado0711 showed [Ah Kh] and won (1136) with high card Ace
Seat 7: dclucasPS folded before Flop (didn't bet)
Seat 8: RaulG777 folded before Flop (didn't bet)
Seat 9: Latrell1988 folded before Flop (didn't bet)


PokerStars Hand #228243758142: Tournament #3228689682, $27.40+$2.60 USD Hold'em No Limit - Level IV (40/80) - 2021/07/12 21:58:25 MSK [2021/07/12 14:58:25 ET]
Table '3228689682 1' 9-max Seat #3 is the button
Seat 1: dimetruk (1222 in chips)
Seat 3: Commercial1 (924 in chips) is sitting out
Seat 4: JonnyKilo (1950 in chips)
Seat 5: daleaf54 (1577 in chips)
Seat 6: Wlado0711 (2292 in chips)
Seat 7: dclucasPS (2589 in chips)
Seat 8: RaulG777 (930 in chips)
Seat 9: Latrell1988 (2016 in chips)
dimetruk: posts the ante 10
Commercial1: posts the ante 10
JonnyKilo: posts the ante 10
daleaf54: posts the ante 10
Wlado0711: posts the ante 10
dclucasPS: posts the ante 10
RaulG777: posts the ante 10
Latrell1988: posts the ante 10
JonnyKilo: posts small blind 40
daleaf54: posts big blind 80
*** HOLE CARDS ***
Dealt to dimetruk [Kc 2c]
Wlado0711: folds
dclucasPS: folds
RaulG777: folds
Latrell1988: folds
dimetruk: raises 80 to 160
Commercial1: folds
JonnyKilo: folds
daleaf54: calls 80
*** FLOP *** [Qc Qh 2h]
daleaf54: checks
dimetruk: bets 120
daleaf54: folds
Uncalled bet (120) returned to dimetruk
dimetruk collected 440 from pot
dimetruk: doesn't show hand
*** SUMMARY ***
Total pot 440 | Rake 0
Board [Qc Qh 2h]
Seat 1: dimetruk collected (440)
Seat 3: Commercial1 (button) folded before Flop (didn't bet)
Seat 4: JonnyKilo (small blind) folded before Flop
Seat 5: daleaf54 (big blind) folded on the Flop
Seat 6: Wlado0711 folded before Flop (didn't bet)
Seat 7: dclucasPS folded before Flop (didn't bet)
Seat 8: RaulG777 folded before Flop (didn't bet)
Seat 9: Latrell1988 folded before Flop (didn't bet)


PokerStars Hand #228243770985: Tournament #3228689682, $27.40+$2.60 USD Hold'em No Limit - Level IV (40/80) - 2021/07/12 21:59:03 MSK [2021/07/12 14:59:03 ET]
Table '3228689682 1' 9-max Seat #4 is the button
Seat 1: dimetruk (1492 in chips)
Seat 3: Commercial1 (914 in chips) is sitting out
Seat 4: JonnyKilo (1900 in chips)
Seat 5: daleaf54 (1407 in chips)
Seat 6: Wlado0711 (2282 in chips)
Seat 7: dclucasPS (2579 in chips)
Seat 8: RaulG777 (920 in chips)
Seat 9: Latrell1988 (2006 in chips)
dimetruk: posts the ante 10
Commercial1: posts the ante 10
JonnyKilo: posts the ante 10
daleaf54: posts the ante 10
Wlado0711: posts the ante 10
dclucasPS: posts the ante 10
RaulG777: posts the ante 10
Latrell1988: posts the ante 10
daleaf54: posts small blind 40
Wlado0711: posts big blind 80
*** HOLE CARDS ***
Dealt to dimetruk [4c 4s]
dclucasPS: folds
RaulG777 is disconnected
RaulG777 is connected
RaulG777 is disconnected
RaulG777 is connected
RaulG777: folds
Latrell1988: folds
dimetruk: raises 80 to 160
Commercial1: folds
JonnyKilo: folds
daleaf54: raises 160 to 320
Wlado0711: folds
dimetruk: calls 160
*** FLOP *** [3c 8d 2s]
daleaf54: checks
dimetruk: checks
*** TURN *** [3c 8d 2s] [Ks]
daleaf54: bets 800
dimetruk: folds
Uncalled bet (800) returned to daleaf54
daleaf54 collected 800 from pot
daleaf54: doesn't show hand
*** SUMMARY ***
Total pot 800 | Rake 0
Board [3c 8d 2s Ks]
Seat 1: dimetruk folded on the Turn
Seat 3: Commercial1 folded before Flop (didn't bet)
Seat 4: JonnyKilo (button) folded before Flop (didn't bet)
Seat 5: daleaf54 (small blind) collected (800)
Seat 6: Wlado0711 (big blind) folded before Flop
Seat 7: dclucasPS folded before Flop (didn't bet)
Seat 8: RaulG777 folded before Flop (didn't bet)
Seat 9: Latrell1988 folded before Flop (didn't bet)


PokerStars Hand #228244105734: Tournament #3228689682, $27.40+$2.60 USD Hold'em No Limit - Level V (60/120) - 2021/07/12 22:11:20 MSK [2021/07/12 15:11:20 ET]
Table '3228689682 1' 9-max Seat #1 is the button
Seat 1: dimetruk (1276 in chips)
Seat 4: JonnyKilo (2084 in chips)
Seat 5: daleaf54 (1550 in chips)
Seat 7: dclucasPS (3429 in chips)
Seat 9: Latrell1988 (5161 in chips)
dimetruk: posts the ante 15
JonnyKilo: posts the ante 15
daleaf54: posts the ante 15
dclucasPS: posts the ante 15
Latrell1988: posts the ante 15
JonnyKilo: posts small blind 60
daleaf54: posts big blind 120
*** HOLE CARDS ***
Dealt to dimetruk [9c 7c]
dclucasPS: folds
Latrell1988: folds
dimetruk: raises 1141 to 1261 and is all-in
JonnyKilo: folds
daleaf54: calls 1141
*** FLOP *** [4h 5h 8c]
*** TURN *** [4h 5h 8c] [5c]
*** RIVER *** [4h 5h 8c 5c] [7h]
*** SHOW DOWN ***
daleaf54: shows [9s As] (a pair of Fives)
dimetruk: shows [9c 7c] (two pair, Sevens and Fives)
dimetruk collected 2657 from pot
*** SUMMARY ***
Total pot 2657 | Rake 0
Board [4h 5h 8c 5c 7h]
Seat 1: dimetruk (button) showed [9c 7c] and won (2657) with two pair, Sevens and Fives
Seat 4: JonnyKilo (small blind) folded before Flop
Seat 5: daleaf54 (big blind) showed [9s As] and lost with a pair of Fives
Seat 7: dclucasPS folded before Flop (didn't bet)
Seat 9: Latrell1988 folded before Flop (didn't bet)


PokerStars Hand #228244118113: Tournament #3228689682, $27.40+$2.60 USD Hold'em No Limit - Level V (60/120) - 2021/07/12 22:11:46 MSK [2021/07/12 15:11:46 ET]
Table '3228689682 1' 9-max Seat #4 is the button
Seat 1: dimetruk (2657 in chips)
Seat 4: JonnyKilo (2009 in chips)
Seat 5: daleaf54 (274 in chips)
Seat 7: dclucasPS (3414 in chips)
Seat 9: Latrell1988 (5146 in chips)
dimetruk: posts the ante 15
JonnyKilo: posts the ante 15
daleaf54: posts the ante 15
dclucasPS: posts the ante 15
Latrell1988: posts the ante 15
daleaf54: posts small blind 60
dclucasPS: posts big blind 120
*** HOLE CARDS ***
Dealt to dimetruk [Kc 8c]
Latrell1988: folds
dimetruk: raises 120 to 240
JonnyKilo: folds
daleaf54: raises 19 to 259 and is all-in
dclucasPS: calls 139
dimetruk: calls 19
*** FLOP *** [6d 3h 5d]
dclucasPS: checks
dimetruk: checks
*** TURN *** [6d 3h 5d] [6h]
dclucasPS: checks
dimetruk: checks
*** RIVER *** [6d 3h 5d 6h] [8h]
dclucasPS: checks
dimetruk: checks
*** SHOW DOWN ***
daleaf54: shows [5s 5h] (a full house, Fives full of Sixes)
dclucasPS: mucks hand
dimetruk: mucks hand
daleaf54 collected 852 from pot
*** SUMMARY ***
Total pot 852 | Rake 0
Board [6d 3h 5d 6h 8h]
Seat 1: dimetruk mucked [Kc 8c]
Seat 4: JonnyKilo (button) folded before Flop (didn't bet)
Seat 5: daleaf54 (small blind) showed [5s 5h] and won (852) with a full house, Fives full of Sixes
Seat 7: dclucasPS (big blind) mucked [Jc Ks]
Seat 9: Latrell1988 folded before Flop (didn't bet)


PokerStars Hand #228244257884: Tournament #3228689682, $27.40+$2.60 USD Hold'em No Limit - Level VI (80/160) - 2021/07/12 22:16:37 MSK [2021/07/12 15:16:37 ET]
Table '3228689682 1' 9-max Seat #7 is the button
Seat 1: dimetruk (2368 in chips)
Seat 4: JonnyKilo (3868 in chips)
Seat 7: dclucasPS (1350 in chips)
Seat 9: Latrell1988 (5914 in chips)
dimetruk: posts the ante 20
JonnyKilo: posts the ante 20
dclucasPS: posts the ante 20
Latrell1988: posts the ante 20
Latrell1988: posts small blind 80
dimetruk: posts big blind 160
*** HOLE CARDS ***
Dealt to dimetruk [2s 6d]
JonnyKilo: folds
dclucasPS: folds
Latrell1988: calls 80
dimetruk: checks
*** FLOP *** [2h 5s 8s]
Latrell1988: checks
dimetruk: bets 160
Latrell1988: folds
Uncalled bet (160) returned to dimetruk
dimetruk collected 400 from pot
dimetruk: doesn't show hand
*** SUMMARY ***
Total pot 400 | Rake 0
Board [2h 5s 8s]
Seat 1: dimetruk (big blind) collected (400)
Seat 4: JonnyKilo folded before Flop (didn't bet)
Seat 7: dclucasPS (button) folded before Flop (didn't bet)
Seat 9: Latrell1988 (small blind) folded on the Flop


PokerStars Hand #228244311794: Tournament #3228689682, $27.40+$2.60 USD Hold'em No Limit - Level VI (80/160) - 2021/07/12 22:18:29 MSK [2021/07/12 15:18:29 ET]
Table '3228689682 1' 9-max Seat #4 is the button
Seat 1: dimetruk (2788 in chips)
Seat 4: JonnyKilo (3568 in chips)
Seat 7: dclucasPS (1450 in chips)
Seat 9: Latrell1988 (5694 in chips)
dimetruk: posts the ante 20
JonnyKilo: posts the ante 20
dclucasPS: posts the ante 20
Latrell1988: posts the ante 20
dclucasPS: posts small blind 80
Latrell1988: posts big blind 160
*** HOLE CARDS ***
Dealt to dimetruk [Ad 8h]
dimetruk: raises 160 to 320
JonnyKilo: folds
dclucasPS: folds
Latrell1988: calls 160
*** FLOP *** [Td 6c 4s]
Latrell1988: checks
dimetruk: bets 280
Latrell1988: calls 280
*** TURN *** [Td 6c 4s] [Ts]
Latrell1988: checks
dimetruk: checks
*** RIVER *** [Td 6c 4s Ts] [5h]
Latrell1988: checks
dimetruk: checks
*** SHOW DOWN ***
Latrell1988: shows [6d 4d] (two pair, Tens and Sixes)
dimetruk: mucks hand
Latrell1988 collected 1360 from pot
*** SUMMARY ***
Total pot 1360 | Rake 0
Board [Td 6c 4s Ts 5h]
Seat 1: dimetruk mucked [Ad 8h]
Seat 4: JonnyKilo (button) folded before Flop (didn't bet)
Seat 7: dclucasPS (small blind) folded before Flop
Seat 9: Latrell1988 (big blind) showed [6d 4d] and won (1360) with two pair, Tens and Sixes


PokerStars Hand #228244354022: Tournament #3228689682, $27.40+$2.60 USD Hold'em No Limit - Level VI (80/160) - 2021/07/12 22:19:39 MSK [2021/07/12 15:19:39 ET]
Table '3228689682 1' 9-max Seat #7 is the button
Seat 1: dimetruk (2168 in chips)
Seat 4: JonnyKilo (3548 in chips)
Seat 7: dclucasPS (1350 in chips)
Seat 9: Latrell1988 (6434 in chips)
dimetruk: posts the ante 20
JonnyKilo: posts the ante 20
dclucasPS: posts the ante 20
Latrell1988: posts the ante 20
Latrell1988: posts small blind 80
dimetruk: posts big blind 160
*** HOLE CARDS ***
Dealt to dimetruk [As Kh]
JonnyKilo: folds
dclucasPS: raises 1170 to 1330 and is all-in
Latrell1988: folds
dimetruk: calls 1170
*** FLOP *** [Qc 4h Kc]
*** TURN *** [Qc 4h Kc] [Td]
*** RIVER *** [Qc 4h Kc Td] [8d]
*** SHOW DOWN ***
dimetruk: shows [As Kh] (a pair of Kings)
dclucasPS: shows [Ts Qd] (two pair, Queens and Tens)
dclucasPS collected 2820 from pot
*** SUMMARY ***
Total pot 2820 | Rake 0
Board [Qc 4h Kc Td 8d]
Seat 1: dimetruk (big blind) showed [As Kh] and lost with a pair of Kings
Seat 4: JonnyKilo folded before Flop (didn't bet)
Seat 7: dclucasPS (button) showed [Ts Qd] and won (2820) with two pair, Queens and Tens
Seat 9: Latrell1988 (small blind) folded before Flop


PokerStars Hand #228244452800: Tournament #3228689682, $27.40+$2.60 USD Hold'em No Limit - Level VI (80/160) - 2021/07/12 22:23:00 MSK [2021/07/12 15:23:00 ET]
Table '3228689682 1' 9-max Seat #9 is the button
Seat 1: dimetruk (1458 in chips)
Seat 4: JonnyKilo (3208 in chips)
Seat 7: dclucasPS (2180 in chips)
Seat 9: Latrell1988 (6654 in chips)
dimetruk: posts the ante 20
JonnyKilo: posts the ante 20
dclucasPS: posts the ante 20
Latrell1988: posts the ante 20
dimetruk: posts small blind 80
JonnyKilo: posts big blind 160
*** HOLE CARDS ***
Dealt to dimetruk [6c Kd]
dclucasPS: folds
Latrell1988: calls 160
dimetruk: calls 80
JonnyKilo: checks
*** FLOP *** [5s Tc 3c]
dimetruk: checks
JonnyKilo: checks
Latrell1988: checks
*** TURN *** [5s Tc 3c] [Ts]
dimetruk: checks
JonnyKilo: bets 160
Latrell1988: calls 160
dimetruk: folds
*** RIVER *** [5s Tc 3c Ts] [9d]
JonnyKilo: checks
Latrell1988: checks
*** SHOW DOWN ***
JonnyKilo: shows [6h 3s] (two pair, Tens and Threes)
Latrell1988: mucks hand
JonnyKilo collected 880 from pot
*** SUMMARY ***
Total pot 880 | Rake 0
Board [5s Tc 3c Ts 9d]
Seat 1: dimetruk (small blind) folded on the Turn
Seat 4: JonnyKilo (big blind) showed [6h 3s] and won (880) with two pair, Tens and Threes
Seat 7: dclucasPS folded before Flop (didn't bet)
Seat 9: Latrell1988 (button) mucked [As 2s]


PokerStars Hand #228244533753: Tournament #3228689682, $27.40+$2.60 USD Hold'em No Limit - Level VII (100/200) - 2021/07/12 22:25:46 MSK [2021/07/12 15:25:46 ET]
Table '3228689682 1' 9-max Seat #4 is the button
Seat 1: dimetruk (1258 in chips)
Seat 4: JonnyKilo (3968 in chips)
Seat 7: dclucasPS (1980 in chips)
Seat 9: Latrell1988 (6294 in chips)
dimetruk: posts the ante 25
JonnyKilo: posts the ante 25
dclucasPS: posts the ante 25
Latrell1988: posts the ante 25
dclucasPS: posts small blind 100
Latrell1988: posts big blind 200
*** HOLE CARDS ***
Dealt to dimetruk [Tc Kc]
dimetruk: raises 1033 to 1233 and is all-in
JonnyKilo: folds
dclucasPS: folds
Latrell1988: calls 1033
*** FLOP *** [Ah Ac Qs]
*** TURN *** [Ah Ac Qs] [3d]
*** RIVER *** [Ah Ac Qs 3d] [5h]
*** SHOW DOWN ***
Latrell1988: shows [7d 7c] (two pair, Aces and Sevens)
dimetruk: shows [Tc Kc] (a pair of Aces)
Latrell1988 collected 2666 from pot
dimetruk finished the tournament in 4th place
*** SUMMARY ***
Total pot 2666 | Rake 0
Board [Ah Ac Qs 3d 5h]
Seat 1: dimetruk showed [Tc Kc] and lost with a pair of Aces
Seat 4: JonnyKilo (button) folded before Flop (didn't bet)
Seat 7: dclucasPS (small blind) folded before Flop
Seat 9: Latrell1988 (big blind) showed [7d 7c] and won (2666) with two pair, Aces and Sevens


PokerStars Hand #228242787040: Tournament #3228838622, $13.70+$1.30 USD Hold'em No Limit - Level I (10/20) - 2021/07/12 21:21:32 MSK [2021/07/12 14:21:32 ET]
Table '3228838622 1' 9-max Seat #1 is the button
Seat 1: ABBYYjunior (1500 in chips)
Seat 2: sas_2016335 (1500 in chips)
Seat 3: dimetruk (1500 in chips)
Seat 4: rabbahiff (1500 in chips)
Seat 5: OhSeas (1500 in chips)
Seat 6: Wolfffff (1500 in chips)
Seat 7: SEREGA196914 (1500 in chips)
Seat 8: dclucasPS (1500 in chips)
Seat 9: Matrixxx47 (1500 in chips)
ABBYYjunior: posts the ante 3
sas_2016335: posts the ante 3
dimetruk: posts the ante 3
rabbahiff: posts the ante 3
OhSeas: posts the ante 3
Wolfffff: posts the ante 3
SEREGA196914: posts the ante 3
dclucasPS: posts the ante 3
Matrixxx47: posts the ante 3
sas_2016335: posts small blind 10
dimetruk: posts big blind 20
*** HOLE CARDS ***
Dealt to dimetruk [9d 9s]
rabbahiff: folds
OhSeas: folds
Wolfffff: folds
SEREGA196914: raises 30 to 50
dclucasPS: folds
Matrixxx47: folds
ABBYYjunior: folds
sas_2016335: folds
dimetruk: calls 30
*** FLOP *** [6c 6s 6h]
dimetruk: checks
SEREGA196914: bets 45
dimetruk: calls 45
*** TURN *** [6c 6s 6h] [Js]
dimetruk: checks
SEREGA196914: bets 116
dimetruk: calls 116
*** RIVER *** [6c 6s 6h Js] [Qs]
dimetruk: checks
SEREGA196914: checks
*** SHOW DOWN ***
dimetruk: shows [9d 9s] (a full house, Sixes full of Nines)
SEREGA196914: mucks hand
dimetruk collected 459 from pot
*** SUMMARY ***
Total pot 459 | Rake 0
Board [6c 6s 6h Js Qs]
Seat 1: ABBYYjunior (button) folded before Flop (didn't bet)
Seat 2: sas_2016335 (small blind) folded before Flop
Seat 3: dimetruk (big blind) showed [9d 9s] and won (459) with a full house, Sixes full of Nines
Seat 4: rabbahiff folded before Flop (didn't bet)
Seat 5: OhSeas folded before Flop (didn't bet)
Seat 6: Wolfffff folded before Flop (didn't bet)
Seat 7: SEREGA196914 mucked [Ac Tc]
Seat 8: dclucasPS folded before Flop (didn't bet)
Seat 9: Matrixxx47 folded before Flop (didn't bet)


PokerStars Hand #228242821515: Tournament #3228838622, $13.70+$1.30 USD Hold'em No Limit - Level I (10/20) - 2021/07/12 21:22:54 MSK [2021/07/12 14:22:54 ET]
Table '3228838622 1' 9-max Seat #2 is the button
Seat 1: ABBYYjunior (1497 in chips)
Seat 2: sas_2016335 (1487 in chips)
Seat 3: dimetruk (1745 in chips)
Seat 4: rabbahiff (1497 in chips)
Seat 5: OhSeas (1497 in chips)
Seat 6: Wolfffff (1497 in chips)
Seat 7: SEREGA196914 (1286 in chips)
Seat 8: dclucasPS (1497 in chips)
Seat 9: Matrixxx47 (1497 in chips)
ABBYYjunior: posts the ante 3
sas_2016335: posts the ante 3
dimetruk: posts the ante 3
rabbahiff: posts the ante 3
OhSeas: posts the ante 3
Wolfffff: posts the ante 3
SEREGA196914: posts the ante 3
dclucasPS: posts the ante 3
Matrixxx47: posts the ante 3
dimetruk: posts small blind 10
rabbahiff: posts big blind 20
*** HOLE CARDS ***
Dealt to dimetruk [Js Qh]
OhSeas: folds
Wolfffff: folds
SEREGA196914: folds
dclucasPS: raises 20 to 40
Matrixxx47: folds
ABBYYjunior: folds
sas_2016335: folds
dimetruk: calls 30
rabbahiff: calls 20
*** FLOP *** [3h Ah 2h]
dimetruk: checks
rabbahiff: bets 74
dclucasPS: folds
dimetruk: folds
Uncalled bet (74) returned to rabbahiff
rabbahiff collected 147 from pot
rabbahiff: doesn't show hand
*** SUMMARY ***
Total pot 147 | Rake 0
Board [3h Ah 2h]
Seat 1: ABBYYjunior folded before Flop (didn't bet)
Seat 2: sas_2016335 (button) folded before Flop (didn't bet)
Seat 3: dimetruk (small blind) folded on the Flop
Seat 4: rabbahiff (big blind) collected (147)
Seat 5: OhSeas folded before Flop (didn't bet)
Seat 6: Wolfffff folded before Flop (didn't bet)
Seat 7: SEREGA196914 folded before Flop (didn't bet)
Seat 8: dclucasPS folded on the Flop
Seat 9: Matrixxx47 folded before Flop (didn't bet)


PokerStars Hand #228243167376: Tournament #3228838622, $13.70+$1.30 USD Hold'em No Limit - Level II (15/30) - 2021/07/12 21:35:37 MSK [2021/07/12 14:35:37 ET]
Table '3228838622 1' 9-max Seat #5 is the button
Seat 1: ABBYYjunior (997 in chips)
Seat 2: sas_2016335 (1435 in chips)
Seat 3: dimetruk (1571 in chips)
Seat 4: rabbahiff (1290 in chips)
Seat 5: OhSeas (3444 in chips)
Seat 7: SEREGA196914 (1238 in chips)
Seat 8: dclucasPS (2124 in chips)
Seat 9: Matrixxx47 (1401 in chips)
ABBYYjunior: posts the ante 4
sas_2016335: posts the ante 4
dimetruk: posts the ante 4
rabbahiff: posts the ante 4
OhSeas: posts the ante 4
SEREGA196914: posts the ante 4
dclucasPS: posts the ante 4
Matrixxx47: posts the ante 4
SEREGA196914: posts small blind 15
dclucasPS: posts big blind 30
*** HOLE CARDS ***
Dealt to dimetruk [6c 6s]
Matrixxx47: folds
ABBYYjunior: raises 30 to 60
sas_2016335: folds
dimetruk: calls 60
rabbahiff: folds
OhSeas: folds
SEREGA196914: folds
dclucasPS: folds
*** FLOP *** [Jc Ks 7h]
ABBYYjunior: bets 69
dimetruk: folds
Uncalled bet (69) returned to ABBYYjunior
ABBYYjunior collected 197 from pot
ABBYYjunior: doesn't show hand
*** SUMMARY ***
Total pot 197 | Rake 0
Board [Jc Ks 7h]
Seat 1: ABBYYjunior collected (197)
Seat 2: sas_2016335 folded before Flop (didn't bet)
Seat 3: dimetruk folded on the Flop
Seat 4: rabbahiff folded before Flop (didn't bet)
Seat 5: OhSeas (button) folded before Flop (didn't bet)
Seat 7: SEREGA196914 (small blind) folded before Flop
Seat 8: dclucasPS (big blind) folded before Flop
Seat 9: Matrixxx47 folded before Flop (didn't bet)


PokerStars Hand #228243191918: Tournament #3228838622, $13.70+$1.30 USD Hold'em No Limit - Level II (15/30) - 2021/07/12 21:36:34 MSK [2021/07/12 14:36:34 ET]
Table '3228838622 1' 9-max Seat #7 is the button
Seat 1: ABBYYjunior (1130 in chips)
Seat 2: sas_2016335 (1431 in chips)
Seat 3: dimetruk (1507 in chips)
Seat 4: rabbahiff (1286 in chips)
Seat 5: OhSeas (3440 in chips)
Seat 7: SEREGA196914 (1219 in chips)
Seat 8: dclucasPS (2090 in chips)
Seat 9: Matrixxx47 (1397 in chips)
ABBYYjunior: posts the ante 4
sas_2016335: posts the ante 4
dimetruk: posts the ante 4
rabbahiff: posts the ante 4
OhSeas: posts the ante 4
SEREGA196914: posts the ante 4
dclucasPS: posts the ante 4
Matrixxx47: posts the ante 4
dclucasPS: posts small blind 15
Matrixxx47: posts big blind 30
*** HOLE CARDS ***
Dealt to dimetruk [2c 2h]
ABBYYjunior: folds
sas_2016335: folds
dimetruk: raises 30 to 60
rabbahiff: folds
OhSeas: calls 60
SEREGA196914: folds
dclucasPS: folds
Matrixxx47: calls 30
*** FLOP *** [9h Qd 2d]
Matrixxx47: checks
dimetruk: bets 114
OhSeas: folds
Matrixxx47: folds
Uncalled bet (114) returned to dimetruk
dimetruk collected 227 from pot
dimetruk: doesn't show hand
*** SUMMARY ***
Total pot 227 | Rake 0
Board [9h Qd 2d]
Seat 1: ABBYYjunior folded before Flop (didn't bet)
Seat 2: sas_2016335 folded before Flop (didn't bet)
Seat 3: dimetruk collected (227)
Seat 4: rabbahiff folded before Flop (didn't bet)
Seat 5: OhSeas folded on the Flop
Seat 7: SEREGA196914 (button) folded before Flop (didn't bet)
Seat 8: dclucasPS (small blind) folded before Flop
Seat 9: Matrixxx47 (big blind) folded on the Flop


PokerStars Hand #228243304742: Tournament #3228838622, $13.70+$1.30 USD Hold'em No Limit - Level II (15/30) - 2021/07/12 21:40:51 MSK [2021/07/12 14:40:51 ET]
Table '3228838622 1' 9-max Seat #3 is the button
Seat 1: ABBYYjunior (1334 in chips)
Seat 2: sas_2016335 (1509 in chips)
Seat 3: dimetruk (1746 in chips)
Seat 4: rabbahiff (1236 in chips)
Seat 5: OhSeas (3360 in chips)
Seat 7: SEREGA196914 (1133 in chips)
Seat 8: dclucasPS (1880 in chips)
Seat 9: Matrixxx47 (1302 in chips)
ABBYYjunior: posts the ante 4
sas_2016335: posts the ante 4
dimetruk: posts the ante 4
rabbahiff: posts the ante 4
OhSeas: posts the ante 4
SEREGA196914: posts the ante 4
dclucasPS: posts the ante 4
Matrixxx47: posts the ante 4
rabbahiff: posts small blind 15
OhSeas: posts big blind 30
*** HOLE CARDS ***
Dealt to dimetruk [8c Kh]
SEREGA196914: folds
dclucasPS: folds
Matrixxx47: folds
ABBYYjunior: folds
sas_2016335: folds
dimetruk: raises 30 to 60
rabbahiff: calls 45
OhSeas: folds
*** FLOP *** [5h 7c Qh]
rabbahiff: checks
dimetruk: bets 64
rabbahiff: folds
Uncalled bet (64) returned to dimetruk
dimetruk collected 182 from pot
*** SUMMARY ***
Total pot 182 | Rake 0
Board [5h 7c Qh]
Seat 1: ABBYYjunior folded before Flop (didn't bet)
Seat 2: sas_2016335 folded before Flop (didn't bet)
Seat 3: dimetruk (button) collected (182)
Seat 4: rabbahiff (small blind) folded on the Flop
Seat 5: OhSeas (big blind) folded before Flop
Seat 7: SEREGA196914 folded before Flop (didn't bet)
Seat 8: dclucasPS folded before Flop (didn't bet)
Seat 9: Matrixxx47 folded before Flop (didn't bet)


PokerStars Hand #228243465943: Tournament #3228838622, $13.70+$1.30 USD Hold'em No Limit - Level III (25/50) - 2021/07/12 21:46:39 MSK [2021/07/12 14:46:39 ET]
Table '3228838622 1' 9-max Seat #1 is the button
Seat 1: ABBYYjunior (1537 in chips)
Seat 2: sas_2016335 (1798 in chips)
Seat 3: dimetruk (1834 in chips)
Seat 4: rabbahiff (1142 in chips)
Seat 5: OhSeas (3078 in chips)
Seat 7: SEREGA196914 (1024 in chips)
Seat 8: dclucasPS (1771 in chips)
Seat 9: Matrixxx47 (1316 in chips)
ABBYYjunior: posts the ante 6
sas_2016335: posts the ante 6
dimetruk: posts the ante 6
rabbahiff: posts the ante 6
OhSeas: posts the ante 6
SEREGA196914: posts the ante 6
dclucasPS: posts the ante 6
Matrixxx47: posts the ante 6
sas_2016335: posts small blind 25
dimetruk: posts big blind 50
*** HOLE CARDS ***
Dealt to dimetruk [Kh 5d]
rabbahiff: folds
OhSeas: calls 50
SEREGA196914: folds
dclucasPS: calls 50
Matrixxx47: folds
ABBYYjunior: folds
sas_2016335: folds
dimetruk: checks
*** FLOP *** [Ts 3c 5c]
dimetruk: checks
OhSeas: checks
dclucasPS: bets 74
dimetruk: calls 74
OhSeas: folds
*** TURN *** [Ts 3c 5c] [6h]
dimetruk: checks
dclucasPS: checks
*** RIVER *** [Ts 3c 5c 6h] [Qc]
dimetruk: bets 250
dclucasPS: folds
Uncalled bet (250) returned to dimetruk
dimetruk collected 371 from pot
dimetruk: doesn't show hand
*** SUMMARY ***
Total pot 371 | Rake 0
Board [Ts 3c 5c 6h Qc]
Seat 1: ABBYYjunior (button) folded before Flop (didn't bet)
Seat 2: sas_2016335 (small blind) folded before Flop
Seat 3: dimetruk (big blind) collected (371)
Seat 4: rabbahiff folded before Flop (didn't bet)
Seat 5: OhSeas folded on the Flop
Seat 7: SEREGA196914 folded before Flop (didn't bet)
Seat 8: dclucasPS folded on the River
Seat 9: Matrixxx47 folded before Flop (didn't bet)


PokerStars Hand #228243516684: Tournament #3228838622, $13.70+$1.30 USD Hold'em No Limit - Level III (25/50) - 2021/07/12 21:48:33 MSK [2021/07/12 14:48:33 ET]
Table '3228838622 1' 9-max Seat #3 is the button
Seat 1: ABBYYjunior (1525 in chips)
Seat 2: sas_2016335 (1761 in chips)
Seat 3: dimetruk (2044 in chips)
Seat 4: rabbahiff (118 in chips)
Seat 5: OhSeas (3016 in chips)
Seat 7: SEREGA196914 (2097 in chips)
Seat 8: dclucasPS (1635 in chips)
Seat 9: Matrixxx47 (1304 in chips)
ABBYYjunior: posts the ante 6
sas_2016335: posts the ante 6
dimetruk: posts the ante 6
rabbahiff: posts the ante 6
OhSeas: posts the ante 6
SEREGA196914: posts the ante 6
dclucasPS: posts the ante 6
Matrixxx47: posts the ante 6
rabbahiff: posts small blind 25
OhSeas: posts big blind 50
*** HOLE CARDS ***
Dealt to dimetruk [Th Ks]
SEREGA196914: folds
dclucasPS: folds
Matrixxx47: folds
ABBYYjunior: folds
sas_2016335: folds
dimetruk: raises 50 to 100
rabbahiff: raises 12 to 112 and is all-in
OhSeas: calls 62
dimetruk: calls 12
*** FLOP *** [5h Ac Qc]
OhSeas: checks
dimetruk: bets 134
OhSeas: calls 134
*** TURN *** [5h Ac Qc] [Js]
OhSeas: checks
dimetruk: bets 375
OhSeas: folds
Uncalled bet (375) returned to dimetruk
*** RIVER *** [5h Ac Qc Js] [6d]
*** SHOW DOWN ***
dimetruk: shows [Th Ks] (a straight, Ten to Ace)
dimetruk collected 268 from side pot
rabbahiff: shows [5d 6c] (two pair, Sixes and Fives)
dimetruk collected 384 from main pot
rabbahiff finished the tournament in 8th place
*** SUMMARY ***
Total pot 652 Main pot 384. Side pot 268. | Rake 0
Board [5h Ac Qc Js 6d]
Seat 1: ABBYYjunior folded before Flop (didn't bet)
Seat 2: sas_2016335 folded before Flop (didn't bet)
Seat 3: dimetruk (button) showed [Th Ks] and won (652) with a straight, Ten to Ace
Seat 4: rabbahiff (small blind) showed [5d 6c] and lost with two pair, Sixes and Fives
Seat 5: OhSeas (big blind) folded on the Turn
Seat 7: SEREGA196914 folded before Flop (didn't bet)
Seat 8: dclucasPS folded before Flop (didn't bet)
Seat 9: Matrixxx47 folded before Flop (didn't bet)


PokerStars Hand #228243612222: Tournament #3228838622, $13.70+$1.30 USD Hold'em No Limit - Level IV (40/80) - 2021/07/12 21:52:08 MSK [2021/07/12 14:52:08 ET]
Table '3228838622 1' 9-max Seat #9 is the button
Seat 1: ABBYYjunior (1417 in chips)
Seat 3: dimetruk (2422 in chips)
Seat 5: OhSeas (2662 in chips)
Seat 7: SEREGA196914 (4021 in chips)
Seat 8: dclucasPS (1792 in chips)
Seat 9: Matrixxx47 (1186 in chips)
ABBYYjunior: posts the ante 10
dimetruk: posts the ante 10
OhSeas: posts the ante 10
SEREGA196914: posts the ante 10
dclucasPS: posts the ante 10
Matrixxx47: posts the ante 10
ABBYYjunior: posts small blind 40
dimetruk: posts big blind 80
*** HOLE CARDS ***
Dealt to dimetruk [Qs Kh]
OhSeas: folds
SEREGA196914: raises 120 to 200
dclucasPS: folds
Matrixxx47: folds
ABBYYjunior: folds
dimetruk: calls 120
*** FLOP *** [8s 2h 6c]
dimetruk: checks
SEREGA196914: checks
*** TURN *** [8s 2h 6c] [4s]
dimetruk: bets 175
SEREGA196914: calls 175
*** RIVER *** [8s 2h 6c 4s] [3d]
dimetruk: bets 578
SEREGA196914: folds
Uncalled bet (578) returned to dimetruk
dimetruk collected 850 from pot
dimetruk: doesn't show hand
*** SUMMARY ***
Total pot 850 | Rake 0
Board [8s 2h 6c 4s 3d]
Seat 1: ABBYYjunior (small blind) folded before Flop
Seat 3: dimetruk (big blind) collected (850)
Seat 5: OhSeas folded before Flop (didn't bet)
Seat 7: SEREGA196914 folded on the River
Seat 8: dclucasPS folded before Flop (didn't bet)
Seat 9: Matrixxx47 (button) folded before Flop (didn't bet)


PokerStars Hand #228243696831: Tournament #3228838622, $13.70+$1.30 USD Hold'em No Limit - Level IV (40/80) - 2021/07/12 21:55:24 MSK [2021/07/12 14:55:24 ET]
Table '3228838622 1' 9-max Seat #9 is the button
Seat 1: ABBYYjunior (1597 in chips)
Seat 3: dimetruk (2977 in chips)
Seat 5: OhSeas (2662 in chips)
Seat 7: SEREGA196914 (3646 in chips)
Seat 8: dclucasPS (1612 in chips)
Seat 9: Matrixxx47 (1006 in chips)
ABBYYjunior: posts the ante 10
dimetruk: posts the ante 10
OhSeas: posts the ante 10
SEREGA196914: posts the ante 10
dclucasPS: posts the ante 10
Matrixxx47: posts the ante 10
ABBYYjunior: posts small blind 40
dimetruk: posts big blind 80
*** HOLE CARDS ***
Dealt to dimetruk [3h Kh]
OhSeas: calls 80
SEREGA196914: folds
dclucasPS: folds
Matrixxx47: folds
ABBYYjunior: calls 40
dimetruk: checks
*** FLOP *** [7c 5c 8d]
ABBYYjunior: checks
dimetruk: checks
OhSeas: bets 300
ABBYYjunior: raises 1207 to 1507 and is all-in
dimetruk: folds
OhSeas: calls 1207
*** TURN *** [7c 5c 8d] [3d]
*** RIVER *** [7c 5c 8d 3d] [Td]
*** SHOW DOWN ***
ABBYYjunior: shows [6c 9c] (a straight, Six to Ten)
OhSeas: shows [8c Ah] (a pair of Eights)
ABBYYjunior collected 3314 from pot
*** SUMMARY ***
Total pot 3314 | Rake 0
Board [7c 5c 8d 3d Td]
Seat 1: ABBYYjunior (small blind) showed [6c 9c] and won (3314) with a straight, Six to Ten
Seat 3: dimetruk (big blind) folded on the Flop
Seat 5: OhSeas showed [8c Ah] and lost with a pair of Eights
Seat 7: SEREGA196914 folded before Flop (didn't bet)
Seat 8: dclucasPS folded before Flop (didn't bet)
Seat 9: Matrixxx47 (button) folded before Flop (didn't bet)


PokerStars Hand #228243788590: Tournament #3228838622, $13.70+$1.30 USD Hold'em No Limit - Level IV (40/80) - 2021/07/12 21:59:55 MSK [2021/07/12 14:59:55 ET]
Table '3228838622 1' 9-max Seat #8 is the button
Seat 1: ABBYYjunior (5337 in chips)
Seat 3: dimetruk (2697 in chips)
Seat 7: SEREGA196914 (3318 in chips)
Seat 8: dclucasPS (2148 in chips)
ABBYYjunior: posts the ante 10
dimetruk: posts the ante 10
SEREGA196914: posts the ante 10
dclucasPS: posts the ante 10
ABBYYjunior: posts small blind 40
dimetruk: posts big blind 80
*** HOLE CARDS ***
Dealt to dimetruk [Jh 8h]
SEREGA196914: folds
dclucasPS: raises 80 to 160
ABBYYjunior: folds
dimetruk: calls 80
*** FLOP *** [Tc 3d 4d]
dimetruk: checks
dclucasPS: bets 132
dimetruk: folds
Uncalled bet (132) returned to dclucasPS
dclucasPS collected 400 from pot
dclucasPS: doesn't show hand
*** SUMMARY ***
Total pot 400 | Rake 0
Board [Tc 3d 4d]
Seat 1: ABBYYjunior (small blind) folded before Flop
Seat 3: dimetruk (big blind) folded on the Flop
Seat 7: SEREGA196914 folded before Flop (didn't bet)
Seat 8: dclucasPS (button) collected (400)


PokerStars Hand #228243855576: Tournament #3228838622, $13.70+$1.30 USD Hold'em No Limit - Level V (60/120) - 2021/07/12 22:02:28 MSK [2021/07/12 15:02:28 ET]
Table '3228838622 1' 9-max Seat #7 is the button
Seat 1: ABBYYjunior (5312 in chips)
Seat 3: dimetruk (2232 in chips)
Seat 7: SEREGA196914 (3573 in chips)
Seat 8: dclucasPS (2383 in chips)
ABBYYjunior: posts the ante 15
dimetruk: posts the ante 15
SEREGA196914: posts the ante 15
dclucasPS: posts the ante 15
dclucasPS: posts small blind 60
ABBYYjunior: posts big blind 120
*** HOLE CARDS ***
Dealt to dimetruk [Ac 4d]
dimetruk: raises 120 to 240
SEREGA196914: folds
dclucasPS: folds
ABBYYjunior: calls 120
*** FLOP *** [Ks 3d 4c]
ABBYYjunior: checks
dimetruk: bets 210
ABBYYjunior: folds
Uncalled bet (210) returned to dimetruk
dimetruk collected 600 from pot
dimetruk: doesn't show hand
*** SUMMARY ***
Total pot 600 | Rake 0
Board [Ks 3d 4c]
Seat 1: ABBYYjunior (big blind) folded on the Flop
Seat 3: dimetruk collected (600)
Seat 7: SEREGA196914 (button) folded before Flop (didn't bet)
Seat 8: dclucasPS (small blind) folded before Flop


PokerStars Hand #228243865567: Tournament #3228838622, $13.70+$1.30 USD Hold'em No Limit - Level V (60/120) - 2021/07/12 22:02:50 MSK [2021/07/12 15:02:50 ET]
Table '3228838622 1' 9-max Seat #8 is the button
Seat 1: ABBYYjunior (5057 in chips)
Seat 3: dimetruk (2577 in chips)
Seat 7: SEREGA196914 (3558 in chips)
Seat 8: dclucasPS (2308 in chips)
ABBYYjunior: posts the ante 15
dimetruk: posts the ante 15
SEREGA196914: posts the ante 15
dclucasPS: posts the ante 15
ABBYYjunior: posts small blind 60
dimetruk: posts big blind 120
*** HOLE CARDS ***
Dealt to dimetruk [Jd Jc]
SEREGA196914: folds
dclucasPS: raises 120 to 240
ABBYYjunior: raises 4802 to 5042 and is all-in
dimetruk: calls 2442 and is all-in
dclucasPS: folds
Uncalled bet (2480) returned to ABBYYjunior
*** FLOP *** [3h 6c Kc]
*** TURN *** [3h 6c Kc] [Ah]
*** RIVER *** [3h 6c Kc Ah] [7h]
*** SHOW DOWN ***
ABBYYjunior: shows [Jh Ks] (a pair of Kings)
dimetruk: shows [Jd Jc] (a pair of Jacks)
ABBYYjunior collected 5424 from pot
dimetruk finished the tournament in 4th place
*** SUMMARY ***
Total pot 5424 | Rake 0
Board [3h 6c Kc Ah 7h]
Seat 1: ABBYYjunior (small blind) showed [Jh Ks] and won (5424) with a pair of Kings
Seat 3: dimetruk (big blind) showed [Jd Jc] and lost with a pair of Jacks
Seat 7: SEREGA196914 folded before Flop (didn't bet)
Seat 8: dclucasPS (button) folded before Flop


PokerStars Hand #228244923598: Tournament #3228886942, $13.70+$1.30 USD Hold'em No Limit - Level I (10/20) - 2021/07/12 22:38:53 MSK [2021/07/12 15:38:53 ET]
Table '3228886942 1' 9-max Seat #2 is the button
Seat 1: h8autumn (1497 in chips)
Seat 2: dimetruk (1487 in chips)
Seat 3: zxraq (1477 in chips)
Seat 4: Matrixxx47 (1526 in chips)
Seat 5: rumred14 (1497 in chips)
Seat 6: thorparinn (1497 in chips)
Seat 7: Pokerstud (1497 in chips)
Seat 8: zzuby (1497 in chips)
Seat 9: JhuannyG (1525 in chips)
h8autumn: posts the ante 3
dimetruk: posts the ante 3
zxraq: posts the ante 3
Matrixxx47: posts the ante 3
rumred14: posts the ante 3
thorparinn: posts the ante 3
Pokerstud: posts the ante 3
zzuby: posts the ante 3
JhuannyG: posts the ante 3
zxraq: posts small blind 10
Matrixxx47: posts big blind 20
*** HOLE CARDS ***
Dealt to dimetruk [Ad Kh]
rumred14: folds
thorparinn: calls 20
Pokerstud: raises 97 to 117
zzuby: folds
JhuannyG: folds
h8autumn: folds
dimetruk: calls 117
zxraq: folds
Matrixxx47: folds
thorparinn: folds
*** FLOP *** [Js Qd 3c]
Pokerstud: bets 93
dimetruk: calls 93
*** TURN *** [Js Qd 3c] [Ks]
Pokerstud: checks
dimetruk: bets 249
Pokerstud: calls 249
*** RIVER *** [Js Qd 3c Ks] [8d]
Pokerstud: checks
dimetruk: checks
*** SHOW DOWN ***
Pokerstud: shows [Kd As] (a pair of Kings)
dimetruk: shows [Ad Kh] (a pair of Kings)
Pokerstud collected 498 from pot
dimetruk collected 497 from pot
*** SUMMARY ***
Total pot 995 | Rake 0
Board [Js Qd 3c Ks 8d]
Seat 1: h8autumn folded before Flop (didn't bet)
Seat 2: dimetruk (button) showed [Ad Kh] and won (497) with a pair of Kings
Seat 3: zxraq (small blind) folded before Flop
Seat 4: Matrixxx47 (big blind) folded before Flop
Seat 5: rumred14 folded before Flop (didn't bet)
Seat 6: thorparinn folded before Flop
Seat 7: Pokerstud showed [Kd As] and won (498) with a pair of Kings
Seat 8: zzuby folded before Flop (didn't bet)
Seat 9: JhuannyG folded before Flop (didn't bet)


PokerStars Hand #228244962328: Tournament #3228886942, $13.70+$1.30 USD Hold'em No Limit - Level I (10/20) - 2021/07/12 22:40:13 MSK [2021/07/12 15:40:13 ET]
Table '3228886942 1' 9-max Seat #3 is the button
Seat 1: h8autumn (1494 in chips)
Seat 2: dimetruk (1522 in chips)
Seat 3: zxraq (1464 in chips)
Seat 4: Matrixxx47 (1503 in chips)
Seat 5: rumred14 (1494 in chips)
Seat 6: thorparinn (1474 in chips)
Seat 7: Pokerstud (1533 in chips)
Seat 8: zzuby (1494 in chips)
Seat 9: JhuannyG (1522 in chips)
h8autumn: posts the ante 3
dimetruk: posts the ante 3
zxraq: posts the ante 3
Matrixxx47: posts the ante 3
rumred14: posts the ante 3
thorparinn: posts the ante 3
Pokerstud: posts the ante 3
zzuby: posts the ante 3
JhuannyG: posts the ante 3
Matrixxx47: posts small blind 10
rumred14: posts big blind 20
*** HOLE CARDS ***
Dealt to dimetruk [9d Td]
thorparinn: folds
Pokerstud: calls 20
zzuby: calls 20
JhuannyG: folds
h8autumn: folds
dimetruk: raises 40 to 60
zxraq: folds
Matrixxx47: folds
rumred14: folds
Pokerstud: calls 40
zzuby: calls 40
*** FLOP *** [9h Jd Jc]
Pokerstud: checks
zzuby: bets 119
dimetruk: calls 119
Pokerstud: folds
*** TURN *** [9h Jd Jc] [Ts]
zzuby: bets 238
dimetruk: folds
Uncalled bet (238) returned to zzuby
zzuby collected 475 from pot
*** SUMMARY ***
Total pot 475 | Rake 0
Board [9h Jd Jc Ts]
Seat 1: h8autumn folded before Flop (didn't bet)
Seat 2: dimetruk folded on the Turn
Seat 3: zxraq (button) folded before Flop (didn't bet)
Seat 4: Matrixxx47 (small blind) folded before Flop
Seat 5: rumred14 (big blind) folded before Flop
Seat 6: thorparinn folded before Flop (didn't bet)
Seat 7: Pokerstud folded on the Flop
Seat 8: zzuby collected (475)
Seat 9: JhuannyG folded before Flop (didn't bet)


PokerStars Hand #228245192546: Tournament #3228886942, $13.70+$1.30 USD Hold'em No Limit - Level II (15/30) - 2021/07/12 22:48:10 MSK [2021/07/12 15:48:10 ET]
Table '3228886942 1' 9-max Seat #9 is the button
Seat 1: h8autumn (1924 in chips)
Seat 2: dimetruk (1323 in chips)
Seat 3: zxraq (1400 in chips)
Seat 4: Matrixxx47 (1642 in chips)
Seat 5: rumred14 (1400 in chips)
Seat 6: thorparinn (1133 in chips)
Seat 7: Pokerstud (1399 in chips)
Seat 8: zzuby (1869 in chips)
Seat 9: JhuannyG (1410 in chips)
h8autumn: posts the ante 4
dimetruk: posts the ante 4
zxraq: posts the ante 4
Matrixxx47: posts the ante 4
rumred14: posts the ante 4
thorparinn: posts the ante 4
Pokerstud: posts the ante 4
zzuby: posts the ante 4
JhuannyG: posts the ante 4
h8autumn: posts small blind 15
dimetruk: posts big blind 30
*** HOLE CARDS ***
Dealt to dimetruk [Qs Kd]
zxraq: folds
Matrixxx47: folds
rumred14: raises 41 to 71
thorparinn: folds
Pokerstud: folds
zzuby: folds
JhuannyG: folds
h8autumn: folds
dimetruk: calls 41
*** FLOP *** [9s Ad 6s]
dimetruk: checks
rumred14: bets 135
dimetruk: folds
Uncalled bet (135) returned to rumred14
rumred14 collected 193 from pot
rumred14: doesn't show hand
*** SUMMARY ***
Total pot 193 | Rake 0
Board [9s Ad 6s]
Seat 1: h8autumn (small blind) folded before Flop
Seat 2: dimetruk (big blind) folded on the Flop
Seat 3: zxraq folded before Flop (didn't bet)
Seat 4: Matrixxx47 folded before Flop (didn't bet)
Seat 5: rumred14 collected (193)
Seat 6: thorparinn folded before Flop (didn't bet)
Seat 7: Pokerstud folded before Flop (didn't bet)
Seat 8: zzuby folded before Flop (didn't bet)
Seat 9: JhuannyG (button) folded before Flop (didn't bet)


PokerStars Hand #228245223146: Tournament #3228886942, $13.70+$1.30 USD Hold'em No Limit - Level II (15/30) - 2021/07/12 22:49:13 MSK [2021/07/12 15:49:13 ET]
Table '3228886942 1' 9-max Seat #1 is the button
Seat 1: h8autumn (1905 in chips)
Seat 2: dimetruk (1248 in chips)
Seat 3: zxraq (1396 in chips)
Seat 4: Matrixxx47 (1638 in chips)
Seat 5: rumred14 (1518 in chips)
Seat 6: thorparinn (1129 in chips)
Seat 7: Pokerstud (1395 in chips)
Seat 8: zzuby (1865 in chips)
Seat 9: JhuannyG (1406 in chips)
h8autumn: posts the ante 4
dimetruk: posts the ante 4
zxraq: posts the ante 4
Matrixxx47: posts the ante 4
rumred14: posts the ante 4
thorparinn: posts the ante 4
Pokerstud: posts the ante 4
zzuby: posts the ante 4
JhuannyG: posts the ante 4
dimetruk: posts small blind 15
zxraq: posts big blind 30
*** HOLE CARDS ***
Dealt to dimetruk [9c Tc]
Matrixxx47: folds
rumred14: raises 41 to 71
thorparinn: folds
Pokerstud: folds
zzuby: calls 71
JhuannyG: folds
h8autumn: calls 71
dimetruk: calls 56
zxraq: folds
*** FLOP *** [5s Qc 8c]
dimetruk: checks
rumred14: bets 245
zzuby: calls 245
h8autumn: folds
dimetruk: folds
*** TURN *** [5s Qc 8c] [Th]
rumred14: bets 1198 and is all-in
zzuby: folds
Uncalled bet (1198) returned to rumred14
rumred14 collected 840 from pot
rumred14: doesn't show hand
*** SUMMARY ***
Total pot 840 | Rake 0
Board [5s Qc 8c Th]
Seat 1: h8autumn (button) folded on the Flop
Seat 2: dimetruk (small blind) folded on the Flop
Seat 3: zxraq (big blind) folded before Flop
Seat 4: Matrixxx47 folded before Flop (didn't bet)
Seat 5: rumred14 collected (840)
Seat 6: thorparinn folded before Flop (didn't bet)
Seat 7: Pokerstud folded before Flop (didn't bet)
Seat 8: zzuby folded on the Turn
Seat 9: JhuannyG folded before Flop (didn't bet)


PokerStars Hand #228245496813: Tournament #3228886942, $13.70+$1.30 USD Hold'em No Limit - Level III (25/50) - 2021/07/12 22:59:41 MSK [2021/07/12 15:59:41 ET]
Table '3228886942 1' 9-max Seat #3 is the button
Seat 1: h8autumn (1884 in chips)
Seat 2: dimetruk (1412 in chips)
Seat 3: zxraq (1341 in chips)
Seat 4: Matrixxx47 (1452 in chips)
Seat 5: rumred14 (1885 in chips)
Seat 6: thorparinn (481 in chips)
Seat 7: Pokerstud (1264 in chips)
Seat 8: zzuby (1961 in chips)
Seat 9: JhuannyG (1820 in chips)
h8autumn: posts the ante 6
dimetruk: posts the ante 6
zxraq: posts the ante 6
Matrixxx47: posts the ante 6
rumred14: posts the ante 6
thorparinn: posts the ante 6
Pokerstud: posts the ante 6
zzuby: posts the ante 6
JhuannyG: posts the ante 6
Matrixxx47: posts small blind 25
rumred14: posts big blind 50
*** HOLE CARDS ***
Dealt to dimetruk [Ah Qd]
thorparinn: folds
Pokerstud: calls 50
zzuby: folds
JhuannyG: raises 130 to 180
h8autumn: folds
dimetruk: raises 1226 to 1406 and is all-in
zxraq: folds
Matrixxx47: folds
rumred14: folds
Pokerstud: folds
JhuannyG: calls 1226
*** FLOP *** [4c 2d 3h]
*** TURN *** [4c 2d 3h] [4s]
*** RIVER *** [4c 2d 3h 4s] [7h]
*** SHOW DOWN ***
JhuannyG: shows [As Kh] (a pair of Fours)
dimetruk: shows [Ah Qd] (a pair of Fours - lower kicker)
JhuannyG collected 2991 from pot
dimetruk finished the tournament in 9th place
*** SUMMARY ***
Total pot 2991 | Rake 0
Board [4c 2d 3h 4s 7h]
Seat 1: h8autumn folded before Flop (didn't bet)
Seat 2: dimetruk showed [Ah Qd] and lost with a pair of Fours
Seat 3: zxraq (button) folded before Flop (didn't bet)
Seat 4: Matrixxx47 (small blind) folded before Flop
Seat 5: rumred14 (big blind) folded before Flop
Seat 6: thorparinn folded before Flop (didn't bet)
Seat 7: Pokerstud folded before Flop
Seat 8: zzuby folded before Flop (didn't bet)
Seat 9: JhuannyG showed [As Kh] and won (2991) with a pair of Fours


PokerStars Hand #228259644516: Tournament #3229239210, $13.70+$1.30 USD Hold'em No Limit - Level I (10/20) - 2021/07/13 15:18:53 MSK [2021/07/13 8:18:53 ET]
Table '3229239210 1' 9-max Seat #7 is the button
Seat 1: dimetruk (1482 in chips)
Seat 2: birita20 (1472 in chips)
Seat 3: AAhobbit (1856 in chips) is sitting out
Seat 4: NamAnJH (1704 in chips)
Seat 5: And_Camargo (1452 in chips)
Seat 6: Damianp12452 (1776 in chips)
Seat 7: Balamyt_82 (1422 in chips)
Seat 9: demon199548 (2336 in chips)
dimetruk: posts the ante 3
birita20: posts the ante 3
AAhobbit: posts the ante 3
NamAnJH: posts the ante 3
And_Camargo: posts the ante 3
Damianp12452: posts the ante 3
Balamyt_82: posts the ante 3
demon199548: posts the ante 3
demon199548: posts small blind 10
dimetruk: posts big blind 20
*** HOLE CARDS ***
Dealt to dimetruk [7d Ad]
birita20: folds
AAhobbit: folds
NamAnJH: folds
And_Camargo: folds
Damianp12452: folds
Balamyt_82: folds
demon199548: calls 10
AAhobbit has returned
dimetruk: checks
*** FLOP *** [Jh 7h 3c]
demon199548: checks
dimetruk: bets 30
demon199548: raises 60 to 90
dimetruk: calls 60
*** TURN *** [Jh 7h 3c] [Kc]
demon199548: checks
dimetruk: checks
*** RIVER *** [Jh 7h 3c Kc] [9d]
demon199548: checks
dimetruk: checks
*** SHOW DOWN ***
demon199548: shows [Jd 4d] (a pair of Jacks)
dimetruk: mucks hand
demon199548 collected 244 from pot
*** SUMMARY ***
Total pot 244 | Rake 0
Board [Jh 7h 3c Kc 9d]
Seat 1: dimetruk (big blind) mucked [7d Ad]
Seat 2: birita20 folded before Flop (didn't bet)
Seat 3: AAhobbit folded before Flop (didn't bet)
Seat 4: NamAnJH folded before Flop (didn't bet)
Seat 5: And_Camargo folded before Flop (didn't bet)
Seat 6: Damianp12452 folded before Flop (didn't bet)
Seat 7: Balamyt_82 (button) folded before Flop (didn't bet)
Seat 9: demon199548 (small blind) showed [Jd 4d] and won (244) with a pair of Jacks


PokerStars Hand #228259739923: Tournament #3229239210, $13.70+$1.30 USD Hold'em No Limit - Level II (15/30) - 2021/07/13 15:24:58 MSK [2021/07/13 8:24:58 ET]
Table '3229239210 1' 9-max Seat #5 is the button
Seat 1: dimetruk (1341 in chips)
Seat 2: birita20 (1317 in chips)
Seat 3: AAhobbit (1892 in chips)
Seat 4: NamAnJH (1821 in chips)
Seat 5: And_Camargo (1356 in chips)
Seat 6: Damianp12452 (1926 in chips)
Seat 7: Balamyt_82 (1401 in chips)
Seat 9: demon199548 (2446 in chips)
dimetruk: posts the ante 4
birita20: posts the ante 4
AAhobbit: posts the ante 4
NamAnJH: posts the ante 4
And_Camargo: posts the ante 4
Damianp12452: posts the ante 4
Balamyt_82: posts the ante 4
demon199548: posts the ante 4
Damianp12452: posts small blind 15
Balamyt_82: posts big blind 30
*** HOLE CARDS ***
Dealt to dimetruk [As 8s]
demon199548: folds
dimetruk: raises 30 to 60
birita20: folds
AAhobbit: calls 60
NamAnJH: folds
And_Camargo: folds
Damianp12452: folds
Balamyt_82: calls 30
*** FLOP *** [Qh Ks Ah]
Balamyt_82: checks
dimetruk: checks
AAhobbit: checks
*** TURN *** [Qh Ks Ah] [Tc]
Balamyt_82: bets 136
dimetruk: calls 136
AAhobbit: folds
*** RIVER *** [Qh Ks Ah Tc] [3h]
Balamyt_82: checks
dimetruk: checks
*** SHOW DOWN ***
Balamyt_82: shows [Ad Jh] (a straight, Ten to Ace)
dimetruk: mucks hand
Balamyt_82 collected 499 from pot
*** SUMMARY ***
Total pot 499 | Rake 0
Board [Qh Ks Ah Tc 3h]
Seat 1: dimetruk mucked [As 8s]
Seat 2: birita20 folded before Flop (didn't bet)
Seat 3: AAhobbit folded on the Turn
Seat 4: NamAnJH folded before Flop (didn't bet)
Seat 5: And_Camargo (button) folded before Flop (didn't bet)
Seat 6: Damianp12452 (small blind) folded before Flop
Seat 7: Balamyt_82 (big blind) showed [Ad Jh] and won (499) with a straight, Ten to Ace
Seat 9: demon199548 folded before Flop (didn't bet)


PokerStars Hand #228259774968: Tournament #3229239210, $13.70+$1.30 USD Hold'em No Limit - Level II (15/30) - 2021/07/13 15:27:14 MSK [2021/07/13 8:27:14 ET]
Table '3229239210 1' 9-max Seat #7 is the button
Seat 1: dimetruk (1137 in chips)
Seat 2: birita20 (1309 in chips)
Seat 3: AAhobbit (1824 in chips)
Seat 4: NamAnJH (2018 in chips)
Seat 5: And_Camargo (1348 in chips)
Seat 6: Damianp12452 (1903 in chips)
Seat 7: Balamyt_82 (1681 in chips)
Seat 9: demon199548 (2280 in chips)
dimetruk: posts the ante 4
birita20: posts the ante 4
AAhobbit: posts the ante 4
NamAnJH: posts the ante 4
And_Camargo: posts the ante 4
Damianp12452: posts the ante 4
Balamyt_82: posts the ante 4
demon199548: posts the ante 4
demon199548: posts small blind 15
dimetruk: posts big blind 30
*** HOLE CARDS ***
Dealt to dimetruk [Qd 4s]
birita20: folds
AAhobbit: raises 36 to 66
NamAnJH: folds
And_Camargo: calls 66
Damianp12452: folds
Balamyt_82: folds
demon199548: folds
dimetruk: calls 36
*** FLOP *** [8h Th 9d]
dimetruk: checks
AAhobbit: checks
And_Camargo: checks
*** TURN *** [8h Th 9d] [4h]
dimetruk: checks
AAhobbit: checks
And_Camargo: bets 162
dimetruk: folds
AAhobbit: folds
Uncalled bet (162) returned to And_Camargo
And_Camargo collected 245 from pot
And_Camargo: doesn't show hand
*** SUMMARY ***
Total pot 245 | Rake 0
Board [8h Th 9d 4h]
Seat 1: dimetruk (big blind) folded on the Turn
Seat 2: birita20 folded before Flop (didn't bet)
Seat 3: AAhobbit folded on the Turn
Seat 4: NamAnJH folded before Flop (didn't bet)
Seat 5: And_Camargo collected (245)
Seat 6: Damianp12452 folded before Flop (didn't bet)
Seat 7: Balamyt_82 (button) folded before Flop (didn't bet)
Seat 9: demon199548 (small blind) folded before Flop


PokerStars Hand #228259813862: Tournament #3229239210, $13.70+$1.30 USD Hold'em No Limit - Level II (15/30) - 2021/07/13 15:29:47 MSK [2021/07/13 8:29:47 ET]
Table '3229239210 1' 9-max Seat #1 is the button
Seat 1: dimetruk (1048 in chips)
Seat 2: birita20 (1235 in chips)
Seat 3: AAhobbit (1750 in chips)
Seat 4: NamAnJH (2010 in chips)
Seat 5: And_Camargo (1453 in chips)
Seat 6: Damianp12452 (1895 in chips)
Seat 7: Balamyt_82 (1673 in chips)
Seat 9: demon199548 (2436 in chips)
dimetruk: posts the ante 4
birita20: posts the ante 4
AAhobbit: posts the ante 4
NamAnJH: posts the ante 4
And_Camargo: posts the ante 4
Damianp12452: posts the ante 4
Balamyt_82: posts the ante 4
demon199548: posts the ante 4
birita20: posts small blind 15
AAhobbit: posts big blind 30
*** HOLE CARDS ***
Dealt to dimetruk [Qc Qh]
NamAnJH: raises 60 to 90
And_Camargo: folds
Damianp12452: folds
Balamyt_82: folds
demon199548: folds
dimetruk: raises 135 to 225
birita20: folds
AAhobbit: folds
NamAnJH: calls 135
*** FLOP *** [9d Ac 4d]
NamAnJH: checks
dimetruk: checks
*** TURN *** [9d Ac 4d] [3h]
NamAnJH: checks
dimetruk: bets 180
NamAnJH: calls 180
*** RIVER *** [9d Ac 4d 3h] [8s]
NamAnJH: checks
dimetruk: checks
*** SHOW DOWN ***
NamAnJH: shows [Ad Kd] (a pair of Aces)
dimetruk: mucks hand
NamAnJH collected 887 from pot
*** SUMMARY ***
Total pot 887 | Rake 0
Board [9d Ac 4d 3h 8s]
Seat 1: dimetruk (button) mucked [Qc Qh]
Seat 2: birita20 (small blind) folded before Flop
Seat 3: AAhobbit (big blind) folded before Flop
Seat 4: NamAnJH showed [Ad Kd] and won (887) with a pair of Aces
Seat 5: And_Camargo folded before Flop (didn't bet)
Seat 6: Damianp12452 folded before Flop (didn't bet)
Seat 7: Balamyt_82 folded before Flop (didn't bet)
Seat 9: demon199548 folded before Flop (didn't bet)


PokerStars Hand #228259853120: Tournament #3229239210, $13.70+$1.30 USD Hold'em No Limit - Level III (25/50) - 2021/07/13 15:32:20 MSK [2021/07/13 8:32:20 ET]
Table '3229239210 1' 9-max Seat #3 is the button
Seat 1: dimetruk (633 in chips)
Seat 2: birita20 (1210 in chips)
Seat 3: AAhobbit (1685 in chips)
Seat 4: NamAnJH (2382 in chips)
Seat 5: And_Camargo (1616 in chips)
Seat 6: Damianp12452 (1885 in chips)
Seat 7: Balamyt_82 (1663 in chips)
Seat 9: demon199548 (2426 in chips)
dimetruk: posts the ante 6
birita20: posts the ante 6
AAhobbit: posts the ante 6
NamAnJH: posts the ante 6
And_Camargo: posts the ante 6
Damianp12452: posts the ante 6
Balamyt_82: posts the ante 6
demon199548: posts the ante 6
NamAnJH: posts small blind 25
And_Camargo: posts big blind 50
*** HOLE CARDS ***
Dealt to dimetruk [Jh Ah]
Damianp12452: folds
Balamyt_82: raises 75 to 125
demon199548: folds
dimetruk: raises 502 to 627 and is all-in
birita20: folds
AAhobbit: folds
NamAnJH: folds
And_Camargo: folds
Balamyt_82: calls 502
*** FLOP *** [Qs 8s 4d]
*** TURN *** [Qs 8s 4d] [Ks]
*** RIVER *** [Qs 8s 4d Ks] [6h]
*** SHOW DOWN ***
Balamyt_82: shows [9d 9s] (a pair of Nines)
dimetruk: shows [Jh Ah] (high card Ace)
Balamyt_82 collected 1377 from pot
dimetruk finished the tournament in 8th place
*** SUMMARY ***
Total pot 1377 | Rake 0
Board [Qs 8s 4d Ks 6h]
Seat 1: dimetruk showed [Jh Ah] and lost with high card Ace
Seat 2: birita20 folded before Flop (didn't bet)
Seat 3: AAhobbit (button) folded before Flop (didn't bet)
Seat 4: NamAnJH (small blind) folded before Flop
Seat 5: And_Camargo (big blind) folded before Flop
Seat 6: Damianp12452 folded before Flop (didn't bet)
Seat 7: Balamyt_82 showed [9d 9s] and won (1377) with a pair of Nines
Seat 9: demon199548 folded before Flop (didn't bet)


PokerStars Hand #228378998965: Tournament #3231914115, $27.40+$2.60 USD Hold'em No Limit - Level I (10/20) - 2021/07/18 14:43:13 MSK [2021/07/18 7:43:13 ET]
Table '3231914115 1' 9-max Seat #1 is the button
Seat 1: gangztastyla (1500 in chips)
Seat 2: jaguardoodlez (1500 in chips)
Seat 3: Mailo2001 (1500 in chips)
Seat 4: Nealio79 (1500 in chips)
Seat 5: dimetruk (1500 in chips)
Seat 6: macky009 (1500 in chips)
Seat 7: WinSomeLose0 (1500 in chips)
Seat 8: JayTom1 (1500 in chips)
Seat 9: JGustavoBR (1500 in chips)
gangztastyla: posts the ante 3
jaguardoodlez: posts the ante 3
Mailo2001: posts the ante 3
Nealio79: posts the ante 3
dimetruk: posts the ante 3
macky009: posts the ante 3
WinSomeLose0: posts the ante 3
JayTom1: posts the ante 3
JGustavoBR: posts the ante 3
jaguardoodlez: posts small blind 10
Mailo2001: posts big blind 20
*** HOLE CARDS ***
Dealt to dimetruk [Ts Kd]
Nealio79: folds
dimetruk: raises 20 to 40
macky009: calls 40
WinSomeLose0: folds
JayTom1: folds
JGustavoBR: folds
gangztastyla: raises 20 to 60
jaguardoodlez: calls 50
Mailo2001: folds
dimetruk: calls 20
macky009: calls 20
*** FLOP *** [7d 4s Qc]
jaguardoodlez: checks
dimetruk: checks
macky009: checks
gangztastyla: bets 100
jaguardoodlez: folds
dimetruk: folds
macky009: folds
Uncalled bet (100) returned to gangztastyla
gangztastyla collected 287 from pot
gangztastyla: doesn't show hand
*** SUMMARY ***
Total pot 287 | Rake 0
Board [7d 4s Qc]
Seat 1: gangztastyla (button) collected (287)
Seat 2: jaguardoodlez (small blind) folded on the Flop
Seat 3: Mailo2001 (big blind) folded before Flop
Seat 4: Nealio79 folded before Flop (didn't bet)
Seat 5: dimetruk folded on the Flop
Seat 6: macky009 folded on the Flop
Seat 7: WinSomeLose0 folded before Flop (didn't bet)
Seat 8: JayTom1 folded before Flop (didn't bet)
Seat 9: JGustavoBR folded before Flop (didn't bet)


PokerStars Hand #228379022471: Tournament #3231914115, $27.40+$2.60 USD Hold'em No Limit - Level I (10/20) - 2021/07/18 14:44:48 MSK [2021/07/18 7:44:48 ET]
Table '3231914115 1' 9-max Seat #3 is the button
Seat 1: gangztastyla (1721 in chips)
Seat 2: jaguardoodlez (1434 in chips)
Seat 3: Mailo2001 (1464 in chips)
Seat 4: Nealio79 (1474 in chips)
Seat 5: dimetruk (1434 in chips)
Seat 6: macky009 (1434 in chips)
Seat 7: WinSomeLose0 (1551 in chips)
Seat 8: JayTom1 (1494 in chips)
Seat 9: JGustavoBR (1494 in chips)
gangztastyla: posts the ante 3
jaguardoodlez: posts the ante 3
Mailo2001: posts the ante 3
Nealio79: posts the ante 3
dimetruk: posts the ante 3
macky009: posts the ante 3
WinSomeLose0: posts the ante 3
JayTom1: posts the ante 3
JGustavoBR: posts the ante 3
Nealio79: posts small blind 10
dimetruk: posts big blind 20
*** HOLE CARDS ***
Dealt to dimetruk [7c 2h]
macky009: calls 20
WinSomeLose0: folds
JayTom1: folds
JGustavoBR: folds
gangztastyla: calls 20
jaguardoodlez: calls 20
Mailo2001: folds
Nealio79: calls 10
dimetruk: checks
*** FLOP *** [3c Qc 6s]
Nealio79: checks
dimetruk: checks
macky009: checks
gangztastyla: checks
jaguardoodlez: checks
*** TURN *** [3c Qc 6s] [6c]
Nealio79: checks
dimetruk: checks
macky009: checks
gangztastyla: bets 100
jaguardoodlez: raises 100 to 200
Nealio79: folds
dimetruk: folds
macky009: folds
gangztastyla: calls 100
*** RIVER *** [3c Qc 6s 6c] [5d]
gangztastyla: bets 235
jaguardoodlez: folds
Uncalled bet (235) returned to gangztastyla
gangztastyla collected 527 from pot
gangztastyla: doesn't show hand
*** SUMMARY ***
Total pot 527 | Rake 0
Board [3c Qc 6s 6c 5d]
Seat 1: gangztastyla collected (527)
Seat 2: jaguardoodlez folded on the River
Seat 3: Mailo2001 (button) folded before Flop (didn't bet)
Seat 4: Nealio79 (small blind) folded on the Turn
Seat 5: dimetruk (big blind) folded on the Turn
Seat 6: macky009 folded on the Turn
Seat 7: WinSomeLose0 folded before Flop (didn't bet)
Seat 8: JayTom1 folded before Flop (didn't bet)
Seat 9: JGustavoBR folded before Flop (didn't bet)


PokerStars Hand #228379063215: Tournament #3231914115, $27.40+$2.60 USD Hold'em No Limit - Level I (10/20) - 2021/07/18 14:47:32 MSK [2021/07/18 7:47:32 ET]
Table '3231914115 1' 9-max Seat #5 is the button
Seat 1: gangztastyla (2022 in chips)
Seat 2: jaguardoodlez (1208 in chips)
Seat 3: Mailo2001 (1615 in chips)
Seat 4: Nealio79 (1388 in chips)
Seat 5: dimetruk (1398 in chips)
Seat 6: macky009 (1348 in chips)
Seat 7: WinSomeLose0 (1545 in chips)
Seat 8: JayTom1 (1488 in chips)
Seat 9: JGustavoBR (1488 in chips)
gangztastyla: posts the ante 3
jaguardoodlez: posts the ante 3
Mailo2001: posts the ante 3
Nealio79: posts the ante 3
dimetruk: posts the ante 3
macky009: posts the ante 3
WinSomeLose0: posts the ante 3
JayTom1: posts the ante 3
JGustavoBR: posts the ante 3
macky009: posts small blind 10
WinSomeLose0: posts big blind 20
*** HOLE CARDS ***
Dealt to dimetruk [Qd Kh]
JayTom1: folds
JGustavoBR: folds
gangztastyla: folds
jaguardoodlez: raises 40 to 60
Mailo2001: folds
Nealio79: folds
dimetruk: raises 90 to 150
macky009: folds
WinSomeLose0: folds
jaguardoodlez: calls 90
*** FLOP *** [As Qc Jh]
jaguardoodlez: bets 30
dimetruk: calls 30
*** TURN *** [As Qc Jh] [4c]
jaguardoodlez: bets 40
dimetruk: calls 40
*** RIVER *** [As Qc Jh 4c] [4d]
jaguardoodlez: bets 40
dimetruk: calls 40
*** SHOW DOWN ***
jaguardoodlez: shows [6d 6s] (two pair, Sixes and Fours)
dimetruk: shows [Qd Kh] (two pair, Queens and Fours)
dimetruk collected 577 from pot
*** SUMMARY ***
Total pot 577 | Rake 0
Board [As Qc Jh 4c 4d]
Seat 1: gangztastyla folded before Flop (didn't bet)
Seat 2: jaguardoodlez showed [6d 6s] and lost with two pair, Sixes and Fours
Seat 3: Mailo2001 folded before Flop (didn't bet)
Seat 4: Nealio79 folded before Flop (didn't bet)
Seat 5: dimetruk (button) showed [Qd Kh] and won (577) with two pair, Queens and Fours
Seat 6: macky009 (small blind) folded before Flop
Seat 7: WinSomeLose0 (big blind) folded before Flop
Seat 8: JayTom1 folded before Flop (didn't bet)
Seat 9: JGustavoBR folded before Flop (didn't bet)


PokerStars Hand #228379075361: Tournament #3231914115, $27.40+$2.60 USD Hold'em No Limit - Level I (10/20) - 2021/07/18 14:48:20 MSK [2021/07/18 7:48:20 ET]
Table '3231914115 1' 9-max Seat #6 is the button
Seat 1: gangztastyla (2019 in chips)
Seat 2: jaguardoodlez (945 in chips)
Seat 3: Mailo2001 (1612 in chips)
Seat 4: Nealio79 (1385 in chips)
Seat 5: dimetruk (1712 in chips)
Seat 6: macky009 (1335 in chips)
Seat 7: WinSomeLose0 (1522 in chips)
Seat 8: JayTom1 (1485 in chips)
Seat 9: JGustavoBR (1485 in chips)
gangztastyla: posts the ante 3
jaguardoodlez: posts the ante 3
Mailo2001: posts the ante 3
Nealio79: posts the ante 3
dimetruk: posts the ante 3
macky009: posts the ante 3
WinSomeLose0: posts the ante 3
JayTom1: posts the ante 3
JGustavoBR: posts the ante 3
WinSomeLose0: posts small blind 10
JayTom1: posts big blind 20
*** HOLE CARDS ***
Dealt to dimetruk [7h Th]
JGustavoBR: folds
gangztastyla: folds
jaguardoodlez: folds
Mailo2001: raises 30 to 50
Nealio79: folds
dimetruk: calls 50
macky009: folds
WinSomeLose0: calls 40
JayTom1: folds
*** FLOP *** [Qh Jd Js]
WinSomeLose0: checks
Mailo2001: bets 104
dimetruk: folds
WinSomeLose0: folds
Uncalled bet (104) returned to Mailo2001
Mailo2001 collected 197 from pot
Mailo2001: doesn't show hand
*** SUMMARY ***
Total pot 197 | Rake 0
Board [Qh Jd Js]
Seat 1: gangztastyla folded before Flop (didn't bet)
Seat 2: jaguardoodlez folded before Flop (didn't bet)
Seat 3: Mailo2001 collected (197)
Seat 4: Nealio79 folded before Flop (didn't bet)
Seat 5: dimetruk folded on the Flop
Seat 6: macky009 (button) folded before Flop (didn't bet)
Seat 7: WinSomeLose0 (small blind) folded on the Flop
Seat 8: JayTom1 (big blind) folded before Flop
Seat 9: JGustavoBR folded before Flop (didn't bet)


PokerStars Hand #228379122873: Tournament #3231914115, $27.40+$2.60 USD Hold'em No Limit - Level I (10/20) - 2021/07/18 14:51:27 MSK [2021/07/18 7:51:27 ET]
Table '3231914115 1' 9-max Seat #1 is the button
Seat 1: gangztastyla (1847 in chips)
Seat 2: jaguardoodlez (1280 in chips)
Seat 3: Mailo2001 (1747 in chips)
Seat 4: Nealio79 (1373 in chips)
Seat 5: dimetruk (1650 in chips)
Seat 6: macky009 (1230 in chips)
Seat 7: WinSomeLose0 (1700 in chips)
Seat 8: JayTom1 (1370 in chips)
Seat 9: JGustavoBR (1303 in chips)
gangztastyla: posts the ante 3
jaguardoodlez: posts the ante 3
Mailo2001: posts the ante 3
Nealio79: posts the ante 3
dimetruk: posts the ante 3
macky009: posts the ante 3
WinSomeLose0: posts the ante 3
JayTom1: posts the ante 3
JGustavoBR: posts the ante 3
jaguardoodlez: posts small blind 10
Mailo2001: posts big blind 20
*** HOLE CARDS ***
Dealt to dimetruk [8d 7d]
Nealio79: folds
dimetruk: raises 20 to 40
macky009: folds
WinSomeLose0: folds
JayTom1: folds
JGustavoBR: folds
gangztastyla: raises 60 to 100
jaguardoodlez: folds
Mailo2001: folds
dimetruk: calls 60
*** FLOP *** [4h Jc Jh]
dimetruk: checks
gangztastyla: bets 180
dimetruk: folds
Uncalled bet (180) returned to gangztastyla
gangztastyla collected 257 from pot
gangztastyla: doesn't show hand
*** SUMMARY ***
Total pot 257 | Rake 0
Board [4h Jc Jh]
Seat 1: gangztastyla (button) collected (257)
Seat 2: jaguardoodlez (small blind) folded before Flop
Seat 3: Mailo2001 (big blind) folded before Flop
Seat 4: Nealio79 folded before Flop (didn't bet)
Seat 5: dimetruk folded on the Flop
Seat 6: macky009 folded before Flop (didn't bet)
Seat 7: WinSomeLose0 folded before Flop (didn't bet)
Seat 8: JayTom1 folded before Flop (didn't bet)
Seat 9: JGustavoBR folded before Flop (didn't bet)


PokerStars Hand #228379162575: Tournament #3231914115, $27.40+$2.60 USD Hold'em No Limit - Level I (10/20) - 2021/07/18 14:53:06 MSK [2021/07/18 7:53:06 ET]
Table '3231914115 1' 9-max Seat #3 is the button
Seat 1: gangztastyla (1998 in chips)
Seat 2: jaguardoodlez (1321 in chips)
Seat 3: Mailo2001 (1711 in chips)
Seat 4: Nealio79 (1347 in chips)
Seat 5: dimetruk (1544 in chips)
Seat 6: macky009 (1224 in chips)
Seat 7: WinSomeLose0 (1694 in chips)
Seat 8: JayTom1 (1364 in chips)
Seat 9: JGustavoBR (1297 in chips)
gangztastyla: posts the ante 3
jaguardoodlez: posts the ante 3
Mailo2001: posts the ante 3
Nealio79: posts the ante 3
dimetruk: posts the ante 3
macky009: posts the ante 3
WinSomeLose0: posts the ante 3
JayTom1: posts the ante 3
JGustavoBR: posts the ante 3
Nealio79: posts small blind 10
dimetruk: posts big blind 20
*** HOLE CARDS ***
Dealt to dimetruk [Ac 5h]
macky009: folds
WinSomeLose0: folds
JayTom1: folds
JGustavoBR: folds
gangztastyla: folds
jaguardoodlez: folds
Mailo2001: raises 30 to 50
Nealio79: calls 40
dimetruk: calls 30
*** FLOP *** [Td 8s Js]
Nealio79: checks
dimetruk: checks
Mailo2001: checks
*** TURN *** [Td 8s Js] [6d]
Nealio79: checks
dimetruk: bets 89
Mailo2001: folds
Nealio79: folds
Uncalled bet (89) returned to dimetruk
dimetruk collected 177 from pot
dimetruk: doesn't show hand
*** SUMMARY ***
Total pot 177 | Rake 0
Board [Td 8s Js 6d]
Seat 1: gangztastyla folded before Flop (didn't bet)
Seat 2: jaguardoodlez folded before Flop (didn't bet)
Seat 3: Mailo2001 (button) folded on the Turn
Seat 4: Nealio79 (small blind) folded on the Turn
Seat 5: dimetruk (big blind) collected (177)
Seat 6: macky009 folded before Flop (didn't bet)
Seat 7: WinSomeLose0 folded before Flop (didn't bet)
Seat 8: JayTom1 folded before Flop (didn't bet)
Seat 9: JGustavoBR folded before Flop (didn't bet)


PokerStars Hand #228379178580: Tournament #3231914115, $27.40+$2.60 USD Hold'em No Limit - Level II (15/30) - 2021/07/18 14:54:10 MSK [2021/07/18 7:54:10 ET]
Table '3231914115 1' 9-max Seat #4 is the button
Seat 1: gangztastyla (1995 in chips)
Seat 2: jaguardoodlez (1318 in chips)
Seat 3: Mailo2001 (1658 in chips)
Seat 4: Nealio79 (1294 in chips)
Seat 5: dimetruk (1668 in chips)
Seat 6: macky009 (1221 in chips)
Seat 7: WinSomeLose0 (1691 in chips)
Seat 8: JayTom1 (1361 in chips)
Seat 9: JGustavoBR (1294 in chips)
gangztastyla: posts the ante 4
jaguardoodlez: posts the ante 4
Mailo2001: posts the ante 4
Nealio79: posts the ante 4
dimetruk: posts the ante 4
macky009: posts the ante 4
WinSomeLose0: posts the ante 4
JayTom1: posts the ante 4
JGustavoBR: posts the ante 4
dimetruk: posts small blind 15
macky009: posts big blind 30
*** HOLE CARDS ***
Dealt to dimetruk [Ad Qd]
WinSomeLose0: folds
JayTom1: folds
JGustavoBR: folds
gangztastyla: folds
jaguardoodlez: raises 30 to 60
Mailo2001: folds
Nealio79: folds
dimetruk: raises 90 to 150
macky009: folds
jaguardoodlez: calls 90
*** FLOP *** [5d 7h As]
dimetruk: checks
jaguardoodlez: bets 105
dimetruk: raises 1409 to 1514 and is all-in
jaguardoodlez: calls 1059 and is all-in
Uncalled bet (350) returned to dimetruk
*** TURN *** [5d 7h As] [5s]
*** RIVER *** [5d 7h As 5s] [8d]
*** SHOW DOWN ***
dimetruk: shows [Ad Qd] (two pair, Aces and Fives)
jaguardoodlez: shows [6c 6s] (two pair, Sixes and Fives)
dimetruk collected 2694 from pot
jaguardoodlez finished the tournament in 9th place
*** SUMMARY ***
Total pot 2694 | Rake 0
Board [5d 7h As 5s 8d]
Seat 1: gangztastyla folded before Flop (didn't bet)
Seat 2: jaguardoodlez showed [6c 6s] and lost with two pair, Sixes and Fives
Seat 3: Mailo2001 folded before Flop (didn't bet)
Seat 4: Nealio79 (button) folded before Flop (didn't bet)
Seat 5: dimetruk (small blind) showed [Ad Qd] and won (2694) with two pair, Aces and Fives
Seat 6: macky009 (big blind) folded before Flop
Seat 7: WinSomeLose0 folded before Flop (didn't bet)
Seat 8: JayTom1 folded before Flop (didn't bet)
Seat 9: JGustavoBR folded before Flop (didn't bet)


PokerStars Hand #228379193524: Tournament #3231914115, $27.40+$2.60 USD Hold'em No Limit - Level II (15/30) - 2021/07/18 14:55:10 MSK [2021/07/18 7:55:10 ET]
Table '3231914115 1' 9-max Seat #5 is the button
Seat 1: gangztastyla (1991 in chips)
Seat 3: Mailo2001 (1654 in chips)
Seat 4: Nealio79 (1290 in chips)
Seat 5: dimetruk (3044 in chips)
Seat 6: macky009 (1187 in chips)
Seat 7: WinSomeLose0 (1687 in chips)
Seat 8: JayTom1 (1357 in chips)
Seat 9: JGustavoBR (1290 in chips)
gangztastyla: posts the ante 4
Mailo2001: posts the ante 4
Nealio79: posts the ante 4
dimetruk: posts the ante 4
macky009: posts the ante 4
WinSomeLose0: posts the ante 4
JayTom1: posts the ante 4
JGustavoBR: posts the ante 4
macky009: posts small blind 15
WinSomeLose0: posts big blind 30
*** HOLE CARDS ***
Dealt to dimetruk [9s Jc]
JayTom1: folds
JGustavoBR: folds
gangztastyla: folds
Mailo2001: folds
Nealio79: folds
dimetruk: raises 30 to 60
macky009: calls 45
WinSomeLose0: folds
*** FLOP *** [Ts 5d 4s]
macky009: checks
dimetruk: checks
*** TURN *** [Ts 5d 4s] [Ks]
macky009: bets 91
dimetruk: calls 91
*** RIVER *** [Ts 5d 4s Ks] [6c]
macky009: bets 182
dimetruk: folds
Uncalled bet (182) returned to macky009
macky009 collected 364 from pot
macky009: doesn't show hand
*** SUMMARY ***
Total pot 364 | Rake 0
Board [Ts 5d 4s Ks 6c]
Seat 1: gangztastyla folded before Flop (didn't bet)
Seat 3: Mailo2001 folded before Flop (didn't bet)
Seat 4: Nealio79 folded before Flop (didn't bet)
Seat 5: dimetruk (button) folded on the River
Seat 6: macky009 (small blind) collected (364)
Seat 7: WinSomeLose0 (big blind) folded before Flop
Seat 8: JayTom1 folded before Flop (didn't bet)
Seat 9: JGustavoBR folded before Flop (didn't bet)


PokerStars Hand #228379252492: Tournament #3231914115, $27.40+$2.60 USD Hold'em No Limit - Level II (15/30) - 2021/07/18 14:59:52 MSK [2021/07/18 7:59:52 ET]
Table '3231914115 1' 9-max Seat #1 is the button
Seat 1: gangztastyla (2695 in chips)
Seat 3: Mailo2001 (1604 in chips)
Seat 4: Nealio79 (1407 in chips)
Seat 5: dimetruk (2873 in chips)
Seat 6: macky009 (845 in chips)
Seat 7: WinSomeLose0 (1622 in chips)
Seat 8: JayTom1 (1369 in chips)
Seat 9: JGustavoBR (1085 in chips)
gangztastyla: posts the ante 4
Mailo2001: posts the ante 4
Nealio79: posts the ante 4
dimetruk: posts the ante 4
macky009: posts the ante 4
WinSomeLose0: posts the ante 4
JayTom1: posts the ante 4
JGustavoBR: posts the ante 4
Mailo2001: posts small blind 15
Nealio79: posts big blind 30
*** HOLE CARDS ***
Dealt to dimetruk [8d Ah]
dimetruk: raises 30 to 60
macky009: folds
WinSomeLose0: calls 60
JayTom1: folds
JGustavoBR: folds
gangztastyla: calls 60
Mailo2001: folds
Nealio79: folds
*** FLOP *** [Qs 5d 5s]
dimetruk: checks
WinSomeLose0: checks
gangztastyla: bets 120
dimetruk: folds
WinSomeLose0: calls 120
*** TURN *** [Qs 5d 5s] [9h]
WinSomeLose0: checks
gangztastyla: bets 100
WinSomeLose0: calls 100
*** RIVER *** [Qs 5d 5s 9h] [7h]
WinSomeLose0: checks
gangztastyla: bets 1338
WinSomeLose0: calls 1338 and is all-in
*** SHOW DOWN ***
gangztastyla: shows [4s 6s] (a pair of Fives)
WinSomeLose0: shows [Qd Kh] (two pair, Queens and Fives)
WinSomeLose0 collected 3373 from pot
*** SUMMARY ***
Total pot 3373 | Rake 0
Board [Qs 5d 5s 9h 7h]
Seat 1: gangztastyla (button) showed [4s 6s] and lost with a pair of Fives
Seat 3: Mailo2001 (small blind) folded before Flop
Seat 4: Nealio79 (big blind) folded before Flop
Seat 5: dimetruk folded on the Flop
Seat 6: macky009 folded before Flop (didn't bet)
Seat 7: WinSomeLose0 showed [Qd Kh] and won (3373) with two pair, Queens and Fives
Seat 8: JayTom1 folded before Flop (didn't bet)
Seat 9: JGustavoBR folded before Flop (didn't bet)


PokerStars Hand #228379294220: Tournament #3231914115, $27.40+$2.60 USD Hold'em No Limit - Level II (15/30) - 2021/07/18 15:02:45 MSK [2021/07/18 8:02:45 ET]
Table '3231914115 1' 9-max Seat #5 is the button
Seat 1: gangztastyla (2361 in chips)
Seat 3: Mailo2001 (1577 in chips)
Seat 4: Nealio79 (1350 in chips)
Seat 5: dimetruk (2756 in chips)
Seat 6: macky009 (803 in chips)
Seat 7: WinSomeLose0 (2223 in chips)
Seat 8: JayTom1 (1357 in chips)
Seat 9: JGustavoBR (1073 in chips)
gangztastyla: posts the ante 4
Mailo2001: posts the ante 4
Nealio79: posts the ante 4
dimetruk: posts the ante 4
macky009: posts the ante 4
WinSomeLose0: posts the ante 4
JayTom1: posts the ante 4
JGustavoBR: posts the ante 4
macky009: posts small blind 15
WinSomeLose0: posts big blind 30
*** HOLE CARDS ***
Dealt to dimetruk [Td Qh]
JayTom1: folds
JGustavoBR: folds
gangztastyla: folds
Mailo2001: raises 45 to 75
Nealio79: folds
dimetruk: calls 75
macky009: calls 60
WinSomeLose0: folds
*** FLOP *** [6c Ad 5h]
macky009: checks
Mailo2001: bets 123
dimetruk: folds
macky009: folds
Uncalled bet (123) returned to Mailo2001
Mailo2001 collected 287 from pot
Mailo2001: doesn't show hand
*** SUMMARY ***
Total pot 287 | Rake 0
Board [6c Ad 5h]
Seat 1: gangztastyla folded before Flop (didn't bet)
Seat 3: Mailo2001 collected (287)
Seat 4: Nealio79 folded before Flop (didn't bet)
Seat 5: dimetruk (button) folded on the Flop
Seat 6: macky009 (small blind) folded on the Flop
Seat 7: WinSomeLose0 (big blind) folded before Flop
Seat 8: JayTom1 folded before Flop (didn't bet)
Seat 9: JGustavoBR folded before Flop (didn't bet)


PokerStars Hand #228379363215: Tournament #3231914115, $27.40+$2.60 USD Hold'em No Limit - Level III (25/50) - 2021/07/18 15:07:14 MSK [2021/07/18 8:07:14 ET]
Table '3231914115 1' 9-max Seat #3 is the button
Seat 1: gangztastyla (1971 in chips)
Seat 3: Mailo2001 (2426 in chips)
Seat 4: Nealio79 (1196 in chips)
Seat 5: dimetruk (2770 in chips)
Seat 6: macky009 (694 in chips)
Seat 7: WinSomeLose0 (2481 in chips)
Seat 8: JayTom1 (998 in chips)
Seat 9: JGustavoBR (964 in chips)
gangztastyla: posts the ante 6
Mailo2001: posts the ante 6
Nealio79: posts the ante 6
dimetruk: posts the ante 6
macky009: posts the ante 6
WinSomeLose0: posts the ante 6
JayTom1: posts the ante 6
JGustavoBR: posts the ante 6
Nealio79: posts small blind 25
dimetruk: posts big blind 50
*** HOLE CARDS ***
Dealt to dimetruk [Th 9c]
macky009: folds
WinSomeLose0: folds
JayTom1: folds
JGustavoBR: raises 50 to 100
gangztastyla: folds
Mailo2001: folds
Nealio79: folds
dimetruk: calls 50
*** FLOP *** [2c Ac 9s]
dimetruk: checks
JGustavoBR: bets 90
dimetruk: calls 90
*** TURN *** [2c Ac 9s] [Kc]
dimetruk: checks
JGustavoBR: checks
*** RIVER *** [2c Ac 9s Kc] [Jc]
dimetruk: checks
JGustavoBR: checks
*** SHOW DOWN ***
dimetruk: shows [Th 9c] (a flush, Ace high)
JGustavoBR: mucks hand
dimetruk collected 453 from pot
*** SUMMARY ***
Total pot 453 | Rake 0
Board [2c Ac 9s Kc Jc]
Seat 1: gangztastyla folded before Flop (didn't bet)
Seat 3: Mailo2001 (button) folded before Flop (didn't bet)
Seat 4: Nealio79 (small blind) folded before Flop
Seat 5: dimetruk (big blind) showed [Th 9c] and won (453) with a flush, Ace high
Seat 6: macky009 folded before Flop (didn't bet)
Seat 7: WinSomeLose0 folded before Flop (didn't bet)
Seat 8: JayTom1 folded before Flop (didn't bet)
Seat 9: JGustavoBR mucked [Td Ts]


PokerStars Hand #228379443199: Tournament #3231914115, $27.40+$2.60 USD Hold'em No Limit - Level III (25/50) - 2021/07/18 15:12:21 MSK [2021/07/18 8:12:21 ET]
Table '3231914115 1' 9-max Seat #3 is the button
Seat 1: gangztastyla (1961 in chips)
Seat 3: Mailo2001 (2847 in chips)
Seat 4: Nealio79 (923 in chips)
Seat 5: dimetruk (2760 in chips)
Seat 6: macky009 (571 in chips)
Seat 7: WinSomeLose0 (1491 in chips)
Seat 8: JayTom1 (875 in chips)
Seat 9: JGustavoBR (2072 in chips)
gangztastyla: posts the ante 6
Mailo2001: posts the ante 6
Nealio79: posts the ante 6
dimetruk: posts the ante 6
macky009: posts the ante 6
WinSomeLose0: posts the ante 6
JayTom1: posts the ante 6
JGustavoBR: posts the ante 6
Nealio79: posts small blind 25
dimetruk: posts big blind 50
*** HOLE CARDS ***
Dealt to dimetruk [4d 4s]
macky009: folds
WinSomeLose0: folds
JayTom1: folds
JGustavoBR: raises 50 to 100
gangztastyla: folds
Mailo2001: folds
Nealio79: calls 75
dimetruk: calls 50
*** FLOP *** [2d 4c 7s]
Nealio79: checks
dimetruk: checks
JGustavoBR: bets 162
Nealio79: folds
dimetruk: raises 238 to 400
JGustavoBR: folds
Uncalled bet (238) returned to dimetruk
dimetruk collected 672 from pot
dimetruk: doesn't show hand
*** SUMMARY ***
Total pot 672 | Rake 0
Board [2d 4c 7s]
Seat 1: gangztastyla folded before Flop (didn't bet)
Seat 3: Mailo2001 (button) folded before Flop (didn't bet)
Seat 4: Nealio79 (small blind) folded on the Flop
Seat 5: dimetruk (big blind) collected (672)
Seat 6: macky009 folded before Flop (didn't bet)
Seat 7: WinSomeLose0 folded before Flop (didn't bet)
Seat 8: JayTom1 folded before Flop (didn't bet)
Seat 9: JGustavoBR folded on the Flop


PokerStars Hand #228379481124: Tournament #3231914115, $27.40+$2.60 USD Hold'em No Limit - Level IV (40/80) - 2021/07/18 15:14:44 MSK [2021/07/18 8:14:44 ET]
Table '3231914115 1' 9-max Seat #6 is the button
Seat 1: gangztastyla (2415 in chips)
Seat 3: Mailo2001 (2641 in chips)
Seat 4: Nealio79 (797 in chips)
Seat 5: dimetruk (3104 in chips)
Seat 6: macky009 (425 in chips)
Seat 7: WinSomeLose0 (1485 in chips)
Seat 8: JayTom1 (849 in chips)
Seat 9: JGustavoBR (1784 in chips)
gangztastyla: posts the ante 10
Mailo2001: posts the ante 10
Nealio79: posts the ante 10
dimetruk: posts the ante 10
macky009: posts the ante 10
WinSomeLose0: posts the ante 10
JayTom1: posts the ante 10
JGustavoBR: posts the ante 10
WinSomeLose0: posts small blind 40
JayTom1: posts big blind 80
*** HOLE CARDS ***
Dealt to dimetruk [3c 3h]
JGustavoBR: raises 80 to 160
gangztastyla: calls 160
Mailo2001: folds
Nealio79: folds
dimetruk: calls 160
macky009: folds
WinSomeLose0: folds
JayTom1: calls 80
*** FLOP *** [Kc 9s 8s]
JayTom1: checks
JGustavoBR: bets 392
gangztastyla: folds
dimetruk: folds
JayTom1: folds
Uncalled bet (392) returned to JGustavoBR
JGustavoBR collected 760 from pot
*** SUMMARY ***
Total pot 760 | Rake 0
Board [Kc 9s 8s]
Seat 1: gangztastyla folded on the Flop
Seat 3: Mailo2001 folded before Flop (didn't bet)
Seat 4: Nealio79 folded before Flop (didn't bet)
Seat 5: dimetruk folded on the Flop
Seat 6: macky009 (button) folded before Flop (didn't bet)
Seat 7: WinSomeLose0 (small blind) folded before Flop
Seat 8: JayTom1 (big blind) folded on the Flop
Seat 9: JGustavoBR collected (760)


PokerStars Hand #228379508836: Tournament #3231914115, $27.40+$2.60 USD Hold'em No Limit - Level IV (40/80) - 2021/07/18 15:16:28 MSK [2021/07/18 8:16:28 ET]
Table '3231914115 1' 9-max Seat #1 is the button
Seat 1: gangztastyla (3014 in chips)
Seat 3: Mailo2001 (2531 in chips)
Seat 4: Nealio79 (767 in chips)
Seat 5: dimetruk (3104 in chips)
Seat 6: macky009 (395 in chips)
Seat 7: WinSomeLose0 (1415 in chips)
Seat 9: JGustavoBR (2274 in chips)
gangztastyla: posts the ante 10
Mailo2001: posts the ante 10
Nealio79: posts the ante 10
dimetruk: posts the ante 10
macky009: posts the ante 10
WinSomeLose0: posts the ante 10
JGustavoBR: posts the ante 10
Mailo2001: posts small blind 40
Nealio79: posts big blind 80
*** HOLE CARDS ***
Dealt to dimetruk [Qs Jc]
dimetruk: raises 80 to 160
macky009: folds
WinSomeLose0: folds
JGustavoBR: folds
gangztastyla: folds
Mailo2001: calls 120
Nealio79: folds
*** FLOP *** [7h 5c 4d]
Mailo2001: checks
dimetruk: checks
*** TURN *** [7h 5c 4d] [9s]
Mailo2001: bets 348
dimetruk: folds
Uncalled bet (348) returned to Mailo2001
Mailo2001 collected 470 from pot
Mailo2001: doesn't show hand
*** SUMMARY ***
Total pot 470 | Rake 0
Board [7h 5c 4d 9s]
Seat 1: gangztastyla (button) folded before Flop (didn't bet)
Seat 3: Mailo2001 (small blind) collected (470)
Seat 4: Nealio79 (big blind) folded before Flop
Seat 5: dimetruk folded on the Turn
Seat 6: macky009 folded before Flop (didn't bet)
Seat 7: WinSomeLose0 folded before Flop (didn't bet)
Seat 9: JGustavoBR folded before Flop (didn't bet)


PokerStars Hand #228379520195: Tournament #3231914115, $27.40+$2.60 USD Hold'em No Limit - Level IV (40/80) - 2021/07/18 15:17:11 MSK [2021/07/18 8:17:11 ET]
Table '3231914115 1' 9-max Seat #3 is the button
Seat 1: gangztastyla (3004 in chips)
Seat 3: Mailo2001 (2831 in chips)
Seat 4: Nealio79 (677 in chips)
Seat 5: dimetruk (2934 in chips)
Seat 6: macky009 (385 in chips)
Seat 7: WinSomeLose0 (1405 in chips)
Seat 9: JGustavoBR (2264 in chips)
gangztastyla: posts the ante 10
Mailo2001: posts the ante 10
Nealio79: posts the ante 10
dimetruk: posts the ante 10
macky009: posts the ante 10
WinSomeLose0: posts the ante 10
JGustavoBR: posts the ante 10
Nealio79: posts small blind 40
dimetruk: posts big blind 80
*** HOLE CARDS ***
Dealt to dimetruk [As Ah]
macky009: folds
WinSomeLose0: folds
JGustavoBR: folds
gangztastyla: calls 80
Mailo2001: raises 240 to 320
Nealio79: folds
dimetruk: raises 360 to 680
gangztastyla: folds
Mailo2001: calls 360
*** FLOP *** [Jd Jc Ac]
dimetruk: checks
Mailo2001: checks
*** TURN *** [Jd Jc Ac] [5h]
dimetruk: checks
Mailo2001: bets 496
dimetruk: calls 496
*** RIVER *** [Jd Jc Ac 5h] [2c]
dimetruk: bets 1748 and is all-in
Mailo2001: calls 1645 and is all-in
Uncalled bet (103) returned to dimetruk
*** SHOW DOWN ***
dimetruk: shows [As Ah] (a full house, Aces full of Jacks)
Mailo2001: shows [Ad Jh] (a full house, Jacks full of Aces)
dimetruk collected 5832 from pot
Mailo2001 finished the tournament in 7th place
*** SUMMARY ***
Total pot 5832 | Rake 0
Board [Jd Jc Ac 5h 2c]
Seat 1: gangztastyla folded before Flop
Seat 3: Mailo2001 (button) showed [Ad Jh] and lost with a full house, Jacks full of Aces
Seat 4: Nealio79 (small blind) folded before Flop
Seat 5: dimetruk (big blind) showed [As Ah] and won (5832) with a full house, Aces full of Jacks
Seat 6: macky009 folded before Flop (didn't bet)
Seat 7: WinSomeLose0 folded before Flop (didn't bet)
Seat 9: JGustavoBR folded before Flop (didn't bet)


PokerStars Hand #228379651455: Tournament #3231914115, $27.40+$2.60 USD Hold'em No Limit - Level V (60/120) - 2021/07/18 15:25:14 MSK [2021/07/18 8:25:14 ET]
Table '3231914115 1' 9-max Seat #5 is the button
Seat 1: gangztastyla (3366 in chips)
Seat 5: dimetruk (6905 in chips)
Seat 7: WinSomeLose0 (1555 in chips)
Seat 9: JGustavoBR (1674 in chips)
gangztastyla: posts the ante 15
dimetruk: posts the ante 15
WinSomeLose0: posts the ante 15
JGustavoBR: posts the ante 15
WinSomeLose0: posts small blind 60
JGustavoBR: posts big blind 120
*** HOLE CARDS ***
Dealt to dimetruk [3h Th]
gangztastyla: folds
dimetruk: raises 120 to 240
WinSomeLose0: folds
JGustavoBR: calls 120
*** FLOP *** [8h As 9s]
JGustavoBR: checks
dimetruk: bets 210
JGustavoBR: raises 1209 to 1419 and is all-in
dimetruk: folds
Uncalled bet (1209) returned to JGustavoBR
JGustavoBR collected 1020 from pot
*** SUMMARY ***
Total pot 1020 | Rake 0
Board [8h As 9s]
Seat 1: gangztastyla folded before Flop (didn't bet)
Seat 5: dimetruk (button) folded on the Flop
Seat 7: WinSomeLose0 (small blind) folded before Flop
Seat 9: JGustavoBR (big blind) collected (1020)


PokerStars Hand #228379669356: Tournament #3231914115, $27.40+$2.60 USD Hold'em No Limit - Level V (60/120) - 2021/07/18 15:26:19 MSK [2021/07/18 8:26:19 ET]
Table '3231914115 1' 9-max Seat #1 is the button
Seat 1: gangztastyla (3141 in chips)
Seat 5: dimetruk (6770 in chips)
Seat 7: WinSomeLose0 (1450 in chips)
Seat 9: JGustavoBR (2139 in chips)
gangztastyla: posts the ante 15
dimetruk: posts the ante 15
WinSomeLose0: posts the ante 15
JGustavoBR: posts the ante 15
dimetruk: posts small blind 60
WinSomeLose0: posts big blind 120
*** HOLE CARDS ***
Dealt to dimetruk [3s 3c]
JGustavoBR: folds
gangztastyla: folds
dimetruk: raises 6635 to 6755 and is all-in
WinSomeLose0: calls 1315 and is all-in
Uncalled bet (5320) returned to dimetruk
*** FLOP *** [Tc Jd 6c]
*** TURN *** [Tc Jd 6c] [Th]
*** RIVER *** [Tc Jd 6c Th] [4d]
*** SHOW DOWN ***
dimetruk: shows [3s 3c] (two pair, Tens and Threes)
WinSomeLose0: shows [Qd 8d] (a pair of Tens)
dimetruk collected 2930 from pot
WinSomeLose0 finished the tournament in 4th place
*** SUMMARY ***
Total pot 2930 | Rake 0
Board [Tc Jd 6c Th 4d]
Seat 1: gangztastyla (button) folded before Flop (didn't bet)
Seat 5: dimetruk (small blind) showed [3s 3c] and won (2930) with two pair, Tens and Threes
Seat 7: WinSomeLose0 (big blind) showed [Qd 8d] and lost with a pair of Tens
Seat 9: JGustavoBR folded before Flop (didn't bet)


PokerStars Hand #228379676843: Tournament #3231914115, $27.40+$2.60 USD Hold'em No Limit - Level V (60/120) - 2021/07/18 15:26:46 MSK [2021/07/18 8:26:46 ET]
Table '3231914115 1' 9-max Seat #9 is the button
Seat 1: gangztastyla (3216 in chips)
Seat 5: dimetruk (8235 in chips)
Seat 9: JGustavoBR (2049 in chips)
gangztastyla: posts the ante 15
dimetruk: posts the ante 15
JGustavoBR: posts the ante 15
gangztastyla: posts small blind 60
dimetruk: posts big blind 120
*** HOLE CARDS ***
Dealt to dimetruk [Td Kd]
JGustavoBR: raises 120 to 240
gangztastyla: folds
dimetruk: calls 120
*** FLOP *** [8s 3d Kc]
dimetruk: checks
JGustavoBR: bets 193
dimetruk: raises 7787 to 7980 and is all-in
JGustavoBR: calls 1601 and is all-in
Uncalled bet (6186) returned to dimetruk
*** TURN *** [8s 3d Kc] [4c]
*** RIVER *** [8s 3d Kc 4c] [8d]
*** SHOW DOWN ***
dimetruk: shows [Td Kd] (two pair, Kings and Eights)
JGustavoBR: shows [Tc Th] (two pair, Tens and Eights)
dimetruk collected 4173 from pot
JGustavoBR finished the tournament in 3rd place and received $49.32.
*** SUMMARY ***
Total pot 4173 | Rake 0
Board [8s 3d Kc 4c 8d]
Seat 1: gangztastyla (small blind) folded before Flop
Seat 5: dimetruk (big blind) showed [Td Kd] and won (4173) with two pair, Kings and Eights
Seat 9: JGustavoBR (button) showed [Tc Th] and lost with two pair, Tens and Eights


PokerStars Hand #228379691274: Tournament #3231914115, $27.40+$2.60 USD Hold'em No Limit - Level V (60/120) - 2021/07/18 15:27:37 MSK [2021/07/18 8:27:37 ET]
Table '3231914115 1' 9-max Seat #1 is the button
Seat 1: gangztastyla (3396 in chips)
Seat 5: dimetruk (10104 in chips)
gangztastyla: posts the ante 15
dimetruk: posts the ante 15
gangztastyla: posts small blind 60
dimetruk: posts big blind 120
*** HOLE CARDS ***
Dealt to dimetruk [8s 2c]
gangztastyla: calls 60
dimetruk: checks
*** FLOP *** [3h Qd 2s]
dimetruk: bets 120
gangztastyla: folds
Uncalled bet (120) returned to dimetruk
dimetruk collected 270 from pot
dimetruk: doesn't show hand
*** SUMMARY ***
Total pot 270 | Rake 0
Board [3h Qd 2s]
Seat 1: gangztastyla (button) (small blind) folded on the Flop
Seat 5: dimetruk (big blind) collected (270)


PokerStars Hand #228379704705: Tournament #3231914115, $27.40+$2.60 USD Hold'em No Limit - Level V (60/120) - 2021/07/18 15:28:25 MSK [2021/07/18 8:28:25 ET]
Table '3231914115 1' 9-max Seat #1 is the button
Seat 1: gangztastyla (2916 in chips)
Seat 5: dimetruk (10584 in chips)
gangztastyla: posts the ante 15
dimetruk: posts the ante 15
gangztastyla: posts small blind 60
dimetruk: posts big blind 120
*** HOLE CARDS ***
Dealt to dimetruk [Ad 2h]
gangztastyla: calls 60
dimetruk: raises 240 to 360
gangztastyla: calls 240
*** FLOP *** [Ah 7c 3d]
dimetruk: bets 10209 and is all-in
gangztastyla: calls 2541 and is all-in
Uncalled bet (7668) returned to dimetruk
*** TURN *** [Ah 7c 3d] [7h]
*** RIVER *** [Ah 7c 3d 7h] [9c]
*** SHOW DOWN ***
dimetruk: shows [Ad 2h] (two pair, Aces and Sevens)
gangztastyla: shows [5s 7s] (three of a kind, Sevens)
gangztastyla collected 5832 from pot
*** SUMMARY ***
Total pot 5832 | Rake 0
Board [Ah 7c 3d 7h 9c]
Seat 1: gangztastyla (button) (small blind) showed [5s 7s] and won (5832) with three of a kind, Sevens
Seat 5: dimetruk (big blind) showed [Ad 2h] and lost with two pair, Aces and Sevens


PokerStars Hand #228379744858: Tournament #3231914115, $27.40+$2.60 USD Hold'em No Limit - Level V (60/120) - 2021/07/18 15:30:46 MSK [2021/07/18 8:30:46 ET]
Table '3231914115 1' 9-max Seat #1 is the button
Seat 1: gangztastyla (6387 in chips)
Seat 5: dimetruk (7113 in chips)
gangztastyla: posts the ante 15
dimetruk: posts the ante 15
gangztastyla: posts small blind 60
dimetruk: posts big blind 120
*** HOLE CARDS ***
Dealt to dimetruk [2c Kh]
gangztastyla: calls 60
dimetruk: checks
*** FLOP *** [4h 7c Js]
dimetruk: checks
gangztastyla: checks
*** TURN *** [4h 7c Js] [8c]
dimetruk: checks
gangztastyla: bets 120
dimetruk: folds
Uncalled bet (120) returned to gangztastyla
gangztastyla collected 270 from pot
gangztastyla: doesn't show hand
*** SUMMARY ***
Total pot 270 | Rake 0
Board [4h 7c Js 8c]
Seat 1: gangztastyla (button) (small blind) collected (270)
Seat 5: dimetruk (big blind) folded on the Turn


PokerStars Hand #228379755159: Tournament #3231914115, $27.40+$2.60 USD Hold'em No Limit - Level V (60/120) - 2021/07/18 15:31:23 MSK [2021/07/18 8:31:23 ET]
Table '3231914115 1' 9-max Seat #5 is the button
Seat 1: gangztastyla (6312 in chips)
Seat 5: dimetruk (7188 in chips)
gangztastyla: posts the ante 15
dimetruk: posts the ante 15
dimetruk: posts small blind 60
gangztastyla: posts big blind 120
*** HOLE CARDS ***
Dealt to dimetruk [Kh 5d]
dimetruk: raises 120 to 240
gangztastyla: calls 120
*** FLOP *** [9s 3h Kc]
gangztastyla: checks
dimetruk: bets 179
gangztastyla: calls 179
*** TURN *** [9s 3h Kc] [Tc]
gangztastyla: checks
dimetruk: bets 434
gangztastyla: calls 434
*** RIVER *** [9s 3h Kc Tc] [Js]
gangztastyla: bets 5444 and is all-in
dimetruk: folds
Uncalled bet (5444) returned to gangztastyla
gangztastyla collected 1736 from pot
gangztastyla: doesn't show hand
*** SUMMARY ***
Total pot 1736 | Rake 0
Board [9s 3h Kc Tc Js]
Seat 1: gangztastyla (big blind) collected (1736)
Seat 5: dimetruk (button) (small blind) folded on the River


PokerStars Hand #228379766730: Tournament #3231914115, $27.40+$2.60 USD Hold'em No Limit - Level V (60/120) - 2021/07/18 15:32:03 MSK [2021/07/18 8:32:03 ET]
Table '3231914115 1' 9-max Seat #1 is the button
Seat 1: gangztastyla (7180 in chips)
Seat 5: dimetruk (6320 in chips)
gangztastyla: posts the ante 15
dimetruk: posts the ante 15
gangztastyla: posts small blind 60
dimetruk: posts big blind 120
*** HOLE CARDS ***
Dealt to dimetruk [Td 8s]
gangztastyla: calls 60
dimetruk: checks
*** FLOP *** [Ad Qd 7d]
dimetruk: bets 120
gangztastyla: folds
Uncalled bet (120) returned to dimetruk
dimetruk collected 270 from pot
dimetruk: doesn't show hand
*** SUMMARY ***
Total pot 270 | Rake 0
Board [Ad Qd 7d]
Seat 1: gangztastyla (button) (small blind) folded on the Flop
Seat 5: dimetruk (big blind) collected (270)


PokerStars Hand #228379773897: Tournament #3231914115, $27.40+$2.60 USD Hold'em No Limit - Level V (60/120) - 2021/07/18 15:32:28 MSK [2021/07/18 8:32:28 ET]
Table '3231914115 1' 9-max Seat #1 is the button
Seat 1: gangztastyla (6910 in chips)
Seat 5: dimetruk (6590 in chips)
gangztastyla: posts the ante 15
dimetruk: posts the ante 15
gangztastyla: posts small blind 60
dimetruk: posts big blind 120
*** HOLE CARDS ***
Dealt to dimetruk [8h Kd]
gangztastyla: calls 60
dimetruk: checks
*** FLOP *** [3d 7h Qd]
dimetruk: checks
gangztastyla: bets 200
dimetruk: calls 200
*** TURN *** [3d 7h Qd] [9h]
dimetruk: checks
gangztastyla: checks
*** RIVER *** [3d 7h Qd 9h] [7s]
dimetruk: bets 670
gangztastyla: folds
Uncalled bet (670) returned to dimetruk
dimetruk collected 670 from pot
dimetruk: doesn't show hand
*** SUMMARY ***
Total pot 670 | Rake 0
Board [3d 7h Qd 9h 7s]
Seat 1: gangztastyla (button) (small blind) folded on the River
Seat 5: dimetruk (big blind) collected (670)


PokerStars Hand #228379783092: Tournament #3231914115, $27.40+$2.60 USD Hold'em No Limit - Level V (60/120) - 2021/07/18 15:32:59 MSK [2021/07/18 8:32:59 ET]
Table '3231914115 1' 9-max Seat #5 is the button
Seat 1: gangztastyla (6575 in chips)
Seat 5: dimetruk (6925 in chips)
gangztastyla: posts the ante 15
dimetruk: posts the ante 15
dimetruk: posts small blind 60
gangztastyla: posts big blind 120
*** HOLE CARDS ***
Dealt to dimetruk [9c Jd]
dimetruk: raises 120 to 240
gangztastyla: raises 120 to 360
dimetruk: calls 120
*** FLOP *** [5h 9d 6c]
gangztastyla: checks
dimetruk: bets 375
gangztastyla: folds
Uncalled bet (375) returned to dimetruk
dimetruk collected 750 from pot
dimetruk: doesn't show hand
*** SUMMARY ***
Total pot 750 | Rake 0
Board [5h 9d 6c]
Seat 1: gangztastyla (big blind) folded on the Flop
Seat 5: dimetruk (button) (small blind) collected (750)


PokerStars Hand #228379793705: Tournament #3231914115, $27.40+$2.60 USD Hold'em No Limit - Level VI (80/160) - 2021/07/18 15:33:23 MSK [2021/07/18 8:33:23 ET]
Table '3231914115 1' 9-max Seat #1 is the button
Seat 1: gangztastyla (6200 in chips)
Seat 5: dimetruk (7300 in chips)
gangztastyla: posts the ante 20
dimetruk: posts the ante 20
gangztastyla: posts small blind 80
dimetruk: posts big blind 160
*** HOLE CARDS ***
Dealt to dimetruk [9s Js]
gangztastyla: calls 80
dimetruk: checks
*** FLOP *** [3c Qs Tc]
dimetruk: checks
gangztastyla: bets 240
dimetruk: calls 240
*** TURN *** [3c Qs Tc] [Ts]
dimetruk: checks
gangztastyla: bets 650
dimetruk: calls 650
*** RIVER *** [3c Qs Tc Ts] [5c]
dimetruk: checks
gangztastyla: checks
*** SHOW DOWN ***
dimetruk: shows [9s Js] (a pair of Tens)
gangztastyla: shows [As Ac] (two pair, Aces and Tens)
gangztastyla collected 2140 from pot
*** SUMMARY ***
Total pot 2140 | Rake 0
Board [3c Qs Tc Ts 5c]
Seat 1: gangztastyla (button) (small blind) showed [As Ac] and won (2140) with two pair, Aces and Tens
Seat 5: dimetruk (big blind) showed [9s Js] and lost with a pair of Tens


PokerStars Hand #228379812515: Tournament #3231914115, $27.40+$2.60 USD Hold'em No Limit - Level VI (80/160) - 2021/07/18 15:34:28 MSK [2021/07/18 8:34:28 ET]
Table '3231914115 1' 9-max Seat #1 is the button
Seat 1: gangztastyla (6530 in chips)
Seat 5: dimetruk (6970 in chips)
gangztastyla: posts the ante 20
dimetruk: posts the ante 20
gangztastyla: posts small blind 80
dimetruk: posts big blind 160
*** HOLE CARDS ***
Dealt to dimetruk [Ah 9d]
gangztastyla: raises 160 to 320
dimetruk: raises 480 to 800
gangztastyla: calls 480
*** FLOP *** [Qc 8s Ac]
dimetruk: checks
gangztastyla: bets 350
dimetruk: raises 5800 to 6150 and is all-in
gangztastyla: folds
Uncalled bet (5800) returned to dimetruk
dimetruk collected 2340 from pot
dimetruk: doesn't show hand
*** SUMMARY ***
Total pot 2340 | Rake 0
Board [Qc 8s Ac]
Seat 1: gangztastyla (button) (small blind) folded on the Flop
Seat 5: dimetruk (big blind) collected (2340)


PokerStars Hand #228379829413: Tournament #3231914115, $27.40+$2.60 USD Hold'em No Limit - Level VI (80/160) - 2021/07/18 15:35:26 MSK [2021/07/18 8:35:26 ET]
Table '3231914115 1' 9-max Seat #1 is the button
Seat 1: gangztastyla (5700 in chips)
Seat 5: dimetruk (7800 in chips)
gangztastyla: posts the ante 20
dimetruk: posts the ante 20
gangztastyla: posts small blind 80
dimetruk: posts big blind 160
*** HOLE CARDS ***
Dealt to dimetruk [Kd Qc]
gangztastyla: calls 80
dimetruk: raises 160 to 320
gangztastyla: calls 160
*** FLOP *** [4s 4c 5c]
dimetruk: bets 238
gangztastyla: raises 962 to 1200
dimetruk: folds
Uncalled bet (962) returned to gangztastyla
gangztastyla collected 1156 from pot
gangztastyla: doesn't show hand
*** SUMMARY ***
Total pot 1156 | Rake 0
Board [4s 4c 5c]
Seat 1: gangztastyla (button) (small blind) collected (1156)
Seat 5: dimetruk (big blind) folded on the Flop


PokerStars Hand #228379838910: Tournament #3231914115, $27.40+$2.60 USD Hold'em No Limit - Level VI (80/160) - 2021/07/18 15:35:58 MSK [2021/07/18 8:35:58 ET]
Table '3231914115 1' 9-max Seat #5 is the button
Seat 1: gangztastyla (6278 in chips)
Seat 5: dimetruk (7222 in chips)
gangztastyla: posts the ante 20
dimetruk: posts the ante 20
dimetruk: posts small blind 80
gangztastyla: posts big blind 160
*** HOLE CARDS ***
Dealt to dimetruk [8h As]
dimetruk: raises 160 to 320
gangztastyla: calls 160
*** FLOP *** [Th 6s Ah]
gangztastyla: checks
dimetruk: bets 238
gangztastyla: calls 238
*** TURN *** [Th 6s Ah] [Kh]
gangztastyla: checks
dimetruk: checks
*** RIVER *** [Th 6s Ah Kh] [4d]
gangztastyla: bets 275
dimetruk: calls 275
*** SHOW DOWN ***
gangztastyla: shows [Qs Jh] (a straight, Ten to Ace)
dimetruk: mucks hand
gangztastyla collected 1706 from pot
*** SUMMARY ***
Total pot 1706 | Rake 0
Board [Th 6s Ah Kh 4d]
Seat 1: gangztastyla (big blind) showed [Qs Jh] and won (1706) with a straight, Ten to Ace
Seat 5: dimetruk (button) (small blind) mucked [8h As]


PokerStars Hand #228379849813: Tournament #3231914115, $27.40+$2.60 USD Hold'em No Limit - Level VI (80/160) - 2021/07/18 15:36:35 MSK [2021/07/18 8:36:35 ET]
Table '3231914115 1' 9-max Seat #1 is the button
Seat 1: gangztastyla (7131 in chips)
Seat 5: dimetruk (6369 in chips)
gangztastyla: posts the ante 20
dimetruk: posts the ante 20
gangztastyla: posts small blind 80
dimetruk: posts big blind 160
*** HOLE CARDS ***
Dealt to dimetruk [4s As]
gangztastyla: calls 80
dimetruk: checks
*** FLOP *** [Jd Qc 7s]
dimetruk: checks
gangztastyla: bets 220
dimetruk: folds
Uncalled bet (220) returned to gangztastyla
gangztastyla collected 360 from pot
gangztastyla: doesn't show hand
*** SUMMARY ***
Total pot 360 | Rake 0
Board [Jd Qc 7s]
Seat 1: gangztastyla (button) (small blind) collected (360)
Seat 5: dimetruk (big blind) folded on the Flop


PokerStars Hand #228379862863: Tournament #3231914115, $27.40+$2.60 USD Hold'em No Limit - Level VI (80/160) - 2021/07/18 15:37:19 MSK [2021/07/18 8:37:19 ET]
Table '3231914115 1' 9-max Seat #1 is the button
Seat 1: gangztastyla (7131 in chips)
Seat 5: dimetruk (6369 in chips)
gangztastyla: posts the ante 20
dimetruk: posts the ante 20
gangztastyla: posts small blind 80
dimetruk: posts big blind 160
*** HOLE CARDS ***
Dealt to dimetruk [Ts 9c]
gangztastyla: calls 80
dimetruk: checks
*** FLOP *** [2h 8h Qc]
dimetruk: checks
gangztastyla: checks
*** TURN *** [2h 8h Qc] [9h]
dimetruk: bets 240
gangztastyla: folds
Uncalled bet (240) returned to dimetruk
dimetruk collected 360 from pot
dimetruk: doesn't show hand
*** SUMMARY ***
Total pot 360 | Rake 0
Board [2h 8h Qc 9h]
Seat 1: gangztastyla (button) (small blind) folded on the Turn
Seat 5: dimetruk (big blind) collected (360)


PokerStars Hand #228379888074: Tournament #3231914115, $27.40+$2.60 USD Hold'em No Limit - Level VI (80/160) - 2021/07/18 15:38:45 MSK [2021/07/18 8:38:45 ET]
Table '3231914115 1' 9-max Seat #5 is the button
Seat 1: gangztastyla (7271 in chips)
Seat 5: dimetruk (6229 in chips)
gangztastyla: posts the ante 20
dimetruk: posts the ante 20
dimetruk: posts small blind 80
gangztastyla: posts big blind 160
*** HOLE CARDS ***
Dealt to dimetruk [4s 5d]
dimetruk: calls 80
gangztastyla: checks
*** FLOP *** [9h Th 6d]
gangztastyla: bets 160
dimetruk: folds
Uncalled bet (160) returned to gangztastyla
gangztastyla collected 360 from pot
gangztastyla: doesn't show hand
*** SUMMARY ***
Total pot 360 | Rake 0
Board [9h Th 6d]
Seat 1: gangztastyla (big blind) collected (360)
Seat 5: dimetruk (button) (small blind) folded on the Flop


PokerStars Hand #228379893664: Tournament #3231914115, $27.40+$2.60 USD Hold'em No Limit - Level VI (80/160) - 2021/07/18 15:39:04 MSK [2021/07/18 8:39:04 ET]
Table '3231914115 1' 9-max Seat #5 is the button
Seat 1: gangztastyla (7351 in chips)
Seat 5: dimetruk (6149 in chips)
gangztastyla: posts the ante 20
dimetruk: posts the ante 20
dimetruk: posts small blind 80
gangztastyla: posts big blind 160
*** HOLE CARDS ***
Dealt to dimetruk [3s 5d]
dimetruk: calls 80
gangztastyla: checks
*** FLOP *** [6s 7d Kh]
gangztastyla: bets 160
dimetruk: calls 160
*** TURN *** [6s 7d Kh] [9c]
gangztastyla: bets 160
dimetruk: calls 160
*** RIVER *** [6s 7d Kh 9c] [Ad]
gangztastyla: checks
dimetruk: bets 680
gangztastyla: folds
Uncalled bet (680) returned to dimetruk
dimetruk collected 1000 from pot
dimetruk: doesn't show hand
*** SUMMARY ***
Total pot 1000 | Rake 0
Board [6s 7d Kh 9c Ad]
Seat 1: gangztastyla (big blind) folded on the River
Seat 5: dimetruk (button) (small blind) collected (1000)


PokerStars Hand #228379909957: Tournament #3231914115, $27.40+$2.60 USD Hold'em No Limit - Level VI (80/160) - 2021/07/18 15:39:59 MSK [2021/07/18 8:39:59 ET]
Table '3231914115 1' 9-max Seat #1 is the button
Seat 1: gangztastyla (7131 in chips)
Seat 5: dimetruk (6369 in chips)
gangztastyla: posts the ante 20
dimetruk: posts the ante 20
gangztastyla: posts small blind 80
dimetruk: posts big blind 160
*** HOLE CARDS ***
Dealt to dimetruk [5d Td]
gangztastyla: calls 80
dimetruk: checks
*** FLOP *** [Qc 6s 7h]
dimetruk: checks
gangztastyla: bets 160
dimetruk: folds
Uncalled bet (160) returned to gangztastyla
gangztastyla collected 360 from pot
gangztastyla: doesn't show hand
*** SUMMARY ***
Total pot 360 | Rake 0
Board [Qc 6s 7h]
Seat 1: gangztastyla (button) (small blind) collected (360)
Seat 5: dimetruk (big blind) folded on the Flop


PokerStars Hand #228379913702: Tournament #3231914115, $27.40+$2.60 USD Hold'em No Limit - Level VI (80/160) - 2021/07/18 15:40:12 MSK [2021/07/18 8:40:12 ET]
Table '3231914115 1' 9-max Seat #5 is the button
Seat 1: gangztastyla (7311 in chips)
Seat 5: dimetruk (6189 in chips)
gangztastyla: posts the ante 20
dimetruk: posts the ante 20
dimetruk: posts small blind 80
gangztastyla: posts big blind 160
*** HOLE CARDS ***
Dealt to dimetruk [Jc 7s]
dimetruk: raises 160 to 320
gangztastyla: calls 160
*** FLOP *** [8h Kh Kd]
gangztastyla: checks
dimetruk: bets 238
gangztastyla: folds
Uncalled bet (238) returned to dimetruk
dimetruk collected 680 from pot
dimetruk: doesn't show hand
*** SUMMARY ***
Total pot 680 | Rake 0
Board [8h Kh Kd]
Seat 1: gangztastyla (big blind) folded on the Flop
Seat 5: dimetruk (button) (small blind) collected (680)


PokerStars Hand #228379928522: Tournament #3231914115, $27.40+$2.60 USD Hold'em No Limit - Level VI (80/160) - 2021/07/18 15:41:04 MSK [2021/07/18 8:41:04 ET]
Table '3231914115 1' 9-max Seat #1 is the button
Seat 1: gangztastyla (7211 in chips)
Seat 5: dimetruk (6289 in chips)
gangztastyla: posts the ante 20
dimetruk: posts the ante 20
gangztastyla: posts small blind 80
dimetruk: posts big blind 160
*** HOLE CARDS ***
Dealt to dimetruk [9d Ad]
gangztastyla: raises 160 to 320
dimetruk: calls 160
*** FLOP *** [2h 3d Kc]
dimetruk: checks
gangztastyla: bets 160
dimetruk: calls 160
*** TURN *** [2h 3d Kc] [8h]
dimetruk: checks
gangztastyla: bets 160
dimetruk: calls 160
*** RIVER *** [2h 3d Kc 8h] [8s]
dimetruk: checks
gangztastyla: checks
*** SHOW DOWN ***
dimetruk: shows [9d Ad] (a pair of Eights)
gangztastyla: shows [Qd As] (a pair of Eights - Ace+King+Queen kicker)
gangztastyla collected 1320 from pot
*** SUMMARY ***
Total pot 1320 | Rake 0
Board [2h 3d Kc 8h 8s]
Seat 1: gangztastyla (button) (small blind) showed [Qd As] and won (1320) with a pair of Eights
Seat 5: dimetruk (big blind) showed [9d Ad] and lost with a pair of Eights


PokerStars Hand #228379944646: Tournament #3231914115, $27.40+$2.60 USD Hold'em No Limit - Level VI (80/160) - 2021/07/18 15:41:32 MSK [2021/07/18 8:41:32 ET]
Table '3231914115 1' 9-max Seat #5 is the button
Seat 1: gangztastyla (7871 in chips)
Seat 5: dimetruk (5629 in chips)
gangztastyla: posts the ante 20
dimetruk: posts the ante 20
dimetruk: posts small blind 80
gangztastyla: posts big blind 160
*** HOLE CARDS ***
Dealt to dimetruk [5h 4c]
dimetruk: raises 160 to 320
gangztastyla: calls 160
*** FLOP *** [Jc 9d 6c]
gangztastyla: checks
dimetruk: checks
*** TURN *** [Jc 9d 6c] [9s]
gangztastyla: checks
dimetruk: bets 340
gangztastyla: raises 410 to 750
dimetruk: folds
Uncalled bet (410) returned to gangztastyla
gangztastyla collected 1360 from pot
gangztastyla: doesn't show hand
*** SUMMARY ***
Total pot 1360 | Rake 0
Board [Jc 9d 6c 9s]
Seat 1: gangztastyla (big blind) collected (1360)
Seat 5: dimetruk (button) (small blind) folded on the Turn


PokerStars Hand #228379961865: Tournament #3231914115, $27.40+$2.60 USD Hold'em No Limit - Level VI (80/160) - 2021/07/18 15:42:31 MSK [2021/07/18 8:42:31 ET]
Table '3231914115 1' 9-max Seat #5 is the button
Seat 1: gangztastyla (8451 in chips)
Seat 5: dimetruk (5049 in chips)
gangztastyla: posts the ante 20
dimetruk: posts the ante 20
dimetruk: posts small blind 80
gangztastyla: posts big blind 160
*** HOLE CARDS ***
Dealt to dimetruk [4c Tc]
dimetruk: raises 160 to 320
gangztastyla: calls 160
*** FLOP *** [Ac 9s 6h]
gangztastyla: checks
dimetruk: bets 238
gangztastyla: folds
Uncalled bet (238) returned to dimetruk
dimetruk collected 680 from pot
dimetruk: doesn't show hand
*** SUMMARY ***
Total pot 680 | Rake 0
Board [Ac 9s 6h]
Seat 1: gangztastyla (big blind) folded on the Flop
Seat 5: dimetruk (button) (small blind) collected (680)


PokerStars Hand #228379965572: Tournament #3231914115, $27.40+$2.60 USD Hold'em No Limit - Level VI (80/160) - 2021/07/18 15:42:44 MSK [2021/07/18 8:42:44 ET]
Table '3231914115 1' 9-max Seat #1 is the button
Seat 1: gangztastyla (8111 in chips)
Seat 5: dimetruk (5389 in chips)
gangztastyla: posts the ante 20
dimetruk: posts the ante 20
gangztastyla: posts small blind 80
dimetruk: posts big blind 160
*** HOLE CARDS ***
Dealt to dimetruk [As Jc]
gangztastyla: calls 80
dimetruk: raises 360 to 520
gangztastyla: calls 360
*** FLOP *** [Td 8s Ks]
dimetruk: bets 378
gangztastyla: calls 378
*** TURN *** [Td 8s Ks] [Ac]
dimetruk: bets 918
gangztastyla: calls 918
*** RIVER *** [Td 8s Ks Ac] [4d]
dimetruk: checks
gangztastyla: bets 2500
dimetruk: calls 2500
*** SHOW DOWN ***
gangztastyla: shows [Js Qc] (a straight, Ten to Ace)
dimetruk: mucks hand
gangztastyla collected 8672 from pot
*** SUMMARY ***
Total pot 8672 | Rake 0
Board [Td 8s Ks Ac 4d]
Seat 1: gangztastyla (button) (small blind) showed [Js Qc] and won (8672) with a straight, Ten to Ace
Seat 5: dimetruk (big blind) mucked [As Jc]


PokerStars Hand #228379998769: Tournament #3231914115, $27.40+$2.60 USD Hold'em No Limit - Level VII (100/200) - 2021/07/18 15:44:38 MSK [2021/07/18 8:44:38 ET]
Table '3231914115 1' 9-max Seat #5 is the button
Seat 1: gangztastyla (12097 in chips)
Seat 5: dimetruk (1403 in chips)
gangztastyla: posts the ante 25
dimetruk: posts the ante 25
dimetruk: posts small blind 100
gangztastyla: posts big blind 200
*** HOLE CARDS ***
Dealt to dimetruk [3d Kh]
dimetruk: raises 1178 to 1378 and is all-in
gangztastyla: calls 1178
*** FLOP *** [Js 9s Th]
*** TURN *** [Js 9s Th] [9d]
*** RIVER *** [Js 9s Th 9d] [8h]
*** SHOW DOWN ***
gangztastyla: shows [5c 5s] (two pair, Nines and Fives)
dimetruk: shows [3d Kh] (a pair of Nines)
gangztastyla collected 2806 from pot
dimetruk finished the tournament in 2nd place and received $73.98.
gangztastyla wins the tournament and receives $123.30 - congratulations!
*** SUMMARY ***
Total pot 2806 | Rake 0
Board [Js 9s Th 9d 8h]
Seat 1: gangztastyla (big blind) showed [5c 5s] and won (2806) with two pair, Nines and Fives
Seat 5: dimetruk (button) (small blind) showed [3d Kh] and lost with a pair of Nines


PokerStars Hand #228815535562: Tournament #3242835350, $27.58+$2.42 USD Hold'em No Limit - Level I (10/20) - 2021/08/05 0:36:18 MSK [2021/08/04 17:36:18 ET]
Table '3242835350 1' 6-max Seat #1 is the button
Seat 1: dimetruk (1500 in chips)
Seat 2: dtronnolone (1500 in chips)
Seat 3: mishanya_pim (1500 in chips)
Seat 4: PokerKid700 (1500 in chips)
Seat 5: Hänsen264 (1500 in chips)
Seat 6: MirrowCall (1500 in chips)
dimetruk: posts the ante 3
dtronnolone: posts the ante 3
mishanya_pim: posts the ante 3
PokerKid700: posts the ante 3
Hänsen264: posts the ante 3
MirrowCall: posts the ante 3
dtronnolone: posts small blind 10
mishanya_pim: posts big blind 20
*** HOLE CARDS ***
Dealt to dimetruk [Ad 4d]
PokerKid700: folds
Hänsen264: folds
MirrowCall: folds
dimetruk: raises 30 to 50
dtronnolone: raises 131 to 181
mishanya_pim: folds
dimetruk: calls 131
*** FLOP *** [9h 6c Qc]
dtronnolone: bets 144
dimetruk: folds
Uncalled bet (144) returned to dtronnolone
dtronnolone collected 400 from pot
dtronnolone: doesn't show hand
*** SUMMARY ***
Total pot 400 | Rake 0
Board [9h 6c Qc]
Seat 1: dimetruk (button) folded on the Flop
Seat 2: dtronnolone (small blind) collected (400)
Seat 3: mishanya_pim (big blind) folded before Flop
Seat 4: PokerKid700 folded before Flop (didn't bet)
Seat 5: Hänsen264 folded before Flop (didn't bet)
Seat 6: MirrowCall folded before Flop (didn't bet)


PokerStars Hand #228815620880: Tournament #3242835350, $27.58+$2.42 USD Hold'em No Limit - Level I (10/20) - 2021/08/05 0:39:43 MSK [2021/08/04 17:39:43 ET]
Table '3242835350 1' 6-max Seat #5 is the button
Seat 1: dimetruk (1307 in chips)
Seat 2: dtronnolone (1863 in chips)
Seat 3: mishanya_pim (1568 in chips)
Seat 4: PokerKid700 (1566 in chips)
Seat 5: Hänsen264 (1288 in chips)
Seat 6: MirrowCall (1408 in chips)
dimetruk: posts the ante 3
dtronnolone: posts the ante 3
mishanya_pim: posts the ante 3
PokerKid700: posts the ante 3
Hänsen264: posts the ante 3
MirrowCall: posts the ante 3
MirrowCall: posts small blind 10
dimetruk: posts big blind 20
*** HOLE CARDS ***
Dealt to dimetruk [8c Qd]
dtronnolone: folds
mishanya_pim: folds
PokerKid700: raises 20 to 40
Hänsen264: folds
MirrowCall: folds
dimetruk: calls 20
*** FLOP *** [Jd 8h 7h]
dimetruk: checks
PokerKid700: bets 54
dimetruk: calls 54
*** TURN *** [Jd 8h 7h] [Ah]
dimetruk: checks
PokerKid700: bets 80
dimetruk: folds
Uncalled bet (80) returned to PokerKid700
PokerKid700 collected 216 from pot
PokerKid700: doesn't show hand
*** SUMMARY ***
Total pot 216 | Rake 0
Board [Jd 8h 7h Ah]
Seat 1: dimetruk (big blind) folded on the Turn
Seat 2: dtronnolone folded before Flop (didn't bet)
Seat 3: mishanya_pim folded before Flop (didn't bet)
Seat 4: PokerKid700 collected (216)
Seat 5: Hänsen264 (button) folded before Flop (didn't bet)
Seat 6: MirrowCall (small blind) folded before Flop


PokerStars Hand #228815641765: Tournament #3242835350, $27.58+$2.42 USD Hold'em No Limit - Level I (10/20) - 2021/08/05 0:40:34 MSK [2021/08/04 17:40:34 ET]
Table '3242835350 1' 6-max Seat #6 is the button
Seat 1: dimetruk (1210 in chips)
Seat 2: dtronnolone (1860 in chips)
Seat 3: mishanya_pim (1565 in chips)
Seat 4: PokerKid700 (1685 in chips)
Seat 5: Hänsen264 (1285 in chips)
Seat 6: MirrowCall (1395 in chips)
dimetruk: posts the ante 3
dtronnolone: posts the ante 3
mishanya_pim: posts the ante 3
PokerKid700: posts the ante 3
Hänsen264: posts the ante 3
MirrowCall: posts the ante 3
dimetruk: posts small blind 10
dtronnolone: posts big blind 20
*** HOLE CARDS ***
Dealt to dimetruk [As 7c]
mishanya_pim: folds
PokerKid700: folds
Hänsen264: folds
MirrowCall: calls 20
dimetruk: raises 45 to 65
dtronnolone: calls 45
MirrowCall: calls 45
*** FLOP *** [6s 2c 3c]
dimetruk: checks
dtronnolone: checks
MirrowCall: checks
*** TURN *** [6s 2c 3c] [8d]
dimetruk: bets 70
dtronnolone: folds
MirrowCall: folds
Uncalled bet (70) returned to dimetruk
dimetruk collected 213 from pot
dimetruk: doesn't show hand
*** SUMMARY ***
Total pot 213 | Rake 0
Board [6s 2c 3c 8d]
Seat 1: dimetruk (small blind) collected (213)
Seat 2: dtronnolone (big blind) folded on the Turn
Seat 3: mishanya_pim folded before Flop (didn't bet)
Seat 4: PokerKid700 folded before Flop (didn't bet)
Seat 5: Hänsen264 folded before Flop (didn't bet)
Seat 6: MirrowCall (button) folded on the Turn


PokerStars Hand #228815672371: Tournament #3242835350, $27.58+$2.42 USD Hold'em No Limit - Level I (10/20) - 2021/08/05 0:41:49 MSK [2021/08/04 17:41:49 ET]
Table '3242835350 1' 6-max Seat #1 is the button
Seat 1: dimetruk (1355 in chips)
Seat 2: dtronnolone (1792 in chips)
Seat 3: mishanya_pim (1562 in chips)
Seat 4: PokerKid700 (1682 in chips)
Seat 5: Hänsen264 (1282 in chips)
Seat 6: MirrowCall (1327 in chips)
dimetruk: posts the ante 3
dtronnolone: posts the ante 3
mishanya_pim: posts the ante 3
PokerKid700: posts the ante 3
Hänsen264: posts the ante 3
MirrowCall: posts the ante 3
dtronnolone: posts small blind 10
mishanya_pim: posts big blind 20
*** HOLE CARDS ***
Dealt to dimetruk [2d Ad]
PokerKid700: folds
Hänsen264: folds
MirrowCall: raises 20 to 40
dimetruk: raises 85 to 125
dtronnolone: folds
mishanya_pim: folds
MirrowCall: calls 85
*** FLOP *** [Jh 5d Qd]
MirrowCall: checks
dimetruk: checks
*** TURN *** [Jh 5d Qd] [4s]
MirrowCall: bets 298
dimetruk: calls 298
*** RIVER *** [Jh 5d Qd 4s] [2s]
MirrowCall: bets 901 and is all-in
dimetruk: folds
Uncalled bet (901) returned to MirrowCall
MirrowCall collected 894 from pot
MirrowCall: doesn't show hand
*** SUMMARY ***
Total pot 894 | Rake 0
Board [Jh 5d Qd 4s 2s]
Seat 1: dimetruk (button) folded on the River
Seat 2: dtronnolone (small blind) folded before Flop
Seat 3: mishanya_pim (big blind) folded before Flop
Seat 4: PokerKid700 folded before Flop (didn't bet)
Seat 5: Hänsen264 folded before Flop (didn't bet)
Seat 6: MirrowCall collected (894)


PokerStars Hand #228815773810: Tournament #3242835350, $27.58+$2.42 USD Hold'em No Limit - Level I (10/20) - 2021/08/05 0:45:57 MSK [2021/08/04 17:45:57 ET]
Table '3242835350 1' 6-max Seat #4 is the button
Seat 1: dimetruk (923 in chips)
Seat 2: dtronnolone (1851 in chips)
Seat 3: mishanya_pim (1513 in chips)
Seat 4: PokerKid700 (1727 in chips)
Seat 5: Hänsen264 (1217 in chips)
Seat 6: MirrowCall (1769 in chips)
dimetruk: posts the ante 3
dtronnolone: posts the ante 3
mishanya_pim: posts the ante 3
PokerKid700: posts the ante 3
Hänsen264: posts the ante 3
MirrowCall: posts the ante 3
Hänsen264: posts small blind 10
MirrowCall: posts big blind 20
*** HOLE CARDS ***
Dealt to dimetruk [Ks 9s]
dimetruk: raises 20 to 40
dtronnolone: calls 40
mishanya_pim: folds
PokerKid700: folds
Hänsen264: folds
MirrowCall: folds
*** FLOP *** [9h Ts Kd]
dimetruk: bets 67
dtronnolone: calls 67
*** TURN *** [9h Ts Kd] [6c]
dimetruk: bets 189
dtronnolone: folds
Uncalled bet (189) returned to dimetruk
dimetruk collected 262 from pot
dimetruk: doesn't show hand
*** SUMMARY ***
Total pot 262 | Rake 0
Board [9h Ts Kd 6c]
Seat 1: dimetruk collected (262)
Seat 2: dtronnolone folded on the Turn
Seat 3: mishanya_pim folded before Flop (didn't bet)
Seat 4: PokerKid700 (button) folded before Flop (didn't bet)
Seat 5: Hänsen264 (small blind) folded before Flop
Seat 6: MirrowCall (big blind) folded before Flop


PokerStars Hand #228815795995: Tournament #3242835350, $27.58+$2.42 USD Hold'em No Limit - Level II (15/30) - 2021/08/05 0:46:52 MSK [2021/08/04 17:46:52 ET]
Table '3242835350 1' 6-max Seat #5 is the button
Seat 1: dimetruk (1075 in chips)
Seat 2: dtronnolone (1741 in chips)
Seat 3: mishanya_pim (1510 in chips)
Seat 4: PokerKid700 (1724 in chips)
Seat 5: Hänsen264 (1204 in chips)
Seat 6: MirrowCall (1746 in chips)
dimetruk: posts the ante 4
dtronnolone: posts the ante 4
mishanya_pim: posts the ante 4
PokerKid700: posts the ante 4
Hänsen264: posts the ante 4
MirrowCall: posts the ante 4
MirrowCall: posts small blind 15
dimetruk: posts big blind 30
*** HOLE CARDS ***
Dealt to dimetruk [Ts 2d]
dtronnolone: raises 51 to 81
mishanya_pim: folds
PokerKid700: folds
Hänsen264: calls 81
MirrowCall: folds
dimetruk: calls 51
*** FLOP *** [2h Ks 5c]
dimetruk: checks
dtronnolone: bets 102
Hänsen264: folds
dimetruk: calls 102
*** TURN *** [2h Ks 5c] [Jc]
dimetruk: checks
dtronnolone: bets 175
dimetruk: folds
Uncalled bet (175) returned to dtronnolone
dtronnolone collected 486 from pot
dtronnolone: doesn't show hand
*** SUMMARY ***
Total pot 486 | Rake 0
Board [2h Ks 5c Jc]
Seat 1: dimetruk (big blind) folded on the Turn
Seat 2: dtronnolone collected (486)
Seat 3: mishanya_pim folded before Flop (didn't bet)
Seat 4: PokerKid700 folded before Flop (didn't bet)
Seat 5: Hänsen264 (button) folded on the Flop
Seat 6: MirrowCall (small blind) folded before Flop


PokerStars Hand #228815906824: Tournament #3242835350, $27.58+$2.42 USD Hold'em No Limit - Level II (15/30) - 2021/08/05 0:51:30 MSK [2021/08/04 17:51:30 ET]
Table '3242835350 1' 6-max Seat #4 is the button
Seat 1: dimetruk (842 in chips)
Seat 2: dtronnolone (1317 in chips)
Seat 3: mishanya_pim (1629 in chips)
Seat 4: PokerKid700 (1788 in chips)
Seat 5: Hänsen264 (1466 in chips)
Seat 6: MirrowCall (1958 in chips)
dimetruk: posts the ante 4
dtronnolone: posts the ante 4
mishanya_pim: posts the ante 4
PokerKid700: posts the ante 4
Hänsen264: posts the ante 4
MirrowCall: posts the ante 4
Hänsen264: posts small blind 15
MirrowCall: posts big blind 30
*** HOLE CARDS ***
Dealt to dimetruk [Th As]
dimetruk: raises 45 to 75
dtronnolone: folds
mishanya_pim: calls 75
PokerKid700: folds
Hänsen264: folds
MirrowCall: folds
*** FLOP *** [4d Qc 5c]
dimetruk: checks
mishanya_pim: bets 55
dimetruk: folds
Uncalled bet (55) returned to mishanya_pim
mishanya_pim collected 219 from pot
mishanya_pim: doesn't show hand
*** SUMMARY ***
Total pot 219 | Rake 0
Board [4d Qc 5c]
Seat 1: dimetruk folded on the Flop
Seat 2: dtronnolone folded before Flop (didn't bet)
Seat 3: mishanya_pim collected (219)
Seat 4: PokerKid700 (button) folded before Flop (didn't bet)
Seat 5: Hänsen264 (small blind) folded before Flop
Seat 6: MirrowCall (big blind) folded before Flop


PokerStars Hand #228815923338: Tournament #3242835350, $27.58+$2.42 USD Hold'em No Limit - Level II (15/30) - 2021/08/05 0:52:10 MSK [2021/08/04 17:52:10 ET]
Table '3242835350 1' 6-max Seat #5 is the button
Seat 1: dimetruk (763 in chips)
Seat 2: dtronnolone (1313 in chips)
Seat 3: mishanya_pim (1769 in chips)
Seat 4: PokerKid700 (1784 in chips)
Seat 5: Hänsen264 (1447 in chips)
Seat 6: MirrowCall (1924 in chips)
dimetruk: posts the ante 4
dtronnolone: posts the ante 4
mishanya_pim: posts the ante 4
PokerKid700: posts the ante 4
Hänsen264: posts the ante 4
MirrowCall: posts the ante 4
MirrowCall: posts small blind 15
dimetruk: posts big blind 30
*** HOLE CARDS ***
Dealt to dimetruk [Tc 2c]
dtronnolone: folds
mishanya_pim: folds
PokerKid700: folds
Hänsen264: raises 56 to 86
MirrowCall: folds
dimetruk: calls 56
*** FLOP *** [Kd Kh 3d]
dimetruk: checks
Hänsen264: bets 87
dimetruk: folds
Uncalled bet (87) returned to Hänsen264
Hänsen264 collected 211 from pot
Hänsen264: doesn't show hand
*** SUMMARY ***
Total pot 211 | Rake 0
Board [Kd Kh 3d]
Seat 1: dimetruk (big blind) folded on the Flop
Seat 2: dtronnolone folded before Flop (didn't bet)
Seat 3: mishanya_pim folded before Flop (didn't bet)
Seat 4: PokerKid700 folded before Flop (didn't bet)
Seat 5: Hänsen264 (button) collected (211)
Seat 6: MirrowCall (small blind) folded before Flop


PokerStars Hand #228816055283: Tournament #3242835350, $27.58+$2.42 USD Hold'em No Limit - Level III (25/50) - 2021/08/05 0:58:33 MSK [2021/08/04 17:58:33 ET]
Table '3242835350 1' 6-max Seat #5 is the button
Seat 1: dimetruk (747 in chips)
Seat 2: dtronnolone (1341 in chips)
Seat 3: mishanya_pim (1698 in chips)
Seat 4: PokerKid700 (1407 in chips)
Seat 5: Hänsen264 (1491 in chips)
Seat 6: MirrowCall (2316 in chips)
dimetruk: posts the ante 6
dtronnolone: posts the ante 6
mishanya_pim: posts the ante 6
PokerKid700: posts the ante 6
Hänsen264: posts the ante 6
MirrowCall: posts the ante 6
MirrowCall: posts small blind 25
dimetruk: posts big blind 50
*** HOLE CARDS ***
Dealt to dimetruk [Ks Th]
dtronnolone: raises 85 to 135
mishanya_pim: folds
PokerKid700: folds
Hänsen264: folds
MirrowCall: calls 110
dimetruk: raises 606 to 741 and is all-in
dtronnolone: folds
MirrowCall: calls 606
*** FLOP *** [Ts 2d Jc]
*** TURN *** [Ts 2d Jc] [Ad]
*** RIVER *** [Ts 2d Jc Ad] [7s]
*** SHOW DOWN ***
MirrowCall: shows [8h Js] (a pair of Jacks)
dimetruk: shows [Ks Th] (a pair of Tens)
MirrowCall collected 1653 from pot
dimetruk finished the tournament in 6th place
*** SUMMARY ***
Total pot 1653 | Rake 0
Board [Ts 2d Jc Ad 7s]
Seat 1: dimetruk (big blind) showed [Ks Th] and lost with a pair of Tens
Seat 2: dtronnolone folded before Flop
Seat 3: mishanya_pim folded before Flop (didn't bet)
Seat 4: PokerKid700 folded before Flop (didn't bet)
Seat 5: Hänsen264 (button) folded before Flop (didn't bet)
Seat 6: MirrowCall (small blind) showed [8h Js] and won (1653) with a pair of Jacks


PokerStars Hand #228816085478: Tournament #3242858326, $27.58+$2.42 USD Hold'em No Limit - Level I (10/20) - 2021/08/05 1:00:11 MSK [2021/08/04 18:00:11 ET]
Table '3242858326 1' 6-max Seat #1 is the button
Seat 1: MirrowCall (1500 in chips)
Seat 2: julinhobrazu (1500 in chips)
Seat 3: mishanya_pim (1500 in chips)
Seat 4: crazyrob87 (1500 in chips)
Seat 5: JK147 (1500 in chips)
Seat 6: dimetruk (1500 in chips)
MirrowCall: posts the ante 3
julinhobrazu: posts the ante 3
mishanya_pim: posts the ante 3
crazyrob87: posts the ante 3
JK147: posts the ante 3
dimetruk: posts the ante 3
julinhobrazu: posts small blind 10
mishanya_pim: posts big blind 20
*** HOLE CARDS ***
Dealt to dimetruk [Tc 9c]
crazyrob87: folds
JK147: calls 20
dimetruk: raises 40 to 60
MirrowCall: folds
julinhobrazu: folds
mishanya_pim: folds
JK147: calls 40
*** FLOP *** [2s 2c 7d]
JK147: checks
dimetruk: bets 55
JK147: calls 55
*** TURN *** [2s 2c 7d] [Qc]
JK147: checks
dimetruk: bets 320
JK147: calls 320
*** RIVER *** [2s 2c 7d Qc] [2d]
JK147: checks
dimetruk: checks
*** SHOW DOWN ***
JK147: shows [Qh 8d] (a full house, Deuces full of Queens)
dimetruk: mucks hand
JK147 collected 918 from pot
*** SUMMARY ***
Total pot 918 | Rake 0
Board [2s 2c 7d Qc 2d]
Seat 1: MirrowCall (button) folded before Flop (didn't bet)
Seat 2: julinhobrazu (small blind) folded before Flop
Seat 3: mishanya_pim (big blind) folded before Flop
Seat 4: crazyrob87 folded before Flop (didn't bet)
Seat 5: JK147 showed [Qh 8d] and won (918) with a full house, Deuces full of Queens
Seat 6: dimetruk mucked [Tc 9c]


PokerStars Hand #228816150099: Tournament #3242858326, $27.58+$2.42 USD Hold'em No Limit - Level I (10/20) - 2021/08/05 1:03:10 MSK [2021/08/04 18:03:10 ET]
Table '3242858326 1' 6-max Seat #4 is the button
Seat 1: MirrowCall (1491 in chips)
Seat 2: julinhobrazu (1481 in chips)
Seat 3: mishanya_pim (1461 in chips)
Seat 4: crazyrob87 (1074 in chips)
Seat 5: JK147 (2437 in chips)
Seat 6: dimetruk (1056 in chips)
MirrowCall: posts the ante 3
julinhobrazu: posts the ante 3
mishanya_pim: posts the ante 3
crazyrob87: posts the ante 3
JK147: posts the ante 3
dimetruk: posts the ante 3
JK147: posts small blind 10
dimetruk: posts big blind 20
*** HOLE CARDS ***
Dealt to dimetruk [9s 6d]
MirrowCall: folds
julinhobrazu: folds
mishanya_pim: folds
crazyrob87: raises 40 to 60
JK147: calls 50
dimetruk: calls 40
*** FLOP *** [3c 5c 7h]
JK147: checks
dimetruk: checks
crazyrob87: bets 99
JK147: folds
dimetruk: calls 99
*** TURN *** [3c 5c 7h] [Td]
dimetruk: checks
crazyrob87: bets 160
dimetruk: folds
Uncalled bet (160) returned to crazyrob87
crazyrob87 collected 396 from pot
crazyrob87: doesn't show hand
*** SUMMARY ***
Total pot 396 | Rake 0
Board [3c 5c 7h Td]
Seat 1: MirrowCall folded before Flop (didn't bet)
Seat 2: julinhobrazu folded before Flop (didn't bet)
Seat 3: mishanya_pim folded before Flop (didn't bet)
Seat 4: crazyrob87 (button) collected (396)
Seat 5: JK147 (small blind) folded on the Flop
Seat 6: dimetruk (big blind) folded on the Turn


PokerStars Hand #228816186371: Tournament #3242858326, $27.58+$2.42 USD Hold'em No Limit - Level I (10/20) - 2021/08/05 1:04:46 MSK [2021/08/04 18:04:46 ET]
Table '3242858326 1' 6-max Seat #6 is the button
Seat 1: MirrowCall (1425 in chips)
Seat 2: julinhobrazu (1475 in chips)
Seat 3: mishanya_pim (1455 in chips)
Seat 4: crazyrob87 (1393 in chips)
Seat 5: JK147 (2371 in chips)
Seat 6: dimetruk (881 in chips)
MirrowCall: posts the ante 3
julinhobrazu: posts the ante 3
mishanya_pim: posts the ante 3
crazyrob87: posts the ante 3
JK147: posts the ante 3
dimetruk: posts the ante 3
MirrowCall: posts small blind 10
julinhobrazu: posts big blind 20
*** HOLE CARDS ***
Dealt to dimetruk [6s Ac]
mishanya_pim: folds
crazyrob87: folds
JK147: folds
dimetruk: raises 30 to 50
MirrowCall: calls 40
julinhobrazu: calls 30
*** FLOP *** [2c 7d 3h]
MirrowCall: checks
julinhobrazu: checks
dimetruk: checks
*** TURN *** [2c 7d 3h] [3s]
MirrowCall: checks
julinhobrazu: bets 50
dimetruk: calls 50
MirrowCall: calls 50
*** RIVER *** [2c 7d 3h 3s] [Jc]
MirrowCall: bets 80
julinhobrazu: raises 315 to 395
dimetruk: folds
MirrowCall: folds
Uncalled bet (315) returned to julinhobrazu
julinhobrazu collected 478 from pot
julinhobrazu: doesn't show hand
*** SUMMARY ***
Total pot 478 | Rake 0
Board [2c 7d 3h 3s Jc]
Seat 1: MirrowCall (small blind) folded on the River
Seat 2: julinhobrazu (big blind) collected (478)
Seat 3: mishanya_pim folded before Flop (didn't bet)
Seat 4: crazyrob87 folded before Flop (didn't bet)
Seat 5: JK147 folded before Flop (didn't bet)
Seat 6: dimetruk (button) folded on the River


PokerStars Hand #228816245727: Tournament #3242858326, $27.58+$2.42 USD Hold'em No Limit - Level I (10/20) - 2021/08/05 1:07:22 MSK [2021/08/04 18:07:22 ET]
Table '3242858326 1' 6-max Seat #3 is the button
Seat 1: MirrowCall (1236 in chips)
Seat 2: julinhobrazu (1969 in chips)
Seat 3: mishanya_pim (1550 in chips)
Seat 4: crazyrob87 (1291 in chips)
Seat 5: JK147 (2182 in chips)
Seat 6: dimetruk (772 in chips)
MirrowCall: posts the ante 3
julinhobrazu: posts the ante 3
mishanya_pim: posts the ante 3
crazyrob87: posts the ante 3
JK147: posts the ante 3
dimetruk: posts the ante 3
crazyrob87: posts small blind 10
JK147: posts big blind 20
*** HOLE CARDS ***
Dealt to dimetruk [5d 5h]
dimetruk: raises 20 to 40
MirrowCall: folds
julinhobrazu: calls 40
mishanya_pim: folds
crazyrob87: calls 30
JK147: calls 20
*** FLOP *** [Tc Ts 5s]
crazyrob87: checks
JK147: checks
dimetruk: checks
julinhobrazu: bets 53
crazyrob87: folds
JK147: folds
dimetruk: calls 53
*** TURN *** [Tc Ts 5s] [6d]
dimetruk: checks
julinhobrazu: bets 85
dimetruk: raises 591 to 676 and is all-in
julinhobrazu: calls 591
*** RIVER *** [Tc Ts 5s 6d] [Ks]
*** SHOW DOWN ***
dimetruk: shows [5d 5h] (a full house, Fives full of Tens)
julinhobrazu: shows [9d 9h] (two pair, Tens and Nines)
dimetruk collected 1636 from pot
*** SUMMARY ***
Total pot 1636 | Rake 0
Board [Tc Ts 5s 6d Ks]
Seat 1: MirrowCall folded before Flop (didn't bet)
Seat 2: julinhobrazu showed [9d 9h] and lost with two pair, Tens and Nines
Seat 3: mishanya_pim (button) folded before Flop (didn't bet)
Seat 4: crazyrob87 (small blind) folded on the Flop
Seat 5: JK147 (big blind) folded on the Flop
Seat 6: dimetruk showed [5d 5h] and won (1636) with a full house, Fives full of Tens


PokerStars Hand #228816270617: Tournament #3242858326, $27.58+$2.42 USD Hold'em No Limit - Level I (10/20) - 2021/08/05 1:08:27 MSK [2021/08/04 18:08:27 ET]
Table '3242858326 1' 6-max Seat #4 is the button
Seat 1: MirrowCall (1233 in chips)
Seat 2: julinhobrazu (1197 in chips)
Seat 3: mishanya_pim (1547 in chips)
Seat 4: crazyrob87 (1248 in chips)
Seat 5: JK147 (2139 in chips)
Seat 6: dimetruk (1636 in chips)
MirrowCall: posts the ante 3
julinhobrazu: posts the ante 3
mishanya_pim: posts the ante 3
crazyrob87: posts the ante 3
JK147: posts the ante 3
dimetruk: posts the ante 3
JK147: posts small blind 10
dimetruk: posts big blind 20
*** HOLE CARDS ***
Dealt to dimetruk [Ts 7s]
MirrowCall: raises 20 to 40
julinhobrazu: folds
mishanya_pim: calls 40
crazyrob87: folds
JK147: calls 30
dimetruk: calls 20
*** FLOP *** [9c Js 9h]
JK147: checks
dimetruk: checks
MirrowCall: checks
mishanya_pim: bets 45
JK147: calls 45
dimetruk: calls 45
MirrowCall: calls 45
*** TURN *** [9c Js 9h] [Jc]
JK147: checks
dimetruk: checks
MirrowCall: checks
mishanya_pim: checks
*** RIVER *** [9c Js 9h Jc] [2h]
JK147: checks
dimetruk: checks
MirrowCall: bets 180
mishanya_pim: folds
JK147: folds
dimetruk: folds
Uncalled bet (180) returned to MirrowCall
MirrowCall collected 358 from pot
MirrowCall: doesn't show hand
*** SUMMARY ***
Total pot 358 | Rake 0
Board [9c Js 9h Jc 2h]
Seat 1: MirrowCall collected (358)
Seat 2: julinhobrazu folded before Flop (didn't bet)
Seat 3: mishanya_pim folded on the River
Seat 4: crazyrob87 (button) folded before Flop (didn't bet)
Seat 5: JK147 (small blind) folded on the River
Seat 6: dimetruk (big blind) folded on the River


PokerStars Hand #228816313092: Tournament #3242858326, $27.58+$2.42 USD Hold'em No Limit - Level II (15/30) - 2021/08/05 1:10:20 MSK [2021/08/04 18:10:20 ET]
Table '3242858326 1' 6-max Seat #6 is the button
Seat 1: MirrowCall (1480 in chips)
Seat 2: julinhobrazu (1191 in chips)
Seat 3: mishanya_pim (1456 in chips)
Seat 4: crazyrob87 (1290 in chips)
Seat 5: JK147 (2048 in chips)
Seat 6: dimetruk (1535 in chips)
MirrowCall: posts the ante 4
julinhobrazu: posts the ante 4
mishanya_pim: posts the ante 4
crazyrob87: posts the ante 4
JK147: posts the ante 4
dimetruk: posts the ante 4
MirrowCall: posts small blind 15
julinhobrazu: posts big blind 30
*** HOLE CARDS ***
Dealt to dimetruk [Kh As]
mishanya_pim: folds
crazyrob87: folds
JK147: folds
dimetruk: raises 45 to 75
MirrowCall: folds
julinhobrazu: calls 45
*** FLOP *** [Js 6h 4c]
julinhobrazu: checks
dimetruk: checks
*** TURN *** [Js 6h 4c] [6s]
julinhobrazu: bets 57
dimetruk: calls 57
*** RIVER *** [Js 6h 4c 6s] [8c]
julinhobrazu: bets 180
dimetruk: calls 180
*** SHOW DOWN ***
julinhobrazu: shows [Qs 3s] (a pair of Sixes)
dimetruk: shows [Kh As] (a pair of Sixes - Ace kicker)
dimetruk collected 663 from pot
*** SUMMARY ***
Total pot 663 | Rake 0
Board [Js 6h 4c 6s 8c]
Seat 1: MirrowCall (small blind) folded before Flop
Seat 2: julinhobrazu (big blind) showed [Qs 3s] and lost with a pair of Sixes
Seat 3: mishanya_pim folded before Flop (didn't bet)
Seat 4: crazyrob87 folded before Flop (didn't bet)
Seat 5: JK147 folded before Flop (didn't bet)
Seat 6: dimetruk (button) showed [Kh As] and won (663) with a pair of Sixes


PokerStars Hand #228816343687: Tournament #3242858326, $27.58+$2.42 USD Hold'em No Limit - Level II (15/30) - 2021/08/05 1:11:41 MSK [2021/08/04 18:11:41 ET]
Table '3242858326 1' 6-max Seat #3 is the button
Seat 1: MirrowCall (1423 in chips)
Seat 2: julinhobrazu (852 in chips)
Seat 3: mishanya_pim (1399 in chips)
Seat 4: crazyrob87 (1347 in chips)
Seat 5: JK147 (2036 in chips)
Seat 6: dimetruk (1943 in chips)
MirrowCall: posts the ante 4
julinhobrazu: posts the ante 4
mishanya_pim: posts the ante 4
crazyrob87: posts the ante 4
JK147: posts the ante 4
dimetruk: posts the ante 4
crazyrob87: posts small blind 15
JK147: posts big blind 30
*** HOLE CARDS ***
Dealt to dimetruk [Qc Ad]
dimetruk: raises 45 to 75
MirrowCall: folds
julinhobrazu: folds
mishanya_pim: folds
crazyrob87: folds
JK147: calls 45
*** FLOP *** [Qd 5d 2d]
JK147: checks
dimetruk: bets 62
JK147: calls 62
*** TURN *** [Qd 5d 2d] [6h]
JK147: checks
dimetruk: bets 163
JK147: calls 163
*** RIVER *** [Qd 5d 2d 6h] [9c]
JK147: checks
dimetruk: bets 460
JK147: folds
Uncalled bet (460) returned to dimetruk
dimetruk collected 639 from pot
dimetruk: doesn't show hand
*** SUMMARY ***
Total pot 639 | Rake 0
Board [Qd 5d 2d 6h 9c]
Seat 1: MirrowCall folded before Flop (didn't bet)
Seat 2: julinhobrazu folded before Flop (didn't bet)
Seat 3: mishanya_pim (button) folded before Flop (didn't bet)
Seat 4: crazyrob87 (small blind) folded before Flop
Seat 5: JK147 (big blind) folded on the River
Seat 6: dimetruk collected (639)


PokerStars Hand #228816365202: Tournament #3242858326, $27.58+$2.42 USD Hold'em No Limit - Level II (15/30) - 2021/08/05 1:12:39 MSK [2021/08/04 18:12:39 ET]
Table '3242858326 1' 6-max Seat #4 is the button
Seat 1: MirrowCall (1419 in chips)
Seat 2: julinhobrazu (848 in chips)
Seat 3: mishanya_pim (1395 in chips)
Seat 4: crazyrob87 (1328 in chips)
Seat 5: JK147 (1732 in chips)
Seat 6: dimetruk (2278 in chips)
MirrowCall: posts the ante 4
julinhobrazu: posts the ante 4
mishanya_pim: posts the ante 4
crazyrob87: posts the ante 4
JK147: posts the ante 4
dimetruk: posts the ante 4
JK147: posts small blind 15
dimetruk: posts big blind 30
*** HOLE CARDS ***
Dealt to dimetruk [5s 6s]
MirrowCall: raises 30 to 60
julinhobrazu: folds
mishanya_pim: folds
crazyrob87: calls 60
JK147: calls 45
dimetruk: calls 30
*** FLOP *** [3d 7d 2s]
JK147: checks
dimetruk: checks
MirrowCall: checks
crazyrob87: bets 132
JK147: calls 132
dimetruk: calls 132
MirrowCall: folds
*** TURN *** [3d 7d 2s] [2h]
JK147: checks
dimetruk: checks
crazyrob87: bets 270
JK147: folds
dimetruk: folds
Uncalled bet (270) returned to crazyrob87
crazyrob87 collected 660 from pot
crazyrob87: doesn't show hand
*** SUMMARY ***
Total pot 660 | Rake 0
Board [3d 7d 2s 2h]
Seat 1: MirrowCall folded on the Flop
Seat 2: julinhobrazu folded before Flop (didn't bet)
Seat 3: mishanya_pim folded before Flop (didn't bet)
Seat 4: crazyrob87 (button) collected (660)
Seat 5: JK147 (small blind) folded on the Turn
Seat 6: dimetruk (big blind) folded on the Turn


PokerStars Hand #228816445233: Tournament #3242858326, $27.58+$2.42 USD Hold'em No Limit - Level II (15/30) - 2021/08/05 1:16:14 MSK [2021/08/04 18:16:14 ET]
Table '3242858326 1' 6-max Seat #4 is the button
Seat 1: MirrowCall (2488 in chips)
Seat 2: julinhobrazu (1676 in chips)
Seat 3: mishanya_pim (1326 in chips)
Seat 4: crazyrob87 (1613 in chips)
Seat 6: dimetruk (1897 in chips)
MirrowCall: posts the ante 4
julinhobrazu: posts the ante 4
mishanya_pim: posts the ante 4
crazyrob87: posts the ante 4
dimetruk: posts the ante 4
dimetruk: posts small blind 15
MirrowCall: posts big blind 30
*** HOLE CARDS ***
Dealt to dimetruk [8d 9c]
julinhobrazu: folds
mishanya_pim: folds
crazyrob87: folds
dimetruk: calls 15
MirrowCall: checks
*** FLOP *** [5s Th 4c]
dimetruk: checks
MirrowCall: checks
*** TURN *** [5s Th 4c] [7s]
dimetruk: bets 98
MirrowCall: calls 98
*** RIVER *** [5s Th 4c 7s] [Js]
dimetruk: bets 427
MirrowCall: folds
Uncalled bet (427) returned to dimetruk
dimetruk collected 276 from pot
dimetruk: doesn't show hand
*** SUMMARY ***
Total pot 276 | Rake 0
Board [5s Th 4c 7s Js]
Seat 1: MirrowCall (big blind) folded on the River
Seat 2: julinhobrazu folded before Flop (didn't bet)
Seat 3: mishanya_pim folded before Flop (didn't bet)
Seat 4: crazyrob87 (button) folded before Flop (didn't bet)
Seat 6: dimetruk (small blind) collected (276)


PokerStars Hand #228816502665: Tournament #3242858326, $27.58+$2.42 USD Hold'em No Limit - Level II (15/30) - 2021/08/05 1:18:51 MSK [2021/08/04 18:18:51 ET]
Table '3242858326 1' 6-max Seat #3 is the button
Seat 1: MirrowCall (1294 in chips)
Seat 2: julinhobrazu (2685 in chips)
Seat 3: mishanya_pim (1265 in chips)
Seat 4: crazyrob87 (1787 in chips)
Seat 6: dimetruk (1969 in chips)
MirrowCall: posts the ante 4
julinhobrazu: posts the ante 4
mishanya_pim: posts the ante 4
crazyrob87: posts the ante 4
dimetruk: posts the ante 4
crazyrob87: posts small blind 15
dimetruk: posts big blind 30
*** HOLE CARDS ***
Dealt to dimetruk [Td 6h]
MirrowCall: folds
julinhobrazu: folds
mishanya_pim: folds
crazyrob87: raises 60 to 90
dimetruk: calls 60
*** FLOP *** [9c Kc Jc]
crazyrob87: bets 100
dimetruk: folds
Uncalled bet (100) returned to crazyrob87
crazyrob87 collected 200 from pot
crazyrob87: doesn't show hand
*** SUMMARY ***
Total pot 200 | Rake 0
Board [9c Kc Jc]
Seat 1: MirrowCall folded before Flop (didn't bet)
Seat 2: julinhobrazu folded before Flop (didn't bet)
Seat 3: mishanya_pim (button) folded before Flop (didn't bet)
Seat 4: crazyrob87 (small blind) collected (200)
Seat 6: dimetruk (big blind) folded on the Flop


PokerStars Hand #228816568248: Tournament #3242858326, $27.58+$2.42 USD Hold'em No Limit - Level III (25/50) - 2021/08/05 1:21:53 MSK [2021/08/04 18:21:53 ET]
Table '3242858326 1' 6-max Seat #2 is the button
Seat 1: MirrowCall (1561 in chips)
Seat 2: julinhobrazu (2767 in chips)
Seat 3: mishanya_pim (1197 in chips)
Seat 4: crazyrob87 (1854 in chips)
Seat 6: dimetruk (1621 in chips)
MirrowCall: posts the ante 6
julinhobrazu: posts the ante 6
mishanya_pim: posts the ante 6
crazyrob87: posts the ante 6
dimetruk: posts the ante 6
mishanya_pim: posts small blind 25
crazyrob87: posts big blind 50
*** HOLE CARDS ***
Dealt to dimetruk [Ts Kh]
dimetruk: raises 50 to 100
MirrowCall: folds
julinhobrazu: folds
mishanya_pim: folds
crazyrob87: calls 50
*** FLOP *** [4c 9h 7c]
crazyrob87: checks
dimetruk: bets 133
crazyrob87: calls 133
*** TURN *** [4c 9h 7c] [5d]
crazyrob87: checks
dimetruk: checks
*** RIVER *** [4c 9h 7c 5d] [8s]
crazyrob87: checks
dimetruk: bets 640
crazyrob87: calls 640
*** SHOW DOWN ***
dimetruk: shows [Ts Kh] (high card King)
crazyrob87: shows [Qc 4d] (a pair of Fours)
crazyrob87 collected 1801 from pot
*** SUMMARY ***
Total pot 1801 | Rake 0
Board [4c 9h 7c 5d 8s]
Seat 1: MirrowCall folded before Flop (didn't bet)
Seat 2: julinhobrazu (button) folded before Flop (didn't bet)
Seat 3: mishanya_pim (small blind) folded before Flop
Seat 4: crazyrob87 (big blind) showed [Qc 4d] and won (1801) with a pair of Fours
Seat 6: dimetruk showed [Ts Kh] and lost with high card King


PokerStars Hand #228816594420: Tournament #3242858326, $27.58+$2.42 USD Hold'em No Limit - Level III (25/50) - 2021/08/05 1:23:06 MSK [2021/08/04 18:23:06 ET]
Table '3242858326 1' 6-max Seat #4 is the button
Seat 1: MirrowCall (1549 in chips)
Seat 2: julinhobrazu (2860 in chips)
Seat 3: mishanya_pim (1160 in chips)
Seat 4: crazyrob87 (2745 in chips)
Seat 6: dimetruk (686 in chips)
MirrowCall: posts the ante 6
julinhobrazu: posts the ante 6
mishanya_pim: posts the ante 6
crazyrob87: posts the ante 6
dimetruk: posts the ante 6
dimetruk: posts small blind 25
MirrowCall: posts big blind 50
*** HOLE CARDS ***
Dealt to dimetruk [Tc Th]
julinhobrazu: raises 65 to 115
mishanya_pim: folds
crazyrob87: folds
dimetruk: raises 565 to 680 and is all-in
MirrowCall: folds
julinhobrazu: calls 565
*** FLOP *** [Qd 2d Ah]
*** TURN *** [Qd 2d Ah] [6d]
*** RIVER *** [Qd 2d Ah 6d] [3d]
*** SHOW DOWN ***
dimetruk: shows [Tc Th] (a pair of Tens)
julinhobrazu: shows [Td Ad] (a flush, Ace high)
julinhobrazu collected 1440 from pot
dimetruk finished the tournament in 5th place
*** SUMMARY ***
Total pot 1440 | Rake 0
Board [Qd 2d Ah 6d 3d]
Seat 1: MirrowCall (big blind) folded before Flop
Seat 2: julinhobrazu showed [Td Ad] and won (1440) with a flush, Ace high
Seat 3: mishanya_pim folded before Flop (didn't bet)
Seat 4: crazyrob87 (button) folded before Flop (didn't bet)
Seat 6: dimetruk (small blind) showed [Tc Th] and lost with a pair of Tens


